"com_code","com_annee","com_type","popref_annee","popref_mun","popref_a_part","popref_tot","popref_date_maj"
"01001","2024","COM","2022","859","16","875","2024-12-30"
"01002","2024","COM","2022","273","6","279","2024-12-30"
"01004","2024","COM","2022","15554","376","15930","2024-12-30"
"01005","2024","COM","2022","1917","24","1941","2024-12-30"
"01006","2024","COM","2022","114","0","114","2024-12-30"
"01007","2024","COM","2022","2828","118","2946","2024-12-30"
"01008","2024","COM","2022","764","17","781","2024-12-30"
"01009","2024","COM","2022","335","8","343","2024-12-30"
"01010","2024","COM","2022","1150","25","1175","2024-12-30"
"01011","2024","COM","2022","399","10","409","2024-12-30"
"01012","2024","COM","2022","329","13","342","2024-12-30"
"01013","2024","COM","2022","140","3","143","2024-12-30"
"01014","2024","COM","2022","3482","80","3562","2024-12-30"
"01015","2024","COM","2022","688","11","699","2024-12-30"
"01016","2024","COM","2022","459","9","468","2024-12-30"
"01017","2024","COM","2022","420","10","430","2024-12-30"
"01019","2024","COM","2022","25","4","29","2024-12-30"
"01021","2024","COM","2022","1513","28","1541","2024-12-30"
"01022","2024","COM","2022","1141","15","1156","2024-12-30"
"01023","2024","COM","2022","77","0","77","2024-12-30"
"01024","2024","COM","2022","3372","68","3440","2024-12-30"
"01025","2024","COM","2022","4057","101","4158","2024-12-30"
"01026","2024","COM","2022","987","66","1053","2024-12-30"
"01027","2024","COM","2022","2878","79","2957","2024-12-30"
"01028","2024","COM","2022","618","17","635","2024-12-30"
"01029","2024","COM","2022","717","12","729","2024-12-30"
"01030","2024","COM","2022","826","15","841","2024-12-30"
"01031","2024","COM","2022","3581","249","3830","2024-12-30"
"01032","2024","COM","2022","3484","42","3526","2024-12-30"
"01033","2024","COM","2022","16162","301","16463","2024-12-30"
"01034","2024","COM","2022","9270","314","9584","2024-12-30"
"01035","2024","COM","2022","306","8","314","2024-12-30"
"01036","2024","COM","2022","1350","25","1375","2024-12-30"
"01037","2024","COM","2022","311","3","314","2024-12-30"
"01038","2024","COM","2022","769","17","786","2024-12-30"
"01040","2024","COM","2022","481","11","492","2024-12-30"
"01041","2024","COM","2022","762","14","776","2024-12-30"
"01042","2024","COM","2022","290","7","297","2024-12-30"
"01043","2024","COM","2022","4936","115","5051","2024-12-30"
"01044","2024","COM","2022","669","16","685","2024-12-30"
"01045","2024","COM","2022","280","7","287","2024-12-30"
"01046","2024","COM","2022","897","12","909","2024-12-30"
"01047","2024","COM","2022","1351","36","1387","2024-12-30"
"01049","2024","COM","2022","3401","80","3481","2024-12-30"
"01050","2024","COM","2022","390","4","394","2024-12-30"
"01051","2024","COM","2022","99","0","99","2024-12-30"
"01052","2024","COM","2022","323","6","329","2024-12-30"
"01053","2024","COM","2022","42065","1631","43696","2024-12-30"
"01054","2024","COM","2022","1540","39","1579","2024-12-30"
"01056","2024","COM","2022","362","8","370","2024-12-30"
"01057","2024","COM","2022","509","16","525","2024-12-30"
"01058","2024","COM","2022","812","19","831","2024-12-30"
"01060","2024","COM","2022","547","11","558","2024-12-30"
"01061","2024","COM","2022","1117","34","1151","2024-12-30"
"01062","2024","COM","2022","1003","23","1026","2024-12-30"
"01063","2024","COM","2022","591","16","607","2024-12-30"
"01064","2024","COM","2022","1102","19","1121","2024-12-30"
"01065","2024","COM","2022","1884","66","1950","2024-12-30"
"01066","2024","COM","2022","97","1","98","2024-12-30"
"01067","2024","COM","2022","263","12","275","2024-12-30"
"01068","2024","COM","2022","755","16","771","2024-12-30"
"01069","2024","COM","2022","1518","39","1557","2024-12-30"
"01071","2024","COM","2022","5570","109","5679","2024-12-30"
"01072","2024","COM","2022","3306","83","3389","2024-12-30"
"01073","2024","COM","2022","1028","23","1051","2024-12-30"
"01074","2024","COM","2022","2544","38","2582","2024-12-30"
"01075","2024","COM","2022","1436","33","1469","2024-12-30"
"01076","2024","COM","2022","127","3","130","2024-12-30"
"01077","2024","COM","2022","185","2","187","2024-12-30"
"01078","2024","COM","2022","1628","36","1664","2024-12-30"
"01079","2024","COM","2022","826","31","857","2024-12-30"
"01080","2024","COM","2022","655","15","670","2024-12-30"
"01081","2024","COM","2022","709","22","731","2024-12-30"
"01082","2024","COM","2022","595","13","608","2024-12-30"
"01083","2024","COM","2022","1041","19","1060","2024-12-30"
"01084","2024","COM","2022","943","18","961","2024-12-30"
"01085","2024","COM","2022","391","6","397","2024-12-30"
"01087","2024","COM","2022","280","8","288","2024-12-30"
"01088","2024","COM","2022","925","23","948","2024-12-30"
"01089","2024","COM","2022","2408","50","2458","2024-12-30"
"01090","2024","COM","2022","358","5","363","2024-12-30"
"01092","2024","COM","2022","1675","62","1737","2024-12-30"
"01093","2024","COM","2022","5154","203","5357","2024-12-30"
"01094","2024","COM","2022","746","19","765","2024-12-30"
"01095","2024","COM","2022","822","18","840","2024-12-30"
"01096","2024","COM","2022","1057","18","1075","2024-12-30"
"01098","2024","COM","2022","1165","21","1186","2024-12-30"
"01099","2024","COM","2022","1613","60","1673","2024-12-30"
"01100","2024","COM","2022","130","4","134","2024-12-30"
"01101","2024","COM","2022","149","8","157","2024-12-30"
"01102","2024","COM","2022","981","19","1000","2024-12-30"
"01103","2024","COM","2022","2301","52","2353","2024-12-30"
"01104","2024","COM","2022","436","12","448","2024-12-30"
"01105","2024","COM","2022","1986","54","2040","2024-12-30"
"01106","2024","COM","2022","175","7","182","2024-12-30"
"01107","2024","COM","2022","144","4","148","2024-12-30"
"01108","2024","COM","2022","1294","15","1309","2024-12-30"
"01109","2024","COM","2022","2260","46","2306","2024-12-30"
"01110","2024","COM","2022","164","2","166","2024-12-30"
"01111","2024","COM","2022","136","2","138","2024-12-30"
"01112","2024","COM","2022","477","6","483","2024-12-30"
"01113","2024","COM","2022","815","12","827","2024-12-30"
"01114","2024","COM","2022","676","11","687","2024-12-30"
"01115","2024","COM","2022","1357","31","1388","2024-12-30"
"01116","2024","COM","2022","489","14","503","2024-12-30"
"01117","2024","COM","2022","148","1","149","2024-12-30"
"01118","2024","COM","2022","1315","15","1330","2024-12-30"
"01121","2024","COM","2022","116","1","117","2024-12-30"
"01123","2024","COM","2022","1165","32","1197","2024-12-30"
"01124","2024","COM","2022","704","5","709","2024-12-30"
"01125","2024","COM","2022","587","11","598","2024-12-30"
"01127","2024","COM","2022","513","14","527","2024-12-30"
"01128","2024","COM","2022","293","4","297","2024-12-30"
"01129","2024","COM","2022","316","5","321","2024-12-30"
"01130","2024","COM","2022","2393","39","2432","2024-12-30"
"01133","2024","COM","2022","384","5","389","2024-12-30"
"01134","2024","COM","2022","1844","43","1887","2024-12-30"
"01135","2024","COM","2022","2354","45","2399","2024-12-30"
"01136","2024","COM","2022","951","18","969","2024-12-30"
"01138","2024","COM","2022","3416","69","3485","2024-12-30"
"01139","2024","COM","2022","462","12","474","2024-12-30"
"01140","2024","COM","2022","805","18","823","2024-12-30"
"01141","2024","COM","2022","423","8","431","2024-12-30"
"01142","2024","COM","2022","4741","54","4795","2024-12-30"
"01143","2024","COM","2022","10300","220","10520","2024-12-30"
"01145","2024","COM","2022","1225","21","1246","2024-12-30"
"01146","2024","COM","2022","453","3","456","2024-12-30"
"01147","2024","COM","2022","540","6","546","2024-12-30"
"01148","2024","COM","2022","2013","40","2053","2024-12-30"
"01149","2024","COM","2022","1108","29","1137","2024-12-30"
"01150","2024","COM","2022","215","5","220","2024-12-30"
"01151","2024","COM","2022","1144","31","1175","2024-12-30"
"01152","2024","COM","2022","774","26","800","2024-12-30"
"01153","2024","COM","2022","2227","58","2285","2024-12-30"
"01155","2024","COM","2022","143","5","148","2024-12-30"
"01156","2024","COM","2022","905","10","915","2024-12-30"
"01157","2024","COM","2022","2524","59","2583","2024-12-30"
"01158","2024","COM","2022","1065","19","1084","2024-12-30"
"01159","2024","COM","2022","3388","69","3457","2024-12-30"
"01160","2024","COM","2022","11530","136","11666","2024-12-30"
"01162","2024","COM","2022","64","3","67","2024-12-30"
"01163","2024","COM","2022","2024","33","2057","2024-12-30"
"01165","2024","COM","2022","1593","35","1628","2024-12-30"
"01166","2024","COM","2022","2547","38","2585","2024-12-30"
"01167","2024","COM","2022","685","12","697","2024-12-30"
"01169","2024","COM","2022","675","21","696","2024-12-30"
"01170","2024","COM","2022","1048","37","1085","2024-12-30"
"01171","2024","COM","2022","843","21","864","2024-12-30"
"01173","2024","COM","2022","13455","287","13742","2024-12-30"
"01174","2024","COM","2022","174","3","177","2024-12-30"
"01175","2024","COM","2022","782","23","805","2024-12-30"
"01177","2024","COM","2022","186","5","191","2024-12-30"
"01179","2024","COM","2022","1909","43","1952","2024-12-30"
"01180","2024","COM","2022","873","21","894","2024-12-30"
"01181","2024","COM","2022","1216","49","1265","2024-12-30"
"01183","2024","COM","2022","1503","29","1532","2024-12-30"
"01184","2024","COM","2022","754","28","782","2024-12-30"
"01185","2024","COM","2022","4790","158","4948","2024-12-30"
"01187","2024","COM","2022","603","18","621","2024-12-30"
"01188","2024","COM","2022","696","21","717","2024-12-30"
"01189","2024","COM","2022","1123","31","1154","2024-12-30"
"01190","2024","COM","2022","92","1","93","2024-12-30"
"01191","2024","COM","2022","159","6","165","2024-12-30"
"01192","2024","COM","2022","2262","55","2317","2024-12-30"
"01193","2024","COM","2022","223","6","229","2024-12-30"
"01194","2024","COM","2022","6315","94","6409","2024-12-30"
"01195","2024","COM","2022","1900","41","1941","2024-12-30"
"01196","2024","COM","2022","1276","22","1298","2024-12-30"
"01197","2024","COM","2022","384","8","392","2024-12-30"
"01198","2024","COM","2022","262","3","265","2024-12-30"
"01199","2024","COM","2022","2209","37","2246","2024-12-30"
"01200","2024","COM","2022","207","6","213","2024-12-30"
"01202","2024","COM","2022","7321","121","7442","2024-12-30"
"01203","2024","COM","2022","1292","24","1316","2024-12-30"
"01204","2024","COM","2022","740","19","759","2024-12-30"
"01206","2024","COM","2022","265","11","276","2024-12-30"
"01207","2024","COM","2022","337","5","342","2024-12-30"
"01208","2024","COM","2022","138","1","139","2024-12-30"
"01209","2024","COM","2022","887","18","905","2024-12-30"
"01210","2024","COM","2022","236","4","240","2024-12-30"
"01211","2024","COM","2022","1459","34","1493","2024-12-30"
"01212","2024","COM","2022","720","8","728","2024-12-30"
"01213","2024","COM","2022","1417","31","1448","2024-12-30"
"01214","2024","COM","2022","163","5","168","2024-12-30"
"01215","2024","COM","2022","140","4","144","2024-12-30"
"01216","2024","COM","2022","891","21","912","2024-12-30"
"01219","2024","COM","2022","162","4","166","2024-12-30"
"01224","2024","COM","2022","3468","37","3505","2024-12-30"
"01225","2024","COM","2022","404","16","420","2024-12-30"
"01227","2024","COM","2022","651","12","663","2024-12-30"
"01228","2024","COM","2022","693","14","707","2024-12-30"
"01229","2024","COM","2022","1235","27","1262","2024-12-30"
"01230","2024","COM","2022","320","7","327","2024-12-30"
"01231","2024","COM","2022","1985","42","2027","2024-12-30"
"01232","2024","COM","2022","2262","44","2306","2024-12-30"
"01233","2024","COM","2022","135","5","140","2024-12-30"
"01234","2024","COM","2022","164","3","167","2024-12-30"
"01235","2024","COM","2022","1186","84","1270","2024-12-30"
"01236","2024","COM","2022","1034","29","1063","2024-12-30"
"01237","2024","COM","2022","1667","41","1708","2024-12-30"
"01238","2024","COM","2022","2733","61","2794","2024-12-30"
"01239","2024","COM","2022","653","9","662","2024-12-30"
"01240","2024","COM","2022","630","18","648","2024-12-30"
"01241","2024","COM","2022","1383","35","1418","2024-12-30"
"01242","2024","COM","2022","133","2","135","2024-12-30"
"01243","2024","COM","2022","1312","39","1351","2024-12-30"
"01244","2024","COM","2022","8198","143","8341","2024-12-30"
"01245","2024","COM","2022","951","26","977","2024-12-30"
"01246","2024","COM","2022","2179","37","2216","2024-12-30"
"01247","2024","COM","2022","297","13","310","2024-12-30"
"01248","2024","COM","2022","2309","56","2365","2024-12-30"
"01249","2024","COM","2022","10450","156","10606","2024-12-30"
"01250","2024","COM","2022","2010","276","2286","2024-12-30"
"01252","2024","COM","2022","824","24","848","2024-12-30"
"01254","2024","COM","2022","2164","45","2209","2024-12-30"
"01255","2024","COM","2022","684","12","696","2024-12-30"
"01257","2024","COM","2022","348","9","357","2024-12-30"
"01258","2024","COM","2022","1202","23","1225","2024-12-30"
"01259","2024","COM","2022","715","17","732","2024-12-30"
"01260","2024","COM","2022","329","7","336","2024-12-30"
"01261","2024","COM","2022","673","10","683","2024-12-30"
"01262","2024","COM","2022","6879","77","6956","2024-12-30"
"01263","2024","COM","2022","3798","90","3888","2024-12-30"
"01264","2024","COM","2022","1008","19","1027","2024-12-30"
"01265","2024","COM","2022","3584","87","3671","2024-12-30"
"01266","2024","COM","2022","2661","45","2706","2024-12-30"
"01267","2024","COM","2022","973","29","1002","2024-12-30"
"01268","2024","COM","2022","239","3","242","2024-12-30"
"01269","2024","COM","2022","3431","160","3591","2024-12-30"
"01272","2024","COM","2022","1540","19","1559","2024-12-30"
"01273","2024","COM","2022","1798","25","1823","2024-12-30"
"01274","2024","COM","2022","623","13","636","2024-12-30"
"01275","2024","COM","2022","2479","40","2519","2024-12-30"
"01276","2024","COM","2022","1648","19","1667","2024-12-30"
"01277","2024","COM","2022","119","1","120","2024-12-30"
"01279","2024","COM","2022","72","2","74","2024-12-30"
"01280","2024","COM","2022","146","3","149","2024-12-30"
"01281","2024","COM","2022","4903","104","5007","2024-12-30"
"01282","2024","COM","2022","258","8","266","2024-12-30"
"01283","2024","COM","2022","22378","426","22804","2024-12-30"
"01284","2024","COM","2022","721","14","735","2024-12-30"
"01285","2024","COM","2022","1317","31","1348","2024-12-30"
"01286","2024","COM","2022","943","37","980","2024-12-30"
"01288","2024","COM","2022","2900","62","2962","2024-12-30"
"01289","2024","COM","2022","6437","248","6685","2024-12-30"
"01290","2024","COM","2022","1382","32","1414","2024-12-30"
"01291","2024","COM","2022","861","21","882","2024-12-30"
"01293","2024","COM","2022","150","4","154","2024-12-30"
"01294","2024","COM","2022","918","19","937","2024-12-30"
"01295","2024","COM","2022","656","10","666","2024-12-30"
"01296","2024","COM","2022","400","10","410","2024-12-30"
"01297","2024","COM","2022","922","16","938","2024-12-30"
"01298","2024","COM","2022","166","2","168","2024-12-30"
"01299","2024","COM","2022","569","8","577","2024-12-30"
"01301","2024","COM","2022","2694","48","2742","2024-12-30"
"01302","2024","COM","2022","167","4","171","2024-12-30"
"01303","2024","COM","2022","1766","26","1792","2024-12-30"
"01304","2024","COM","2022","2862","50","2912","2024-12-30"
"01305","2024","COM","2022","2184","42","2226","2024-12-30"
"01306","2024","COM","2022","1600","88","1688","2024-12-30"
"01307","2024","COM","2022","843","21","864","2024-12-30"
"01308","2024","COM","2022","792","13","805","2024-12-30"
"01309","2024","COM","2022","79","3","82","2024-12-30"
"01310","2024","COM","2022","245","3","248","2024-12-30"
"01311","2024","COM","2022","47","1","48","2024-12-30"
"01313","2024","COM","2022","9081","256","9337","2024-12-30"
"01314","2024","COM","2022","1803","23","1826","2024-12-30"
"01317","2024","COM","2022","332","6","338","2024-12-30"
"01318","2024","COM","2022","760","19","779","2024-12-30"
"01319","2024","COM","2022","467","9","476","2024-12-30"
"01320","2024","COM","2022","3929","82","4011","2024-12-30"
"01321","2024","COM","2022","905","33","938","2024-12-30"
"01322","2024","COM","2022","5228","106","5334","2024-12-30"
"01323","2024","COM","2022","1003","18","1021","2024-12-30"
"01325","2024","COM","2022","1131","19","1150","2024-12-30"
"01328","2024","COM","2022","628","4","632","2024-12-30"
"01329","2024","COM","2022","164","1","165","2024-12-30"
"01330","2024","COM","2022","174","7","181","2024-12-30"
"01331","2024","COM","2022","195","1","196","2024-12-30"
"01332","2024","COM","2022","819","18","837","2024-12-30"
"01333","2024","COM","2022","3369","45","3414","2024-12-30"
"01334","2024","COM","2022","671","15","686","2024-12-30"
"01335","2024","COM","2022","427","6","433","2024-12-30"
"01336","2024","COM","2022","1216","25","1241","2024-12-30"
"01337","2024","COM","2022","1351","29","1380","2024-12-30"
"01338","2024","COM","2022","1232","26","1258","2024-12-30"
"01339","2024","COM","2022","1544","28","1572","2024-12-30"
"01342","2024","COM","2022","548","12","560","2024-12-30"
"01343","2024","COM","2022","1867","31","1898","2024-12-30"
"01344","2024","COM","2022","6078","159","6237","2024-12-30"
"01345","2024","COM","2022","2258","31","2289","2024-12-30"
"01346","2024","COM","2022","845","19","864","2024-12-30"
"01347","2024","COM","2022","2176","68","2244","2024-12-30"
"01348","2024","COM","2022","2969","60","3029","2024-12-30"
"01349","2024","COM","2022","524","13","537","2024-12-30"
"01350","2024","COM","2022","2569","50","2619","2024-12-30"
"01351","2024","COM","2022","1625","27","1652","2024-12-30"
"01352","2024","COM","2022","576","12","588","2024-12-30"
"01353","2024","COM","2022","1741","39","1780","2024-12-30"
"01354","2024","COM","2022","14584","224","14808","2024-12-30"
"01355","2024","COM","2022","488","8","496","2024-12-30"
"01356","2024","COM","2022","214","3","217","2024-12-30"
"01357","2024","COM","2022","505","7","512","2024-12-30"
"01358","2024","COM","2022","423","8","431","2024-12-30"
"01359","2024","COM","2022","262","2","264","2024-12-30"
"01360","2024","COM","2022","2042","38","2080","2024-12-30"
"01361","2024","COM","2022","1862","56","1918","2024-12-30"
"01362","2024","COM","2022","850","12","862","2024-12-30"
"01363","2024","COM","2022","1799","74","1873","2024-12-30"
"01364","2024","COM","2022","764","12","776","2024-12-30"
"01365","2024","COM","2022","1154","22","1176","2024-12-30"
"01366","2024","COM","2022","1092","14","1106","2024-12-30"
"01367","2024","COM","2022","687","9","696","2024-12-30"
"01368","2024","COM","2022","853","18","871","2024-12-30"
"01369","2024","COM","2022","953","23","976","2024-12-30"
"01370","2024","COM","2022","1735","15","1750","2024-12-30"
"01371","2024","COM","2022","1300","20","1320","2024-12-30"
"01372","2024","COM","2022","431","14","445","2024-12-30"
"01373","2024","COM","2022","1027","31","1058","2024-12-30"
"01374","2024","COM","2022","1953","32","1985","2024-12-30"
"01375","2024","COM","2022","784","19","803","2024-12-30"
"01376","2024","COM","2022","4243","44","4287","2024-12-30"
"01378","2024","COM","2022","2826","71","2897","2024-12-30"
"01379","2024","COM","2022","758","13","771","2024-12-30"
"01380","2024","COM","2022","589","12","601","2024-12-30"
"01381","2024","COM","2022","922","13","935","2024-12-30"
"01382","2024","COM","2022","357","4","361","2024-12-30"
"01383","2024","COM","2022","1637","21","1658","2024-12-30"
"01384","2024","COM","2022","2179","29","2208","2024-12-30"
"01385","2024","COM","2022","922","19","941","2024-12-30"
"01386","2024","COM","2022","1140","61","1201","2024-12-30"
"01387","2024","COM","2022","259","3","262","2024-12-30"
"01388","2024","COM","2022","1122","12","1134","2024-12-30"
"01389","2024","COM","2022","1910","36","1946","2024-12-30"
"01390","2024","COM","2022","1229","21","1250","2024-12-30"
"01391","2024","COM","2022","295","7","302","2024-12-30"
"01392","2024","COM","2022","645","29","674","2024-12-30"
"01393","2024","COM","2022","578","14","592","2024-12-30"
"01396","2024","COM","2022","1007","15","1022","2024-12-30"
"01397","2024","COM","2022","1003","20","1023","2024-12-30"
"01398","2024","COM","2022","1459","21","1480","2024-12-30"
"01399","2024","COM","2022","2676","52","2728","2024-12-30"
"01400","2024","COM","2022","136","4","140","2024-12-30"
"01401","2024","COM","2022","2279","76","2355","2024-12-30"
"01402","2024","COM","2022","659","10","669","2024-12-30"
"01403","2024","COM","2022","1329","41","1370","2024-12-30"
"01404","2024","COM","2022","135","2","137","2024-12-30"
"01405","2024","COM","2022","1287","26","1313","2024-12-30"
"01406","2024","COM","2022","180","2","182","2024-12-30"
"01407","2024","COM","2022","997","22","1019","2024-12-30"
"01408","2024","COM","2022","664","14","678","2024-12-30"
"01410","2024","COM","2022","287","7","294","2024-12-30"
"01411","2024","COM","2022","263","8","271","2024-12-30"
"01412","2024","COM","2022","605","14","619","2024-12-30"
"01415","2024","COM","2022","514","6","520","2024-12-30"
"01416","2024","COM","2022","1024","8","1032","2024-12-30"
"01418","2024","COM","2022","1208","22","1230","2024-12-30"
"01419","2024","COM","2022","6356","151","6507","2024-12-30"
"01420","2024","COM","2022","1644","8","1652","2024-12-30"
"01421","2024","COM","2022","744","13","757","2024-12-30"
"01422","2024","COM","2022","1389","28","1417","2024-12-30"
"01423","2024","COM","2022","1228","14","1242","2024-12-30"
"01424","2024","COM","2022","1845","45","1890","2024-12-30"
"01425","2024","COM","2022","288","6","294","2024-12-30"
"01426","2024","COM","2022","2494","53","2547","2024-12-30"
"01427","2024","COM","2022","6931","164","7095","2024-12-30"
"01428","2024","COM","2022","131","0","131","2024-12-30"
"01429","2024","COM","2022","725","14","739","2024-12-30"
"01430","2024","COM","2022","664","11","675","2024-12-30"
"01431","2024","COM","2022","1218","30","1248","2024-12-30"
"01432","2024","COM","2022","343","6","349","2024-12-30"
"01433","2024","COM","2022","296","4","300","2024-12-30"
"01434","2024","COM","2022","500","10","510","2024-12-30"
"01435","2024","COM","2022","2222","73","2295","2024-12-30"
"01436","2024","COM","2022","513","9","522","2024-12-30"
"01437","2024","COM","2022","215","5","220","2024-12-30"
"01439","2024","COM","2022","97","1","98","2024-12-30"
"01441","2024","COM","2022","727","17","744","2024-12-30"
"01443","2024","COM","2022","5059","94","5153","2024-12-30"
"01444","2024","COM","2022","1200","19","1219","2024-12-30"
"01445","2024","COM","2022","607","22","629","2024-12-30"
"01446","2024","COM","2022","1603","25","1628","2024-12-30"
"01447","2024","COM","2022","1391","27","1418","2024-12-30"
"01448","2024","COM","2022","390","14","404","2024-12-30"
"01449","2024","COM","2022","763","15","778","2024-12-30"
"01450","2024","COM","2022","3831","74","3905","2024-12-30"
"01451","2024","COM","2022","6955","131","7086","2024-12-30"
"01452","2024","COM","2022","1110","24","1134","2024-12-30"
"01453","2024","COM","2022","715","16","731","2024-12-30"
"01454","2024","COM","2022","1122","21","1143","2024-12-30"
"01456","2024","COM","2022","71","2","73","2024-12-30"
"01457","2024","COM","2022","3233","44","3277","2024-12-30"
"02001","2024","COM","2022","513","9","522","2024-12-30"
"02002","2024","COM","2022","586","13","599","2024-12-30"
"02003","2024","COM","2022","1013","26","1039","2024-12-30"
"02004","2024","COM","2022","188","3","191","2024-12-30"
"02005","2024","COM","2022","405","6","411","2024-12-30"
"02006","2024","COM","2022","257","9","266","2024-12-30"
"02007","2024","COM","2022","119","3","122","2024-12-30"
"02008","2024","COM","2022","308","3","311","2024-12-30"
"02009","2024","COM","2022","522","8","530","2024-12-30"
"02010","2024","COM","2022","166","2","168","2024-12-30"
"02011","2024","COM","2022","1203","51","1254","2024-12-30"
"02012","2024","COM","2022","81","0","81","2024-12-30"
"02013","2024","COM","2022","386","7","393","2024-12-30"
"02014","2024","COM","2022","710","22","732","2024-12-30"
"02015","2024","COM","2022","78","1","79","2024-12-30"
"02016","2024","COM","2022","211","8","219","2024-12-30"
"02017","2024","COM","2022","281","2","283","2024-12-30"
"02018","2024","COM","2022","2510","39","2549","2024-12-30"
"02019","2024","COM","2022","352","5","357","2024-12-30"
"02020","2024","COM","2022","455","8","463","2024-12-30"
"02021","2024","COM","2022","77","1","78","2024-12-30"
"02022","2024","COM","2022","398","4","402","2024-12-30"
"02023","2024","COM","2022","98","3","101","2024-12-30"
"02024","2024","COM","2022","45","0","45","2024-12-30"
"02025","2024","COM","2022","363","7","370","2024-12-30"
"02027","2024","COM","2022","203","8","211","2024-12-30"
"02028","2024","COM","2022","2600","56","2656","2024-12-30"
"02029","2024","COM","2022","345","11","356","2024-12-30"
"02030","2024","COM","2022","243","6","249","2024-12-30"
"02031","2024","COM","2022","659","6","665","2024-12-30"
"02032","2024","COM","2022","239","3","242","2024-12-30"
"02033","2024","COM","2022","101","2","103","2024-12-30"
"02034","2024","COM","2022","110","1","111","2024-12-30"
"02035","2024","COM","2022","282","9","291","2024-12-30"
"02036","2024","COM","2022","68","1","69","2024-12-30"
"02037","2024","COM","2022","1366","28","1394","2024-12-30"
"02038","2024","COM","2022","63","1","64","2024-12-30"
"02039","2024","COM","2022","175","3","178","2024-12-30"
"02040","2024","COM","2022","176","0","176","2024-12-30"
"02041","2024","COM","2022","791","19","810","2024-12-30"
"02042","2024","COM","2022","370","6","376","2024-12-30"
"02043","2024","COM","2022","62","1","63","2024-12-30"
"02044","2024","COM","2022","25","0","25","2024-12-30"
"02046","2024","COM","2022","556","11","567","2024-12-30"
"02047","2024","COM","2022","108","1","109","2024-12-30"
"02048","2024","COM","2022","128","1","129","2024-12-30"
"02049","2024","COM","2022","746","17","763","2024-12-30"
"02050","2024","COM","2022","317","3","320","2024-12-30"
"02051","2024","COM","2022","399","4","403","2024-12-30"
"02052","2024","COM","2022","130","6","136","2024-12-30"
"02053","2024","COM","2022","590","12","602","2024-12-30"
"02054","2024","COM","2022","517","17","534","2024-12-30"
"02055","2024","COM","2022","84","0","84","2024-12-30"
"02056","2024","COM","2022","172","3","175","2024-12-30"
"02057","2024","COM","2022","1324","20","1344","2024-12-30"
"02058","2024","COM","2022","813","12","825","2024-12-30"
"02059","2024","COM","2022","2625","33","2658","2024-12-30"
"02060","2024","COM","2022","257","2","259","2024-12-30"
"02061","2024","COM","2022","263","3","266","2024-12-30"
"02062","2024","COM","2022","133","1","134","2024-12-30"
"02063","2024","COM","2022","379","3","382","2024-12-30"
"02064","2024","COM","2022","3624","66","3690","2024-12-30"
"02065","2024","COM","2022","561","11","572","2024-12-30"
"02066","2024","COM","2022","188","2","190","2024-12-30"
"02067","2024","COM","2022","206","5","211","2024-12-30"
"02068","2024","COM","2022","81","5","86","2024-12-30"
"02069","2024","COM","2022","104","3","107","2024-12-30"
"02070","2024","COM","2022","434","12","446","2024-12-30"
"02071","2024","COM","2022","633","12","645","2024-12-30"
"02072","2024","COM","2022","177","3","180","2024-12-30"
"02073","2024","COM","2022","720","4","724","2024-12-30"
"02074","2024","COM","2022","586","11","597","2024-12-30"
"02075","2024","COM","2022","198","3","201","2024-12-30"
"02076","2024","COM","2022","154","3","157","2024-12-30"
"02078","2024","COM","2022","166","1","167","2024-12-30"
"02079","2024","COM","2022","137","4","141","2024-12-30"
"02080","2024","COM","2022","314","9","323","2024-12-30"
"02081","2024","COM","2022","425","12","437","2024-12-30"
"02082","2024","COM","2022","117","3","120","2024-12-30"
"02083","2024","COM","2022","741","23","764","2024-12-30"
"02084","2024","COM","2022","250","5","255","2024-12-30"
"02085","2024","COM","2022","991","26","1017","2024-12-30"
"02086","2024","COM","2022","989","13","1002","2024-12-30"
"02087","2024","COM","2022","34","1","35","2024-12-30"
"02088","2024","COM","2022","80","4","84","2024-12-30"
"02089","2024","COM","2022","1141","20","1161","2024-12-30"
"02090","2024","COM","2022","195","4","199","2024-12-30"
"02091","2024","COM","2022","91","0","91","2024-12-30"
"02093","2024","COM","2022","1212","56","1268","2024-12-30"
"02094","2024","COM","2022","473","6","479","2024-12-30"
"02095","2024","COM","2022","5724","72","5796","2024-12-30"
"02096","2024","COM","2022","188","2","190","2024-12-30"
"02097","2024","COM","2022","270","2","272","2024-12-30"
"02098","2024","COM","2022","376","9","385","2024-12-30"
"02099","2024","COM","2022","207","5","212","2024-12-30"
"02100","2024","COM","2022","139","0","139","2024-12-30"
"02101","2024","COM","2022","171","3","174","2024-12-30"
"02102","2024","COM","2022","184","3","187","2024-12-30"
"02103","2024","COM","2022","1316","5","1321","2024-12-30"
"02104","2024","COM","2022","95","4","99","2024-12-30"
"02105","2024","COM","2022","187","1","188","2024-12-30"
"02106","2024","COM","2022","809","13","822","2024-12-30"
"02107","2024","COM","2022","104","1","105","2024-12-30"
"02108","2024","COM","2022","146","2","148","2024-12-30"
"02109","2024","COM","2022","468","10","478","2024-12-30"
"02110","2024","COM","2022","2243","32","2275","2024-12-30"
"02111","2024","COM","2022","710","11","721","2024-12-30"
"02112","2024","COM","2022","558","11","569","2024-12-30"
"02114","2024","COM","2022","1711","37","1748","2024-12-30"
"02115","2024","COM","2022","189","4","193","2024-12-30"
"02116","2024","COM","2022","133","1","134","2024-12-30"
"02117","2024","COM","2022","65","3","68","2024-12-30"
"02118","2024","COM","2022","130","3","133","2024-12-30"
"02119","2024","COM","2022","317","6","323","2024-12-30"
"02120","2024","COM","2022","194","6","200","2024-12-30"
"02121","2024","COM","2022","219","1","220","2024-12-30"
"02122","2024","COM","2022","54","1","55","2024-12-30"
"02123","2024","COM","2022","297","7","304","2024-12-30"
"02124","2024","COM","2022","653","12","665","2024-12-30"
"02125","2024","COM","2022","179","10","189","2024-12-30"
"02126","2024","COM","2022","458","8","466","2024-12-30"
"02127","2024","COM","2022","195","3","198","2024-12-30"
"02128","2024","COM","2022","1419","44","1463","2024-12-30"
"02129","2024","COM","2022","19","0","19","2024-12-30"
"02130","2024","COM","2022","202","3","205","2024-12-30"
"02131","2024","COM","2022","1915","34","1949","2024-12-30"
"02132","2024","COM","2022","188","10","198","2024-12-30"
"02133","2024","COM","2022","406","9","415","2024-12-30"
"02134","2024","COM","2022","822","11","833","2024-12-30"
"02135","2024","COM","2022","1125","14","1139","2024-12-30"
"02136","2024","COM","2022","123","3","126","2024-12-30"
"02137","2024","COM","2022","131","5","136","2024-12-30"
"02138","2024","COM","2022","183","3","186","2024-12-30"
"02139","2024","COM","2022","459","8","467","2024-12-30"
"02140","2024","COM","2022","436","7","443","2024-12-30"
"02141","2024","COM","2022","1757","70","1827","2024-12-30"
"02142","2024","COM","2022","247","4","251","2024-12-30"
"02143","2024","COM","2022","185","6","191","2024-12-30"
"02144","2024","COM","2022","144","3","147","2024-12-30"
"02145","2024","COM","2022","546","9","555","2024-12-30"
"02146","2024","COM","2022","94","1","95","2024-12-30"
"02148","2024","COM","2022","252","1","253","2024-12-30"
"02149","2024","COM","2022","59","2","61","2024-12-30"
"02150","2024","COM","2022","63","0","63","2024-12-30"
"02151","2024","COM","2022","113","2","115","2024-12-30"
"02152","2024","COM","2022","88","1","89","2024-12-30"
"02153","2024","COM","2022","796","22","818","2024-12-30"
"02154","2024","COM","2022","367","9","376","2024-12-30"
"02155","2024","COM","2022","197","1","198","2024-12-30"
"02156","2024","COM","2022","242","2","244","2024-12-30"
"02157","2024","COM","2022","831","23","854","2024-12-30"
"02158","2024","COM","2022","270","2","272","2024-12-30"
"02159","2024","COM","2022","311","2","313","2024-12-30"
"02160","2024","COM","2022","497","20","517","2024-12-30"
"02162","2024","COM","2022","299","8","307","2024-12-30"
"02163","2024","COM","2022","2584","37","2621","2024-12-30"
"02164","2024","COM","2022","324","7","331","2024-12-30"
"02165","2024","COM","2022","1596","26","1622","2024-12-30"
"02166","2024","COM","2022","358","9","367","2024-12-30"
"02167","2024","COM","2022","898","17","915","2024-12-30"
"02168","2024","COM","2022","15068","313","15381","2024-12-30"
"02169","2024","COM","2022","83","2","85","2024-12-30"
"02170","2024","COM","2022","125","0","125","2024-12-30"
"02171","2024","COM","2022","91","1","92","2024-12-30"
"02172","2024","COM","2022","244","6","250","2024-12-30"
"02173","2024","COM","2022","11456","415","11871","2024-12-30"
"02174","2024","COM","2022","852","16","868","2024-12-30"
"02175","2024","COM","2022","159","3","162","2024-12-30"
"02176","2024","COM","2022","210","3","213","2024-12-30"
"02177","2024","COM","2022","146","1","147","2024-12-30"
"02178","2024","COM","2022","121","3","124","2024-12-30"
"02179","2024","COM","2022","379","7","386","2024-12-30"
"02180","2024","COM","2022","737","14","751","2024-12-30"
"02181","2024","COM","2022","97","0","97","2024-12-30"
"02182","2024","COM","2022","128","2","130","2024-12-30"
"02183","2024","COM","2022","191","6","197","2024-12-30"
"02184","2024","COM","2022","335","3","338","2024-12-30"
"02185","2024","COM","2022","377","15","392","2024-12-30"
"02186","2024","COM","2022","1308","28","1336","2024-12-30"
"02187","2024","COM","2022","1169","20","1189","2024-12-30"
"02188","2024","COM","2022","141","3","144","2024-12-30"
"02189","2024","COM","2022","354","2","356","2024-12-30"
"02190","2024","COM","2022","532","6","538","2024-12-30"
"02191","2024","COM","2022","488","7","495","2024-12-30"
"02192","2024","COM","2022","371","6","377","2024-12-30"
"02193","2024","COM","2022","64","1","65","2024-12-30"
"02194","2024","COM","2022","175","3","178","2024-12-30"
"02195","2024","COM","2022","892","27","919","2024-12-30"
"02196","2024","COM","2022","294","6","300","2024-12-30"
"02197","2024","COM","2022","522","101","623","2024-12-30"
"02198","2024","COM","2022","238","3","241","2024-12-30"
"02199","2024","COM","2022","590","8","598","2024-12-30"
"02200","2024","COM","2022","99","1","100","2024-12-30"
"02201","2024","COM","2022","466","7","473","2024-12-30"
"02203","2024","COM","2022","1281","13","1294","2024-12-30"
"02204","2024","COM","2022","63","2","65","2024-12-30"
"02205","2024","COM","2022","212","3","215","2024-12-30"
"02206","2024","COM","2022","72","1","73","2024-12-30"
"02207","2024","COM","2022","219","3","222","2024-12-30"
"02208","2024","COM","2022","260","7","267","2024-12-30"
"02209","2024","COM","2022","658","13","671","2024-12-30"
"02210","2024","COM","2022","358","5","363","2024-12-30"
"02211","2024","COM","2022","343","5","348","2024-12-30"
"02212","2024","COM","2022","682","9","691","2024-12-30"
"02213","2024","COM","2022","318","2","320","2024-12-30"
"02214","2024","COM","2022","61","1","62","2024-12-30"
"02215","2024","COM","2022","849","6","855","2024-12-30"
"02216","2024","COM","2022","318","8","326","2024-12-30"
"02217","2024","COM","2022","989","15","1004","2024-12-30"
"02218","2024","COM","2022","647","13","660","2024-12-30"
"02219","2024","COM","2022","195","64","259","2024-12-30"
"02220","2024","COM","2022","443","9","452","2024-12-30"
"02221","2024","COM","2022","159","4","163","2024-12-30"
"02222","2024","COM","2022","39","0","39","2024-12-30"
"02223","2024","COM","2022","301","11","312","2024-12-30"
"02224","2024","COM","2022","348","8","356","2024-12-30"
"02225","2024","COM","2022","82","1","83","2024-12-30"
"02226","2024","COM","2022","1831","41","1872","2024-12-30"
"02227","2024","COM","2022","123","0","123","2024-12-30"
"02228","2024","COM","2022","353","5","358","2024-12-30"
"02229","2024","COM","2022","76","0","76","2024-12-30"
"02230","2024","COM","2022","177","2","179","2024-12-30"
"02231","2024","COM","2022","931","17","948","2024-12-30"
"02232","2024","COM","2022","366","8","374","2024-12-30"
"02233","2024","COM","2022","133","0","133","2024-12-30"
"02234","2024","COM","2022","85","2","87","2024-12-30"
"02235","2024","COM","2022","118","4","122","2024-12-30"
"02236","2024","COM","2022","323","4","327","2024-12-30"
"02237","2024","COM","2022","1487","17","1504","2024-12-30"
"02238","2024","COM","2022","1807","35","1842","2024-12-30"
"02239","2024","COM","2022","1193","100","1293","2024-12-30"
"02240","2024","COM","2022","187","3","190","2024-12-30"
"02241","2024","COM","2022","89","3","92","2024-12-30"
"02242","2024","COM","2022","607","8","615","2024-12-30"
"02243","2024","COM","2022","3041","38","3079","2024-12-30"
"02244","2024","COM","2022","64","3","67","2024-12-30"
"02245","2024","COM","2022","1760","25","1785","2024-12-30"
"02246","2024","COM","2022","605","9","614","2024-12-30"
"02248","2024","COM","2022","154","1","155","2024-12-30"
"02249","2024","COM","2022","102","3","105","2024-12-30"
"02250","2024","COM","2022","80","1","81","2024-12-30"
"02251","2024","COM","2022","26","1","27","2024-12-30"
"02252","2024","COM","2022","71","1","72","2024-12-30"
"02253","2024","COM","2022","358","5","363","2024-12-30"
"02254","2024","COM","2022","126","2","128","2024-12-30"
"02255","2024","COM","2022","159","1","160","2024-12-30"
"02256","2024","COM","2022","125","2","127","2024-12-30"
"02257","2024","COM","2022","431","5","436","2024-12-30"
"02258","2024","COM","2022","375","9","384","2024-12-30"
"02259","2024","COM","2022","378","7","385","2024-12-30"
"02260","2024","COM","2022","624","9","633","2024-12-30"
"02261","2024","COM","2022","394","8","402","2024-12-30"
"02262","2024","COM","2022","202","3","205","2024-12-30"
"02263","2024","COM","2022","113","0","113","2024-12-30"
"02264","2024","COM","2022","722","16","738","2024-12-30"
"02265","2024","COM","2022","82","1","83","2024-12-30"
"02266","2024","COM","2022","35","0","35","2024-12-30"
"02267","2024","COM","2022","306","9","315","2024-12-30"
"02268","2024","COM","2022","638","9","647","2024-12-30"
"02269","2024","COM","2022","150","3","153","2024-12-30"
"02270","2024","COM","2022","159","1","160","2024-12-30"
"02271","2024","COM","2022","132","2","134","2024-12-30"
"02272","2024","COM","2022","75","2","77","2024-12-30"
"02273","2024","COM","2022","194","1","195","2024-12-30"
"02274","2024","COM","2022","173","2","175","2024-12-30"
"02275","2024","COM","2022","313","5","318","2024-12-30"
"02276","2024","COM","2022","120","1","121","2024-12-30"
"02277","2024","COM","2022","339","7","346","2024-12-30"
"02278","2024","COM","2022","34","2","36","2024-12-30"
"02279","2024","COM","2022","540","24","564","2024-12-30"
"02280","2024","COM","2022","411","12","423","2024-12-30"
"02281","2024","COM","2022","245","13","258","2024-12-30"
"02282","2024","COM","2022","438","6","444","2024-12-30"
"02283","2024","COM","2022","284","6","290","2024-12-30"
"02284","2024","COM","2022","100","0","100","2024-12-30"
"02286","2024","COM","2022","849","20","869","2024-12-30"
"02287","2024","COM","2022","1063","22","1085","2024-12-30"
"02288","2024","COM","2022","351","8","359","2024-12-30"
"02289","2024","COM","2022","412","13","425","2024-12-30"
"02290","2024","COM","2022","2698","65","2763","2024-12-30"
"02291","2024","COM","2022","408","7","415","2024-12-30"
"02292","2024","COM","2022","1331","28","1359","2024-12-30"
"02293","2024","COM","2022","546","9","555","2024-12-30"
"02294","2024","COM","2022","207","5","212","2024-12-30"
"02295","2024","COM","2022","845","11","856","2024-12-30"
"02296","2024","COM","2022","1176","22","1198","2024-12-30"
"02297","2024","COM","2022","125","2","127","2024-12-30"
"02298","2024","COM","2022","1455","11","1466","2024-12-30"
"02299","2024","COM","2022","526","7","533","2024-12-30"
"02302","2024","COM","2022","351","7","358","2024-12-30"
"02303","2024","COM","2022","711","33","744","2024-12-30"
"02304","2024","COM","2022","2860","130","2990","2024-12-30"
"02305","2024","COM","2022","2881","38","2919","2024-12-30"
"02306","2024","COM","2022","521","7","528","2024-12-30"
"02307","2024","COM","2022","2040","99","2139","2024-12-30"
"02308","2024","COM","2022","516","2","518","2024-12-30"
"02309","2024","COM","2022","707","7","714","2024-12-30"
"02310","2024","COM","2022","249","6","255","2024-12-30"
"02311","2024","COM","2022","121","2","123","2024-12-30"
"02312","2024","COM","2022","1098","15","1113","2024-12-30"
"02313","2024","COM","2022","438","5","443","2024-12-30"
"02315","2024","COM","2022","1698","36","1734","2024-12-30"
"02316","2024","COM","2022","126","5","131","2024-12-30"
"02317","2024","COM","2022","198","4","202","2024-12-30"
"02318","2024","COM","2022","1362","12","1374","2024-12-30"
"02319","2024","COM","2022","517","8","525","2024-12-30"
"02320","2024","COM","2022","230","5","235","2024-12-30"
"02321","2024","COM","2022","866","187","1053","2024-12-30"
"02322","2024","COM","2022","379","5","384","2024-12-30"
"02323","2024","COM","2022","135","4","139","2024-12-30"
"02324","2024","COM","2022","289","4","293","2024-12-30"
"02326","2024","COM","2022","470","9","479","2024-12-30"
"02327","2024","COM","2022","164","0","164","2024-12-30"
"02328","2024","COM","2022","524","10","534","2024-12-30"
"02329","2024","COM","2022","414","12","426","2024-12-30"
"02330","2024","COM","2022","512","16","528","2024-12-30"
"02331","2024","COM","2022","107","2","109","2024-12-30"
"02332","2024","COM","2022","278","4","282","2024-12-30"
"02333","2024","COM","2022","160","3","163","2024-12-30"
"02334","2024","COM","2022","2915","66","2981","2024-12-30"
"02335","2024","COM","2022","171","8","179","2024-12-30"
"02336","2024","COM","2022","976","16","992","2024-12-30"
"02337","2024","COM","2022","194","6","200","2024-12-30"
"02338","2024","COM","2022","246","7","253","2024-12-30"
"02339","2024","COM","2022","691","4","695","2024-12-30"
"02340","2024","COM","2022","5197","68","5265","2024-12-30"
"02341","2024","COM","2022","258","8","266","2024-12-30"
"02342","2024","COM","2022","131","1","132","2024-12-30"
"02343","2024","COM","2022","84","0","84","2024-12-30"
"02345","2024","COM","2022","37","0","37","2024-12-30"
"02346","2024","COM","2022","634","7","641","2024-12-30"
"02347","2024","COM","2022","429","7","436","2024-12-30"
"02349","2024","COM","2022","62","1","63","2024-12-30"
"02350","2024","COM","2022","141","2","143","2024-12-30"
"02351","2024","COM","2022","117","3","120","2024-12-30"
"02352","2024","COM","2022","570","6","576","2024-12-30"
"02353","2024","COM","2022","271","10","281","2024-12-30"
"02354","2024","COM","2022","80","0","80","2024-12-30"
"02355","2024","COM","2022","1000","27","1027","2024-12-30"
"02356","2024","COM","2022","230","2","232","2024-12-30"
"02357","2024","COM","2022","61","2","63","2024-12-30"
"02358","2024","COM","2022","310","4","314","2024-12-30"
"02359","2024","COM","2022","1248","20","1268","2024-12-30"
"02360","2024","COM","2022","2788","33","2821","2024-12-30"
"02361","2024","COM","2022","4510","59","4569","2024-12-30"
"02362","2024","COM","2022","239","4","243","2024-12-30"
"02363","2024","COM","2022","363","3","366","2024-12-30"
"02364","2024","COM","2022","246","4","250","2024-12-30"
"02366","2024","COM","2022","327","7","334","2024-12-30"
"02367","2024","COM","2022","176","0","176","2024-12-30"
"02368","2024","COM","2022","558","22","580","2024-12-30"
"02369","2024","COM","2022","243","6","249","2024-12-30"
"02370","2024","COM","2022","551","11","562","2024-12-30"
"02371","2024","COM","2022","1563","25","1588","2024-12-30"
"02372","2024","COM","2022","341","6","347","2024-12-30"
"02373","2024","COM","2022","196","6","202","2024-12-30"
"02374","2024","COM","2022","832","11","843","2024-12-30"
"02375","2024","COM","2022","162","3","165","2024-12-30"
"02376","2024","COM","2022","184","3","187","2024-12-30"
"02377","2024","COM","2022","130","8","138","2024-12-30"
"02378","2024","COM","2022","121","5","126","2024-12-30"
"02379","2024","COM","2022","194","125","319","2024-12-30"
"02380","2024","COM","2022","28","0","28","2024-12-30"
"02381","2024","COM","2022","8565","134","8699","2024-12-30"
"02382","2024","COM","2022","1350","24","1374","2024-12-30"
"02383","2024","COM","2022","1425","34","1459","2024-12-30"
"02384","2024","COM","2022","58","1","59","2024-12-30"
"02385","2024","COM","2022","169","4","173","2024-12-30"
"02386","2024","COM","2022","219","2","221","2024-12-30"
"02387","2024","COM","2022","999","26","1025","2024-12-30"
"02388","2024","COM","2022","219","4","223","2024-12-30"
"02389","2024","COM","2022","669","12","681","2024-12-30"
"02390","2024","COM","2022","253","4","257","2024-12-30"
"02391","2024","COM","2022","224","5","229","2024-12-30"
"02392","2024","COM","2022","326","6","332","2024-12-30"
"02393","2024","COM","2022","139","2","141","2024-12-30"
"02395","2024","COM","2022","126","4","130","2024-12-30"
"02396","2024","COM","2022","62","3","65","2024-12-30"
"02397","2024","COM","2022","1186","20","1206","2024-12-30"
"02398","2024","COM","2022","286","4","290","2024-12-30"
"02399","2024","COM","2022","608","6","614","2024-12-30"
"02400","2024","COM","2022","154","4","158","2024-12-30"
"02401","2024","COM","2022","184","2","186","2024-12-30"
"02402","2024","COM","2022","38","2","40","2024-12-30"
"02403","2024","COM","2022","248","10","258","2024-12-30"
"02404","2024","COM","2022","168","4","172","2024-12-30"
"02405","2024","COM","2022","514","17","531","2024-12-30"
"02406","2024","COM","2022","129","0","129","2024-12-30"
"02407","2024","COM","2022","213","9","222","2024-12-30"
"02408","2024","COM","2022","24066","612","24678","2024-12-30"
"02409","2024","COM","2022","281","6","287","2024-12-30"
"02410","2024","COM","2022","240","5","245","2024-12-30"
"02411","2024","COM","2022","199","5","204","2024-12-30"
"02412","2024","COM","2022","98","4","102","2024-12-30"
"02413","2024","COM","2022","248","5","253","2024-12-30"
"02414","2024","COM","2022","202","4","206","2024-12-30"
"02415","2024","COM","2022","156","6","162","2024-12-30"
"02416","2024","COM","2022","412","4","416","2024-12-30"
"02417","2024","COM","2022","129","2","131","2024-12-30"
"02418","2024","COM","2022","224","3","227","2024-12-30"
"02419","2024","COM","2022","269","10","279","2024-12-30"
"02420","2024","COM","2022","808","17","825","2024-12-30"
"02421","2024","COM","2022","84","2","86","2024-12-30"
"02422","2024","COM","2022","776","20","796","2024-12-30"
"02423","2024","COM","2022","445","6","451","2024-12-30"
"02424","2024","COM","2022","102","1","103","2024-12-30"
"02425","2024","COM","2022","187","0","187","2024-12-30"
"02426","2024","COM","2022","541","7","548","2024-12-30"
"02427","2024","COM","2022","139","1","140","2024-12-30"
"02428","2024","COM","2022","70","1","71","2024-12-30"
"02429","2024","COM","2022","120","0","120","2024-12-30"
"02430","2024","COM","2022","1265","129","1394","2024-12-30"
"02431","2024","COM","2022","383","5","388","2024-12-30"
"02432","2024","COM","2022","191","3","194","2024-12-30"
"02433","2024","COM","2022","218","6","224","2024-12-30"
"02435","2024","COM","2022","83","0","83","2024-12-30"
"02438","2024","COM","2022","237","10","247","2024-12-30"
"02439","2024","COM","2022","1234","14","1248","2024-12-30"
"02440","2024","COM","2022","139","4","143","2024-12-30"
"02441","2024","COM","2022","189","3","192","2024-12-30"
"02442","2024","COM","2022","87","0","87","2024-12-30"
"02443","2024","COM","2022","212","6","218","2024-12-30"
"02444","2024","COM","2022","118","2","120","2024-12-30"
"02445","2024","COM","2022","267","3","270","2024-12-30"
"02446","2024","COM","2022","118","1","119","2024-12-30"
"02447","2024","COM","2022","133","4","137","2024-12-30"
"02448","2024","COM","2022","109","3","112","2024-12-30"
"02449","2024","COM","2022","61","3","64","2024-12-30"
"02450","2024","COM","2022","356","3","359","2024-12-30"
"02451","2024","COM","2022","122","0","122","2024-12-30"
"02452","2024","COM","2022","233","10","243","2024-12-30"
"02453","2024","COM","2022","398","7","405","2024-12-30"
"02454","2024","COM","2022","403","9","412","2024-12-30"
"02455","2024","COM","2022","181","4","185","2024-12-30"
"02456","2024","COM","2022","306","7","313","2024-12-30"
"02457","2024","COM","2022","391","12","403","2024-12-30"
"02458","2024","COM","2022","825","16","841","2024-12-30"
"02459","2024","COM","2022","152","6","158","2024-12-30"
"02460","2024","COM","2022","204","1","205","2024-12-30"
"02461","2024","COM","2022","342","8","350","2024-12-30"
"02462","2024","COM","2022","223","2","225","2024-12-30"
"02463","2024","COM","2022","82","2","84","2024-12-30"
"02464","2024","COM","2022","369","3","372","2024-12-30"
"02465","2024","COM","2022","527","7","534","2024-12-30"
"02466","2024","COM","2022","127","1","128","2024-12-30"
"02467","2024","COM","2022","49","1","50","2024-12-30"
"02468","2024","COM","2022","2224","27","2251","2024-12-30"
"02469","2024","COM","2022","484","9","493","2024-12-30"
"02470","2024","COM","2022","421","9","430","2024-12-30"
"02471","2024","COM","2022","135","3","138","2024-12-30"
"02472","2024","COM","2022","403","7","410","2024-12-30"
"02473","2024","COM","2022","213","1","214","2024-12-30"
"02474","2024","COM","2022","407","6","413","2024-12-30"
"02476","2024","COM","2022","654","11","665","2024-12-30"
"02477","2024","COM","2022","945","20","965","2024-12-30"
"02478","2024","COM","2022","255","12","267","2024-12-30"
"02480","2024","COM","2022","318","6","324","2024-12-30"
"02481","2024","COM","2022","450","13","463","2024-12-30"
"02482","2024","COM","2022","58","2","60","2024-12-30"
"02483","2024","COM","2022","508","12","520","2024-12-30"
"02484","2024","COM","2022","551","3","554","2024-12-30"
"02485","2024","COM","2022","98","6","104","2024-12-30"
"02486","2024","COM","2022","106","2","108","2024-12-30"
"02487","2024","COM","2022","628","7","635","2024-12-30"
"02488","2024","COM","2022","160","2","162","2024-12-30"
"02489","2024","COM","2022","355","7","362","2024-12-30"
"02490","2024","COM","2022","123","3","126","2024-12-30"
"02491","2024","COM","2022","321","8","329","2024-12-30"
"02492","2024","COM","2022","434","7","441","2024-12-30"
"02493","2024","COM","2022","216","6","222","2024-12-30"
"02494","2024","COM","2022","130","2","132","2024-12-30"
"02495","2024","COM","2022","1033","18","1051","2024-12-30"
"02496","2024","COM","2022","94","1","95","2024-12-30"
"02497","2024","COM","2022","1148","17","1165","2024-12-30"
"02498","2024","COM","2022","766","18","784","2024-12-30"
"02499","2024","COM","2022","40","2","42","2024-12-30"
"02500","2024","COM","2022","813","10","823","2024-12-30"
"02501","2024","COM","2022","74","0","74","2024-12-30"
"02502","2024","COM","2022","1224","13","1237","2024-12-30"
"02503","2024","COM","2022","832","11","843","2024-12-30"
"02504","2024","COM","2022","1619","26","1645","2024-12-30"
"02505","2024","COM","2022","208","3","211","2024-12-30"
"02506","2024","COM","2022","202","4","206","2024-12-30"
"02507","2024","COM","2022","30","0","30","2024-12-30"
"02508","2024","COM","2022","145","5","150","2024-12-30"
"02509","2024","COM","2022","155","0","155","2024-12-30"
"02510","2024","COM","2022","137","5","142","2024-12-30"
"02511","2024","COM","2022","317","5","322","2024-12-30"
"02512","2024","COM","2022","271","3","274","2024-12-30"
"02513","2024","COM","2022","138","4","142","2024-12-30"
"02514","2024","COM","2022","684","11","695","2024-12-30"
"02515","2024","COM","2022","50","4","54","2024-12-30"
"02516","2024","COM","2022","70","1","71","2024-12-30"
"02517","2024","COM","2022","299","2","301","2024-12-30"
"02518","2024","COM","2022","289","2","291","2024-12-30"
"02519","2024","COM","2022","193","3","196","2024-12-30"
"02520","2024","COM","2022","742","12","754","2024-12-30"
"02521","2024","COM","2022","1328","21","1349","2024-12-30"
"02522","2024","COM","2022","81","1","82","2024-12-30"
"02523","2024","COM","2022","70","1","71","2024-12-30"
"02524","2024","COM","2022","689","18","707","2024-12-30"
"02525","2024","COM","2022","545","6","551","2024-12-30"
"02526","2024","COM","2022","107","3","110","2024-12-30"
"02527","2024","COM","2022","467","5","472","2024-12-30"
"02528","2024","COM","2022","215","4","219","2024-12-30"
"02529","2024","COM","2022","184","5","189","2024-12-30"
"02530","2024","COM","2022","77","1","78","2024-12-30"
"02531","2024","COM","2022","139","3","142","2024-12-30"
"02532","2024","COM","2022","986","15","1001","2024-12-30"
"02533","2024","COM","2022","111","1","112","2024-12-30"
"02534","2024","COM","2022","45","0","45","2024-12-30"
"02535","2024","COM","2022","114","3","117","2024-12-30"
"02536","2024","COM","2022","93","2","95","2024-12-30"
"02537","2024","COM","2022","196","4","200","2024-12-30"
"02538","2024","COM","2022","83","0","83","2024-12-30"
"02539","2024","COM","2022","672","12","684","2024-12-30"
"02540","2024","COM","2022","1196","36","1232","2024-12-30"
"02541","2024","COM","2022","423","4","427","2024-12-30"
"02542","2024","COM","2022","78","2","80","2024-12-30"
"02543","2024","COM","2022","1980","20","2000","2024-12-30"
"02544","2024","COM","2022","607","10","617","2024-12-30"
"02545","2024","COM","2022","187","5","192","2024-12-30"
"02546","2024","COM","2022","191","4","195","2024-12-30"
"02547","2024","COM","2022","63","2","65","2024-12-30"
"02548","2024","COM","2022","391","6","397","2024-12-30"
"02549","2024","COM","2022","857","22","879","2024-12-30"
"02550","2024","COM","2022","119","3","122","2024-12-30"
"02551","2024","COM","2022","114","2","116","2024-12-30"
"02552","2024","COM","2022","180","7","187","2024-12-30"
"02553","2024","COM","2022","232","3","235","2024-12-30"
"02554","2024","COM","2022","1106","27","1133","2024-12-30"
"02555","2024","COM","2022","2089","43","2132","2024-12-30"
"02556","2024","COM","2022","69","2","71","2024-12-30"
"02557","2024","COM","2022","126","2","128","2024-12-30"
"02558","2024","COM","2022","2479","28","2507","2024-12-30"
"02559","2024","COM","2022","523","7","530","2024-12-30"
"02560","2024","COM","2022","241","5","246","2024-12-30"
"02561","2024","COM","2022","143","3","146","2024-12-30"
"02562","2024","COM","2022","197","2","199","2024-12-30"
"02563","2024","COM","2022","142","4","146","2024-12-30"
"02564","2024","COM","2022","840","20","860","2024-12-30"
"02565","2024","COM","2022","295","4","299","2024-12-30"
"02566","2024","COM","2022","1113","24","1137","2024-12-30"
"02567","2024","COM","2022","270","7","277","2024-12-30"
"02568","2024","COM","2022","175","4","179","2024-12-30"
"02569","2024","COM","2022","459","3","462","2024-12-30"
"02570","2024","COM","2022","169","0","169","2024-12-30"
"02571","2024","COM","2022","679","80","759","2024-12-30"
"02572","2024","COM","2022","496","11","507","2024-12-30"
"02573","2024","COM","2022","55","1","56","2024-12-30"
"02574","2024","COM","2022","1354","21","1375","2024-12-30"
"02575","2024","COM","2022","1612","11","1623","2024-12-30"
"02576","2024","COM","2022","325","9","334","2024-12-30"
"02577","2024","COM","2022","91","1","92","2024-12-30"
"02578","2024","COM","2022","82","3","85","2024-12-30"
"02579","2024","COM","2022","127","4","131","2024-12-30"
"02580","2024","COM","2022","811","10","821","2024-12-30"
"02581","2024","COM","2022","314","1","315","2024-12-30"
"02582","2024","COM","2022","79","1","80","2024-12-30"
"02583","2024","COM","2022","56","0","56","2024-12-30"
"02584","2024","COM","2022","115","7","122","2024-12-30"
"02585","2024","COM","2022","247","6","253","2024-12-30"
"02586","2024","COM","2022","141","2","143","2024-12-30"
"02587","2024","COM","2022","351","12","363","2024-12-30"
"02588","2024","COM","2022","66","4","70","2024-12-30"
"02589","2024","COM","2022","250","4","254","2024-12-30"
"02590","2024","COM","2022","172","4","176","2024-12-30"
"02591","2024","COM","2022","140","4","144","2024-12-30"
"02592","2024","COM","2022","192","3","195","2024-12-30"
"02593","2024","COM","2022","1061","23","1084","2024-12-30"
"02594","2024","COM","2022","125","7","132","2024-12-30"
"02595","2024","COM","2022","139","0","139","2024-12-30"
"02596","2024","COM","2022","755","12","767","2024-12-30"
"02598","2024","COM","2022","683","19","702","2024-12-30"
"02599","2024","COM","2022","249","3","252","2024-12-30"
"02600","2024","COM","2022","336","5","341","2024-12-30"
"02601","2024","COM","2022","175","4","179","2024-12-30"
"02602","2024","COM","2022","1650","27","1677","2024-12-30"
"02604","2024","COM","2022","78","0","78","2024-12-30"
"02605","2024","COM","2022","191","5","196","2024-12-30"
"02606","2024","COM","2022","85","3","88","2024-12-30"
"02607","2024","COM","2022","97","1","98","2024-12-30"
"02608","2024","COM","2022","454","4","458","2024-12-30"
"02609","2024","COM","2022","23","1","24","2024-12-30"
"02610","2024","COM","2022","738","17","755","2024-12-30"
"02612","2024","COM","2022","118","2","120","2024-12-30"
"02613","2024","COM","2022","605","10","615","2024-12-30"
"02614","2024","COM","2022","281","7","288","2024-12-30"
"02615","2024","COM","2022","352","13","365","2024-12-30"
"02616","2024","COM","2022","185","3","188","2024-12-30"
"02617","2024","COM","2022","496","10","506","2024-12-30"
"02618","2024","COM","2022","686","12","698","2024-12-30"
"02619","2024","COM","2022","596","6","602","2024-12-30"
"02620","2024","COM","2022","327","7","334","2024-12-30"
"02621","2024","COM","2022","400","8","408","2024-12-30"
"02622","2024","COM","2022","58","0","58","2024-12-30"
"02623","2024","COM","2022","94","0","94","2024-12-30"
"02624","2024","COM","2022","275","59","334","2024-12-30"
"02625","2024","COM","2022","144","1","145","2024-12-30"
"02626","2024","COM","2022","339","7","346","2024-12-30"
"02627","2024","COM","2022","133","2","135","2024-12-30"
"02628","2024","COM","2022","221","6","227","2024-12-30"
"02629","2024","COM","2022","327","10","337","2024-12-30"
"02631","2024","COM","2022","419","5","424","2024-12-30"
"02632","2024","COM","2022","54","2","56","2024-12-30"
"02633","2024","COM","2022","62","2","64","2024-12-30"
"02634","2024","COM","2022","89","1","90","2024-12-30"
"02635","2024","COM","2022","147","1","148","2024-12-30"
"02636","2024","COM","2022","193","0","193","2024-12-30"
"02637","2024","COM","2022","278","7","285","2024-12-30"
"02638","2024","COM","2022","240","2","242","2024-12-30"
"02639","2024","COM","2022","341","7","348","2024-12-30"
"02640","2024","COM","2022","149","4","153","2024-12-30"
"02641","2024","COM","2022","127","5","132","2024-12-30"
"02642","2024","COM","2022","161","4","165","2024-12-30"
"02643","2024","COM","2022","780","17","797","2024-12-30"
"02644","2024","COM","2022","348","9","357","2024-12-30"
"02645","2024","COM","2022","213","3","216","2024-12-30"
"02647","2024","COM","2022","77","1","78","2024-12-30"
"02648","2024","COM","2022","1909","35","1944","2024-12-30"
"02649","2024","COM","2022","305","0","305","2024-12-30"
"02650","2024","COM","2022","364","6","370","2024-12-30"
"02651","2024","COM","2022","94","2","96","2024-12-30"
"02652","2024","COM","2022","100","1","101","2024-12-30"
"02653","2024","COM","2022","466","10","476","2024-12-30"
"02654","2024","COM","2022","83","3","86","2024-12-30"
"02655","2024","COM","2022","152","0","152","2024-12-30"
"02656","2024","COM","2022","375","6","381","2024-12-30"
"02657","2024","COM","2022","202","7","209","2024-12-30"
"02658","2024","COM","2022","238","5","243","2024-12-30"
"02659","2024","COM","2022","507","13","520","2024-12-30"
"02660","2024","COM","2022","42","1","43","2024-12-30"
"02661","2024","COM","2022","228","2","230","2024-12-30"
"02662","2024","COM","2022","333","5","338","2024-12-30"
"02663","2024","COM","2022","234","4","238","2024-12-30"
"02664","2024","COM","2022","120","3","123","2024-12-30"
"02665","2024","COM","2022","299","4","303","2024-12-30"
"02666","2024","COM","2022","922","12","934","2024-12-30"
"02667","2024","COM","2022","197","5","202","2024-12-30"
"02668","2024","COM","2022","939","25","964","2024-12-30"
"02670","2024","COM","2022","148","2","150","2024-12-30"
"02671","2024","COM","2022","279","5","284","2024-12-30"
"02672","2024","COM","2022","240","8","248","2024-12-30"
"02673","2024","COM","2022","443","7","450","2024-12-30"
"02674","2024","COM","2022","47","2","49","2024-12-30"
"02675","2024","COM","2022","130","1","131","2024-12-30"
"02676","2024","COM","2022","1700","26","1726","2024-12-30"
"02677","2024","COM","2022","234","3","237","2024-12-30"
"02678","2024","COM","2022","70","3","73","2024-12-30"
"02679","2024","COM","2022","153","4","157","2024-12-30"
"02680","2024","COM","2022","2313","38","2351","2024-12-30"
"02681","2024","COM","2022","285","7","292","2024-12-30"
"02682","2024","COM","2022","116","1","117","2024-12-30"
"02683","2024","COM","2022","115","0","115","2024-12-30"
"02684","2024","COM","2022","3222","52","3274","2024-12-30"
"02685","2024","COM","2022","116","3","119","2024-12-30"
"02686","2024","COM","2022","360","5","365","2024-12-30"
"02687","2024","COM","2022","332","9","341","2024-12-30"
"02688","2024","COM","2022","41","4","45","2024-12-30"
"02689","2024","COM","2022","40","0","40","2024-12-30"
"02690","2024","COM","2022","68","1","69","2024-12-30"
"02691","2024","COM","2022","52995","1128","54123","2024-12-30"
"02693","2024","COM","2022","225","6","231","2024-12-30"
"02694","2024","COM","2022","598","14","612","2024-12-30"
"02696","2024","COM","2022","72","2","74","2024-12-30"
"02697","2024","COM","2022","387","5","392","2024-12-30"
"02698","2024","COM","2022","98","2","100","2024-12-30"
"02699","2024","COM","2022","270","3","273","2024-12-30"
"02701","2024","COM","2022","695","7","702","2024-12-30"
"02702","2024","COM","2022","612","13","625","2024-12-30"
"02703","2024","COM","2022","1085","10","1095","2024-12-30"
"02704","2024","COM","2022","207","3","210","2024-12-30"
"02705","2024","COM","2022","198","6","204","2024-12-30"
"02706","2024","COM","2022","571","10","581","2024-12-30"
"02707","2024","COM","2022","179","1","180","2024-12-30"
"02708","2024","COM","2022","211","8","219","2024-12-30"
"02709","2024","COM","2022","390","7","397","2024-12-30"
"02710","2024","COM","2022","714","18","732","2024-12-30"
"02711","2024","COM","2022","277","6","283","2024-12-30"
"02712","2024","COM","2022","137","2","139","2024-12-30"
"02713","2024","COM","2022","268","1","269","2024-12-30"
"02714","2024","COM","2022","347","5","352","2024-12-30"
"02715","2024","COM","2022","42","3","45","2024-12-30"
"02716","2024","COM","2022","290","6","296","2024-12-30"
"02717","2024","COM","2022","602","13","615","2024-12-30"
"02718","2024","COM","2022","114","3","117","2024-12-30"
"02719","2024","COM","2022","1988","40","2028","2024-12-30"
"02720","2024","COM","2022","2061","89","2150","2024-12-30"
"02721","2024","COM","2022","490","9","499","2024-12-30"
"02722","2024","COM","2022","28667","653","29320","2024-12-30"
"02723","2024","COM","2022","96","1","97","2024-12-30"
"02724","2024","COM","2022","58","2","60","2024-12-30"
"02725","2024","COM","2022","135","5","140","2024-12-30"
"02726","2024","COM","2022","177","2","179","2024-12-30"
"02727","2024","COM","2022","207","3","210","2024-12-30"
"02728","2024","COM","2022","261","5","266","2024-12-30"
"02729","2024","COM","2022","77","1","78","2024-12-30"
"02730","2024","COM","2022","270","6","276","2024-12-30"
"02731","2024","COM","2022","166","3","169","2024-12-30"
"02732","2024","COM","2022","98","3","101","2024-12-30"
"02734","2024","COM","2022","262","4","266","2024-12-30"
"02735","2024","COM","2022","16","0","16","2024-12-30"
"02736","2024","COM","2022","165","5","170","2024-12-30"
"02737","2024","COM","2022","549","13","562","2024-12-30"
"02738","2024","COM","2022","13261","208","13469","2024-12-30"
"02739","2024","COM","2022","326","7","333","2024-12-30"
"02740","2024","COM","2022","221","7","228","2024-12-30"
"02741","2024","COM","2022","542","5","547","2024-12-30"
"02742","2024","COM","2022","120","0","120","2024-12-30"
"02743","2024","COM","2022","155","5","160","2024-12-30"
"02744","2024","COM","2022","77","1","78","2024-12-30"
"02745","2024","COM","2022","112","1","113","2024-12-30"
"02746","2024","COM","2022","683","10","693","2024-12-30"
"02747","2024","COM","2022","81","2","83","2024-12-30"
"02748","2024","COM","2022","948","21","969","2024-12-30"
"02749","2024","COM","2022","211","10","221","2024-12-30"
"02750","2024","COM","2022","551","8","559","2024-12-30"
"02751","2024","COM","2022","141","2","143","2024-12-30"
"02752","2024","COM","2022","283","4","287","2024-12-30"
"02753","2024","COM","2022","335","3","338","2024-12-30"
"02754","2024","COM","2022","186","3","189","2024-12-30"
"02755","2024","COM","2022","539","12","551","2024-12-30"
"02756","2024","COM","2022","688","11","699","2024-12-30"
"02757","2024","COM","2022","511","14","525","2024-12-30"
"02758","2024","COM","2022","2019","39","2058","2024-12-30"
"02759","2024","COM","2022","358","5","363","2024-12-30"
"02760","2024","COM","2022","147","3","150","2024-12-30"
"02761","2024","COM","2022","218","4","222","2024-12-30"
"02762","2024","COM","2022","171","2","173","2024-12-30"
"02763","2024","COM","2022","204","5","209","2024-12-30"
"02764","2024","COM","2022","92","2","94","2024-12-30"
"02765","2024","COM","2022","233","10","243","2024-12-30"
"02766","2024","COM","2022","238","6","244","2024-12-30"
"02767","2024","COM","2022","325","4","329","2024-12-30"
"02768","2024","COM","2022","504","9","513","2024-12-30"
"02769","2024","COM","2022","923","17","940","2024-12-30"
"02770","2024","COM","2022","771","12","783","2024-12-30"
"02772","2024","COM","2022","142","5","147","2024-12-30"
"02773","2024","COM","2022","44","0","44","2024-12-30"
"02774","2024","COM","2022","122","1","123","2024-12-30"
"02775","2024","COM","2022","926","17","943","2024-12-30"
"02776","2024","COM","2022","574","8","582","2024-12-30"
"02777","2024","COM","2022","129","6","135","2024-12-30"
"02778","2024","COM","2022","99","1","100","2024-12-30"
"02779","2024","COM","2022","225","3","228","2024-12-30"
"02780","2024","COM","2022","1333","25","1358","2024-12-30"
"02781","2024","COM","2022","455","15","470","2024-12-30"
"02782","2024","COM","2022","215","1","216","2024-12-30"
"02783","2024","COM","2022","134","0","134","2024-12-30"
"02784","2024","COM","2022","156","2","158","2024-12-30"
"02785","2024","COM","2022","1102","27","1129","2024-12-30"
"02786","2024","COM","2022","136","2","138","2024-12-30"
"02787","2024","COM","2022","255","4","259","2024-12-30"
"02788","2024","COM","2022","467","8","475","2024-12-30"
"02789","2024","COM","2022","2574","74","2648","2024-12-30"
"02790","2024","COM","2022","243","3","246","2024-12-30"
"02791","2024","COM","2022","269","6","275","2024-12-30"
"02792","2024","COM","2022","155","2","157","2024-12-30"
"02793","2024","COM","2022","114","0","114","2024-12-30"
"02794","2024","COM","2022","184","8","192","2024-12-30"
"02795","2024","COM","2022","1610","20","1630","2024-12-30"
"02796","2024","COM","2022","93","2","95","2024-12-30"
"02797","2024","COM","2022","172","0","172","2024-12-30"
"02798","2024","COM","2022","1199","19","1218","2024-12-30"
"02799","2024","COM","2022","378","9","387","2024-12-30"
"02800","2024","COM","2022","314","5","319","2024-12-30"
"02801","2024","COM","2022","266","5","271","2024-12-30"
"02802","2024","COM","2022","203","2","205","2024-12-30"
"02803","2024","COM","2022","148","0","148","2024-12-30"
"02804","2024","COM","2022","210","4","214","2024-12-30"
"02805","2024","COM","2022","2585","38","2623","2024-12-30"
"02806","2024","COM","2022","285","5","290","2024-12-30"
"02807","2024","COM","2022","675","22","697","2024-12-30"
"02808","2024","COM","2022","268","5","273","2024-12-30"
"02809","2024","COM","2022","70","2","72","2024-12-30"
"02810","2024","COM","2022","10376","397","10773","2024-12-30"
"02812","2024","COM","2022","194","6","200","2024-12-30"
"02813","2024","COM","2022","256","7","263","2024-12-30"
"02814","2024","COM","2022","160","0","160","2024-12-30"
"02815","2024","COM","2022","419","15","434","2024-12-30"
"02816","2024","COM","2022","517","5","522","2024-12-30"
"02817","2024","COM","2022","83","1","84","2024-12-30"
"02818","2024","COM","2022","1074","17","1091","2024-12-30"
"02819","2024","COM","2022","103","4","107","2024-12-30"
"02820","2024","COM","2022","1682","41","1723","2024-12-30"
"02821","2024","COM","2022","662","19","681","2024-12-30"
"02822","2024","COM","2022","409","8","417","2024-12-30"
"02823","2024","COM","2022","76","0","76","2024-12-30"
"02824","2024","COM","2022","383","7","390","2024-12-30"
"02826","2024","COM","2022","348","9","357","2024-12-30"
"02827","2024","COM","2022","309","3","312","2024-12-30"
"02828","2024","COM","2022","90","1","91","2024-12-30"
"02829","2024","COM","2022","43","3","46","2024-12-30"
"02830","2024","COM","2022","946","21","967","2024-12-30"
"02831","2024","COM","2022","359","7","366","2024-12-30"
"02832","2024","COM","2022","181","3","184","2024-12-30"
"02833","2024","COM","2022","464","8","472","2024-12-30"
"02834","2024","COM","2022","154","3","157","2024-12-30"
"03001","2024","COM","2022","2927","64","2991","2024-12-30"
"03002","2024","COM","2022","304","12","316","2024-12-30"
"03003","2024","COM","2022","987","16","1003","2024-12-30"
"03004","2024","COM","2022","217","5","222","2024-12-30"
"03005","2024","COM","2022","336","4","340","2024-12-30"
"03006","2024","COM","2022","610","17","627","2024-12-30"
"03007","2024","COM","2022","374","9","383","2024-12-30"
"03008","2024","COM","2022","382","9","391","2024-12-30"
"03009","2024","COM","2022","146","34","180","2024-12-30"
"03010","2024","COM","2022","408","9","417","2024-12-30"
"03011","2024","COM","2022","411","11","422","2024-12-30"
"03012","2024","COM","2022","309","6","315","2024-12-30"
"03013","2024","COM","2022","4109","97","4206","2024-12-30"
"03014","2024","COM","2022","137","1","138","2024-12-30"
"03015","2024","COM","2022","339","11","350","2024-12-30"
"03016","2024","COM","2022","142","2","144","2024-12-30"
"03017","2024","COM","2022","185","6","191","2024-12-30"
"03018","2024","COM","2022","673","14","687","2024-12-30"
"03019","2024","COM","2022","1640","40","1680","2024-12-30"
"03020","2024","COM","2022","293","3","296","2024-12-30"
"03021","2024","COM","2022","229","3","232","2024-12-30"
"03022","2024","COM","2022","986","15","1001","2024-12-30"
"03023","2024","COM","2022","8898","237","9135","2024-12-30"
"03024","2024","COM","2022","261","2","263","2024-12-30"
"03025","2024","COM","2022","1384","25","1409","2024-12-30"
"03026","2024","COM","2022","746","21","767","2024-12-30"
"03027","2024","COM","2022","917","21","938","2024-12-30"
"03028","2024","COM","2022","361","6","367","2024-12-30"
"03029","2024","COM","2022","823","12","835","2024-12-30"
"03030","2024","COM","2022","923","18","941","2024-12-30"
"03031","2024","COM","2022","300","10","310","2024-12-30"
"03032","2024","COM","2022","229","4","233","2024-12-30"
"03033","2024","COM","2022","180","6","186","2024-12-30"
"03034","2024","COM","2022","499","9","508","2024-12-30"
"03035","2024","COM","2022","193","3","196","2024-12-30"
"03036","2024","COM","2022","2542","66","2608","2024-12-30"
"03037","2024","COM","2022","259","0","259","2024-12-30"
"03038","2024","COM","2022","529","7","536","2024-12-30"
"03039","2024","COM","2022","385","9","394","2024-12-30"
"03040","2024","COM","2022","1141","37","1178","2024-12-30"
"03041","2024","COM","2022","324","8","332","2024-12-30"
"03042","2024","COM","2022","531","9","540","2024-12-30"
"03043","2024","COM","2022","1209","82","1291","2024-12-30"
"03044","2024","COM","2022","1556","30","1586","2024-12-30"
"03045","2024","COM","2022","810","20","830","2024-12-30"
"03046","2024","COM","2022","1001","22","1023","2024-12-30"
"03047","2024","COM","2022","400","4","404","2024-12-30"
"03048","2024","COM","2022","1312","13","1325","2024-12-30"
"03049","2024","COM","2022","428","10","438","2024-12-30"
"03050","2024","COM","2022","172","9","181","2024-12-30"
"03051","2024","COM","2022","279","6","285","2024-12-30"
"03052","2024","COM","2022","1079","27","1106","2024-12-30"
"03053","2024","COM","2022","1124","21","1145","2024-12-30"
"03054","2024","COM","2022","236","7","243","2024-12-30"
"03055","2024","COM","2022","941","12","953","2024-12-30"
"03056","2024","COM","2022","396","7","403","2024-12-30"
"03057","2024","COM","2022","197","5","202","2024-12-30"
"03058","2024","COM","2022","231","3","234","2024-12-30"
"03059","2024","COM","2022","385","8","393","2024-12-30"
"03060","2024","COM","2022","967","10","977","2024-12-30"
"03061","2024","COM","2022","374","10","384","2024-12-30"
"03062","2024","COM","2022","340","17","357","2024-12-30"
"03063","2024","COM","2022","1030","19","1049","2024-12-30"
"03064","2024","COM","2022","163","5","168","2024-12-30"
"03065","2024","COM","2022","557","9","566","2024-12-30"
"03066","2024","COM","2022","321","7","328","2024-12-30"
"03067","2024","COM","2022","132","3","135","2024-12-30"
"03068","2024","COM","2022","114","1","115","2024-12-30"
"03069","2024","COM","2022","313","6","319","2024-12-30"
"03070","2024","COM","2022","139","4","143","2024-12-30"
"03071","2024","COM","2022","262","7","269","2024-12-30"
"03072","2024","COM","2022","504","10","514","2024-12-30"
"03073","2024","COM","2022","588","10","598","2024-12-30"
"03074","2024","COM","2022","635","17","652","2024-12-30"
"03075","2024","COM","2022","158","2","160","2024-12-30"
"03076","2024","COM","2022","214","7","221","2024-12-30"
"03077","2024","COM","2022","128","2","130","2024-12-30"
"03078","2024","COM","2022","230","5","235","2024-12-30"
"03079","2024","COM","2022","282","6","288","2024-12-30"
"03080","2024","COM","2022","707","14","721","2024-12-30"
"03081","2024","COM","2022","328","5","333","2024-12-30"
"03082","2024","COM","2022","6018","174","6192","2024-12-30"
"03083","2024","COM","2022","575","14","589","2024-12-30"
"03084","2024","COM","2022","2013","26","2039","2024-12-30"
"03085","2024","COM","2022","634","52","686","2024-12-30"
"03086","2024","COM","2022","292","7","299","2024-12-30"
"03087","2024","COM","2022","592","10","602","2024-12-30"
"03088","2024","COM","2022","309","4","313","2024-12-30"
"03089","2024","COM","2022","158","7","165","2024-12-30"
"03090","2024","COM","2022","321","7","328","2024-12-30"
"03091","2024","COM","2022","430","7","437","2024-12-30"
"03092","2024","COM","2022","637","11","648","2024-12-30"
"03093","2024","COM","2022","1235","27","1262","2024-12-30"
"03094","2024","COM","2022","3246","99","3345","2024-12-30"
"03095","2024","COM","2022","13329","496","13825","2024-12-30"
"03096","2024","COM","2022","93","3","96","2024-12-30"
"03097","2024","COM","2022","352","11","363","2024-12-30"
"03098","2024","COM","2022","4323","92","4415","2024-12-30"
"03099","2024","COM","2022","380","10","390","2024-12-30"
"03100","2024","COM","2022","1354","35","1389","2024-12-30"
"03101","2024","COM","2022","8665","182","8847","2024-12-30"
"03102","2024","COM","2022","2970","48","3018","2024-12-30"
"03103","2024","COM","2022","1011","14","1025","2024-12-30"
"03104","2024","COM","2022","1129","25","1154","2024-12-30"
"03105","2024","COM","2022","367","7","374","2024-12-30"
"03106","2024","COM","2022","1317","105","1422","2024-12-30"
"03107","2024","COM","2022","1292","23","1315","2024-12-30"
"03108","2024","COM","2022","369","7","376","2024-12-30"
"03109","2024","COM","2022","797","34","831","2024-12-30"
"03110","2024","COM","2022","973","26","999","2024-12-30"
"03111","2024","COM","2022","1114","24","1138","2024-12-30"
"03112","2024","COM","2022","663","9","672","2024-12-30"
"03113","2024","COM","2022","506","13","519","2024-12-30"
"03114","2024","COM","2022","260","7","267","2024-12-30"
"03115","2024","COM","2022","339","6","345","2024-12-30"
"03116","2024","COM","2022","191","3","194","2024-12-30"
"03117","2024","COM","2022","465","8","473","2024-12-30"
"03118","2024","COM","2022","5684","190","5874","2024-12-30"
"03119","2024","COM","2022","394","8","402","2024-12-30"
"03120","2024","COM","2022","672","15","687","2024-12-30"
"03121","2024","COM","2022","624","17","641","2024-12-30"
"03122","2024","COM","2022","236","6","242","2024-12-30"
"03124","2024","COM","2022","220","3","223","2024-12-30"
"03125","2024","COM","2022","122","2","124","2024-12-30"
"03126","2024","COM","2022","1186","14","1200","2024-12-30"
"03127","2024","COM","2022","564","13","577","2024-12-30"
"03128","2024","COM","2022","2568","46","2614","2024-12-30"
"03129","2024","COM","2022","301","10","311","2024-12-30"
"03130","2024","COM","2022","278","5","283","2024-12-30"
"03131","2024","COM","2022","560","8","568","2024-12-30"
"03132","2024","COM","2022","556","9","565","2024-12-30"
"03133","2024","COM","2022","521","12","533","2024-12-30"
"03134","2024","COM","2022","183","1","184","2024-12-30"
"03135","2024","COM","2022","407","7","414","2024-12-30"
"03136","2024","COM","2022","206","8","214","2024-12-30"
"03137","2024","COM","2022","274","1","275","2024-12-30"
"03138","2024","COM","2022","3127","66","3193","2024-12-30"
"03139","2024","COM","2022","310","5","315","2024-12-30"
"03140","2024","COM","2022","1138","15","1153","2024-12-30"
"03141","2024","COM","2022","152","1","153","2024-12-30"
"03142","2024","COM","2022","250","3","253","2024-12-30"
"03143","2024","COM","2022","91","3","94","2024-12-30"
"03144","2024","COM","2022","199","6","205","2024-12-30"
"03145","2024","COM","2022","758","12","770","2024-12-30"
"03146","2024","COM","2022","176","34","210","2024-12-30"
"03147","2024","COM","2022","167","3","170","2024-12-30"
"03148","2024","COM","2022","354","5","359","2024-12-30"
"03149","2024","COM","2022","406","12","418","2024-12-30"
"03150","2024","COM","2022","206","5","211","2024-12-30"
"03151","2024","COM","2022","180","7","187","2024-12-30"
"03152","2024","COM","2022","228","7","235","2024-12-30"
"03154","2024","COM","2022","269","3","272","2024-12-30"
"03155","2024","COM","2022","1852","36","1888","2024-12-30"
"03156","2024","COM","2022","1633","51","1684","2024-12-30"
"03157","2024","COM","2022","1046","19","1065","2024-12-30"
"03158","2024","COM","2022","850","14","864","2024-12-30"
"03159","2024","COM","2022","768","16","784","2024-12-30"
"03160","2024","COM","2022","376","5","381","2024-12-30"
"03161","2024","COM","2022","907","25","932","2024-12-30"
"03162","2024","COM","2022","200","4","204","2024-12-30"
"03163","2024","COM","2022","696","23","719","2024-12-30"
"03164","2024","COM","2022","305","4","309","2024-12-30"
"03165","2024","COM","2022","1388","88","1476","2024-12-30"
"03166","2024","COM","2022","320","8","328","2024-12-30"
"03167","2024","COM","2022","280","4","284","2024-12-30"
"03168","2024","COM","2022","907","12","919","2024-12-30"
"03169","2024","COM","2022","307","8","315","2024-12-30"
"03170","2024","COM","2022","128","2","130","2024-12-30"
"03171","2024","COM","2022","244","6","250","2024-12-30"
"03172","2024","COM","2022","125","3","128","2024-12-30"
"03173","2024","COM","2022","1120","22","1142","2024-12-30"
"03174","2024","COM","2022","916","22","938","2024-12-30"
"03175","2024","COM","2022","280","9","289","2024-12-30"
"03176","2024","COM","2022","538","13","551","2024-12-30"
"03177","2024","COM","2022","249","8","257","2024-12-30"
"03178","2024","COM","2022","285","5","290","2024-12-30"
"03179","2024","COM","2022","301","4","305","2024-12-30"
"03180","2024","COM","2022","645","13","658","2024-12-30"
"03181","2024","COM","2022","295","3","298","2024-12-30"
"03182","2024","COM","2022","267","2","269","2024-12-30"
"03183","2024","COM","2022","469","3","472","2024-12-30"
"03184","2024","COM","2022","496","17","513","2024-12-30"
"03185","2024","COM","2022","33317","1026","34343","2024-12-30"
"03186","2024","COM","2022","1522","15","1537","2024-12-30"
"03187","2024","COM","2022","602","7","609","2024-12-30"
"03188","2024","COM","2022","209","3","212","2024-12-30"
"03189","2024","COM","2022","697","24","721","2024-12-30"
"03190","2024","COM","2022","19344","546","19890","2024-12-30"
"03191","2024","COM","2022","267","6","273","2024-12-30"
"03192","2024","COM","2022","158","2","160","2024-12-30"
"03193","2024","COM","2022","195","4","199","2024-12-30"
"03194","2024","COM","2022","137","1","138","2024-12-30"
"03195","2024","COM","2022","2441","74","2515","2024-12-30"
"03196","2024","COM","2022","198","6","204","2024-12-30"
"03197","2024","COM","2022","1440","27","1467","2024-12-30"
"03198","2024","COM","2022","201","4","205","2024-12-30"
"03200","2024","COM","2022","1487","258","1745","2024-12-30"
"03201","2024","COM","2022","288","11","299","2024-12-30"
"03202","2024","COM","2022","599","9","608","2024-12-30"
"03203","2024","COM","2022","379","5","384","2024-12-30"
"03204","2024","COM","2022","615","13","628","2024-12-30"
"03205","2024","COM","2022","470","12","482","2024-12-30"
"03206","2024","COM","2022","165","4","169","2024-12-30"
"03207","2024","COM","2022","509","8","517","2024-12-30"
"03208","2024","COM","2022","431","10","441","2024-12-30"
"03209","2024","COM","2022","152","4","156","2024-12-30"
"03210","2024","COM","2022","383","4","387","2024-12-30"
"03211","2024","COM","2022","2513","49","2562","2024-12-30"
"03212","2024","COM","2022","1539","22","1561","2024-12-30"
"03213","2024","COM","2022","262","4","266","2024-12-30"
"03214","2024","COM","2022","330","4","334","2024-12-30"
"03215","2024","COM","2022","552","4","556","2024-12-30"
"03216","2024","COM","2022","168","2","170","2024-12-30"
"03217","2024","COM","2022","753","33","786","2024-12-30"
"03218","2024","COM","2022","266","8","274","2024-12-30"
"03219","2024","COM","2022","223","3","226","2024-12-30"
"03220","2024","COM","2022","714","15","729","2024-12-30"
"03221","2024","COM","2022","739","7","746","2024-12-30"
"03222","2024","COM","2022","97","1","98","2024-12-30"
"03223","2024","COM","2022","431","15","446","2024-12-30"
"03224","2024","COM","2022","284","2","286","2024-12-30"
"03225","2024","COM","2022","429","11","440","2024-12-30"
"03226","2024","COM","2022","245","3","248","2024-12-30"
"03227","2024","COM","2022","388","9","397","2024-12-30"
"03228","2024","COM","2022","56","0","56","2024-12-30"
"03229","2024","COM","2022","619","17","636","2024-12-30"
"03230","2024","COM","2022","527","4","531","2024-12-30"
"03231","2024","COM","2022","187","11","198","2024-12-30"
"03232","2024","COM","2022","285","6","291","2024-12-30"
"03233","2024","COM","2022","388","7","395","2024-12-30"
"03234","2024","COM","2022","395","6","401","2024-12-30"
"03235","2024","COM","2022","956","18","974","2024-12-30"
"03236","2024","COM","2022","3600","51","3651","2024-12-30"
"03237","2024","COM","2022","426","11","437","2024-12-30"
"03238","2024","COM","2022","508","9","517","2024-12-30"
"03239","2024","COM","2022","259","10","269","2024-12-30"
"03240","2024","COM","2022","533","16","549","2024-12-30"
"03241","2024","COM","2022","364","47","411","2024-12-30"
"03242","2024","COM","2022","572","6","578","2024-12-30"
"03243","2024","COM","2022","129","2","131","2024-12-30"
"03244","2024","COM","2022","128","5","133","2024-12-30"
"03245","2024","COM","2022","125","1","126","2024-12-30"
"03246","2024","COM","2022","595","7","602","2024-12-30"
"03247","2024","COM","2022","1135","29","1164","2024-12-30"
"03248","2024","COM","2022","153","6","159","2024-12-30"
"03249","2024","COM","2022","157","2","159","2024-12-30"
"03250","2024","COM","2022","365","10","375","2024-12-30"
"03251","2024","COM","2022","423","7","430","2024-12-30"
"03252","2024","COM","2022","692","17","709","2024-12-30"
"03253","2024","COM","2022","368","10","378","2024-12-30"
"03254","2024","COM","2022","4894","132","5026","2024-12-30"
"03255","2024","COM","2022","146","3","149","2024-12-30"
"03256","2024","COM","2022","213","5","218","2024-12-30"
"03257","2024","COM","2022","785","23","808","2024-12-30"
"03258","2024","COM","2022","1769","27","1796","2024-12-30"
"03259","2024","COM","2022","324","5","329","2024-12-30"
"03260","2024","COM","2022","220","6","226","2024-12-30"
"03261","2024","COM","2022","179","8","187","2024-12-30"
"03262","2024","COM","2022","2078","50","2128","2024-12-30"
"03263","2024","COM","2022","201","7","208","2024-12-30"
"03264","2024","COM","2022","2618","49","2667","2024-12-30"
"03265","2024","COM","2022","648","76","724","2024-12-30"
"03266","2024","COM","2022","277","7","284","2024-12-30"
"03267","2024","COM","2022","651","21","672","2024-12-30"
"03268","2024","COM","2022","392","9","401","2024-12-30"
"03269","2024","COM","2022","83","2","85","2024-12-30"
"03270","2024","COM","2022","140","1","141","2024-12-30"
"03271","2024","COM","2022","826","32","858","2024-12-30"
"03272","2024","COM","2022","273","6","279","2024-12-30"
"03273","2024","COM","2022","483","16","499","2024-12-30"
"03274","2024","COM","2022","321","5","326","2024-12-30"
"03275","2024","COM","2022","1717","51","1768","2024-12-30"
"03276","2024","COM","2022","105","2","107","2024-12-30"
"03277","2024","COM","2022","247","4","251","2024-12-30"
"03278","2024","COM","2022","211","3","214","2024-12-30"
"03279","2024","COM","2022","553","8","561","2024-12-30"
"03280","2024","COM","2022","181","5","186","2024-12-30"
"03281","2024","COM","2022","388","6","394","2024-12-30"
"03282","2024","COM","2022","340","4","344","2024-12-30"
"03283","2024","COM","2022","1036","20","1056","2024-12-30"
"03284","2024","COM","2022","282","7","289","2024-12-30"
"03285","2024","COM","2022","175","9","184","2024-12-30"
"03286","2024","COM","2022","1171","17","1188","2024-12-30"
"03287","2024","COM","2022","376","6","382","2024-12-30"
"03288","2024","COM","2022","416","9","425","2024-12-30"
"03289","2024","COM","2022","517","12","529","2024-12-30"
"03290","2024","COM","2022","1639","49","1688","2024-12-30"
"03291","2024","COM","2022","393","11","404","2024-12-30"
"03292","2024","COM","2022","889","12","901","2024-12-30"
"03293","2024","COM","2022","296","6","302","2024-12-30"
"03294","2024","COM","2022","168","5","173","2024-12-30"
"03295","2024","COM","2022","65","1","66","2024-12-30"
"03296","2024","COM","2022","376","5","381","2024-12-30"
"03297","2024","COM","2022","1468","28","1496","2024-12-30"
"03298","2024","COM","2022","3588","54","3642","2024-12-30"
"03299","2024","COM","2022","225","7","232","2024-12-30"
"03300","2024","COM","2022","538","13","551","2024-12-30"
"03301","2024","COM","2022","1164","24","1188","2024-12-30"
"03302","2024","COM","2022","39","0","39","2024-12-30"
"03303","2024","COM","2022","224","13","237","2024-12-30"
"03304","2024","COM","2022","2269","67","2336","2024-12-30"
"03305","2024","COM","2022","577","11","588","2024-12-30"
"03306","2024","COM","2022","1914","50","1964","2024-12-30"
"03307","2024","COM","2022","237","6","243","2024-12-30"
"03308","2024","COM","2022","150","4","154","2024-12-30"
"03309","2024","COM","2022","476","5","481","2024-12-30"
"03310","2024","COM","2022","25702","315","26017","2024-12-30"
"03311","2024","COM","2022","294","5","299","2024-12-30"
"03312","2024","COM","2022","276","11","287","2024-12-30"
"03313","2024","COM","2022","269","3","272","2024-12-30"
"03314","2024","COM","2022","1333","40","1373","2024-12-30"
"03315","2024","COM","2022","1265","39","1304","2024-12-30"
"03316","2024","COM","2022","1037","18","1055","2024-12-30"
"03317","2024","COM","2022","293","7","300","2024-12-30"
"03319","2024","COM","2022","493","9","502","2024-12-30"
"03320","2024","COM","2022","778","12","790","2024-12-30"
"03321","2024","COM","2022","12670","546","13216","2024-12-30"
"04001","2024","COM","2022","1406","24","1430","2024-12-30"
"04004","2024","COM","2022","539","16","555","2024-12-30"
"04005","2024","COM","2022","125","5","130","2024-12-30"
"04006","2024","COM","2022","816","7","823","2024-12-30"
"04007","2024","COM","2022","70","1","71","2024-12-30"
"04008","2024","COM","2022","1013","29","1042","2024-12-30"
"04009","2024","COM","2022","14","1","15","2024-12-30"
"04012","2024","COM","2022","85","1","86","2024-12-30"
"04013","2024","COM","2022","624","15","639","2024-12-30"
"04016","2024","COM","2022","59","0","59","2024-12-30"
"04017","2024","COM","2022","102","3","105","2024-12-30"
"04018","2024","COM","2022","1070","21","1091","2024-12-30"
"04019","2024","COM","2022","2528","173","2701","2024-12-30"
"04020","2024","COM","2022","124","1","125","2024-12-30"
"04021","2024","COM","2022","142","4","146","2024-12-30"
"04022","2024","COM","2022","402","6","408","2024-12-30"
"04023","2024","COM","2022","202","4","206","2024-12-30"
"04024","2024","COM","2022","122","3","125","2024-12-30"
"04025","2024","COM","2022","387","12","399","2024-12-30"
"04026","2024","COM","2022","158","2","160","2024-12-30"
"04027","2024","COM","2022","256","60","316","2024-12-30"
"04028","2024","COM","2022","121","2","123","2024-12-30"
"04030","2024","COM","2022","52","1","53","2024-12-30"
"04031","2024","COM","2022","559","14","573","2024-12-30"
"04032","2024","COM","2022","134","3","137","2024-12-30"
"04033","2024","COM","2022","796","20","816","2024-12-30"
"04034","2024","COM","2022","1114","16","1130","2024-12-30"
"04035","2024","COM","2022","293","5","298","2024-12-30"
"04036","2024","COM","2022","967","29","996","2024-12-30"
"04037","2024","COM","2022","77","1","78","2024-12-30"
"04039","2024","COM","2022","1454","40","1494","2024-12-30"
"04040","2024","COM","2022","62","2","64","2024-12-30"
"04041","2024","COM","2022","300","6","306","2024-12-30"
"04042","2024","COM","2022","140","3","143","2024-12-30"
"04043","2024","COM","2022","83","0","83","2024-12-30"
"04045","2024","COM","2022","1195","24","1219","2024-12-30"
"04046","2024","COM","2022","689","104","793","2024-12-30"
"04047","2024","COM","2022","785","20","805","2024-12-30"
"04049","2024","COM","2022","5095","123","5218","2024-12-30"
"04050","2024","COM","2022","25","0","25","2024-12-30"
"04051","2024","COM","2022","75","2","77","2024-12-30"
"04053","2024","COM","2022","529","12","541","2024-12-30"
"04054","2024","COM","2022","74","0","74","2024-12-30"
"04055","2024","COM","2022","180","4","184","2024-12-30"
"04057","2024","COM","2022","180","3","183","2024-12-30"
"04058","2024","COM","2022","296","5","301","2024-12-30"
"04059","2024","COM","2022","221","3","224","2024-12-30"
"04061","2024","COM","2022","548","8","556","2024-12-30"
"04062","2024","COM","2022","156","3","159","2024-12-30"
"04063","2024","COM","2022","1285","37","1322","2024-12-30"
"04065","2024","COM","2022","646","10","656","2024-12-30"
"04066","2024","COM","2022","577","12","589","2024-12-30"
"04067","2024","COM","2022","59","1","60","2024-12-30"
"04068","2024","COM","2022","837","13","850","2024-12-30"
"04069","2024","COM","2022","111","5","116","2024-12-30"
"04070","2024","COM","2022","17694","853","18547","2024-12-30"
"04072","2024","COM","2022","113","2","115","2024-12-30"
"04073","2024","COM","2022","397","2","399","2024-12-30"
"04074","2024","COM","2022","100","2","102","2024-12-30"
"04075","2024","COM","2022","409","10","419","2024-12-30"
"04076","2024","COM","2022","791","20","811","2024-12-30"
"04077","2024","COM","2022","169","3","172","2024-12-30"
"04079","2024","COM","2022","1402","31","1433","2024-12-30"
"04081","2024","COM","2022","382","8","390","2024-12-30"
"04084","2024","COM","2022","480","7","487","2024-12-30"
"04085","2024","COM","2022","62","2","64","2024-12-30"
"04086","2024","COM","2022","293","15","308","2024-12-30"
"04087","2024","COM","2022","131","2","133","2024-12-30"
"04088","2024","COM","2022","5142","96","5238","2024-12-30"
"04090","2024","COM","2022","200","6","206","2024-12-30"
"04091","2024","COM","2022","90","4","94","2024-12-30"
"04092","2024","COM","2022","126","4","130","2024-12-30"
"04093","2024","COM","2022","59","0","59","2024-12-30"
"04094","2024","COM","2022","3088","39","3127","2024-12-30"
"04095","2024","COM","2022","96","1","97","2024-12-30"
"04096","2024","COM","2022","1142","27","1169","2024-12-30"
"04097","2024","COM","2022","374","7","381","2024-12-30"
"04099","2024","COM","2022","81","6","87","2024-12-30"
"04101","2024","COM","2022","139","0","139","2024-12-30"
"04102","2024","COM","2022","212","3","215","2024-12-30"
"04104","2024","COM","2022","387","11","398","2024-12-30"
"04106","2024","COM","2022","373","10","383","2024-12-30"
"04107","2024","COM","2022","5","0","5","2024-12-30"
"04108","2024","COM","2022","2019","35","2054","2024-12-30"
"04109","2024","COM","2022","325","4","329","2024-12-30"
"04110","2024","COM","2022","968","26","994","2024-12-30"
"04111","2024","COM","2022","1390","26","1416","2024-12-30"
"04112","2024","COM","2022","22807","617","23424","2024-12-30"
"04113","2024","COM","2022","460","15","475","2024-12-30"
"04115","2024","COM","2022","118","2","120","2024-12-30"
"04116","2024","COM","2022","3992","61","4053","2024-12-30"
"04118","2024","COM","2022","127","1","128","2024-12-30"
"04120","2024","COM","2022","98","2","100","2024-12-30"
"04121","2024","COM","2022","617","12","629","2024-12-30"
"04122","2024","COM","2022","508","13","521","2024-12-30"
"04123","2024","COM","2022","1115","28","1143","2024-12-30"
"04124","2024","COM","2022","405","7","412","2024-12-30"
"04126","2024","COM","2022","397","13","410","2024-12-30"
"04127","2024","COM","2022","333","4","337","2024-12-30"
"04128","2024","COM","2022","220","9","229","2024-12-30"
"04129","2024","COM","2022","57","0","57","2024-12-30"
"04130","2024","COM","2022","211","5","216","2024-12-30"
"04132","2024","COM","2022","167","1","168","2024-12-30"
"04133","2024","COM","2022","238","8","246","2024-12-30"
"04134","2024","COM","2022","544","24","568","2024-12-30"
"04135","2024","COM","2022","695","3","698","2024-12-30"
"04136","2024","COM","2022","333","4","337","2024-12-30"
"04137","2024","COM","2022","54","1","55","2024-12-30"
"04138","2024","COM","2022","278","6","284","2024-12-30"
"04139","2024","COM","2022","527","10","537","2024-12-30"
"04140","2024","COM","2022","128","4","132","2024-12-30"
"04141","2024","COM","2022","359","7","366","2024-12-30"
"04142","2024","COM","2022","44","0","44","2024-12-30"
"04143","2024","COM","2022","6042","115","6157","2024-12-30"
"04144","2024","COM","2022","350","3","353","2024-12-30"
"04145","2024","COM","2022","1496","36","1532","2024-12-30"
"04148","2024","COM","2022","248","9","257","2024-12-30"
"04149","2024","COM","2022","2796","45","2841","2024-12-30"
"04150","2024","COM","2022","208","4","212","2024-12-30"
"04151","2024","COM","2022","530","14","544","2024-12-30"
"04152","2024","COM","2022","3943","110","4053","2024-12-30"
"04154","2024","COM","2022","95","1","96","2024-12-30"
"04155","2024","COM","2022","174","4","178","2024-12-30"
"04156","2024","COM","2022","254","1","255","2024-12-30"
"04157","2024","COM","2022","666","9","675","2024-12-30"
"04158","2024","COM","2022","388","8","396","2024-12-30"
"04159","2024","COM","2022","89","0","89","2024-12-30"
"04160","2024","COM","2022","1730","34","1764","2024-12-30"
"04161","2024","COM","2022","323","7","330","2024-12-30"
"04162","2024","COM","2022","264","4","268","2024-12-30"
"04163","2024","COM","2022","487","12","499","2024-12-30"
"04164","2024","COM","2022","82","1","83","2024-12-30"
"04166","2024","COM","2022","1625","39","1664","2024-12-30"
"04167","2024","COM","2022","292","4","296","2024-12-30"
"04169","2024","COM","2022","108","2","110","2024-12-30"
"04170","2024","COM","2022","72","0","72","2024-12-30"
"04171","2024","COM","2022","120","0","120","2024-12-30"
"04172","2024","COM","2022","732","13","745","2024-12-30"
"04173","2024","COM","2022","1030","23","1053","2024-12-30"
"04174","2024","COM","2022","166","1","167","2024-12-30"
"04175","2024","COM","2022","86","2","88","2024-12-30"
"04176","2024","COM","2022","115","4","119","2024-12-30"
"04177","2024","COM","2022","50","2","52","2024-12-30"
"04178","2024","COM","2022","1297","28","1325","2024-12-30"
"04179","2024","COM","2022","107","2","109","2024-12-30"
"04180","2024","COM","2022","72","2","74","2024-12-30"
"04181","2024","COM","2022","48","1","49","2024-12-30"
"04182","2024","COM","2022","226","4","230","2024-12-30"
"04183","2024","COM","2022","176","2","178","2024-12-30"
"04184","2024","COM","2022","137","1","138","2024-12-30"
"04186","2024","COM","2022","89","1","90","2024-12-30"
"04187","2024","COM","2022","38","0","38","2024-12-30"
"04188","2024","COM","2022","904","17","921","2024-12-30"
"04189","2024","COM","2022","632","14","646","2024-12-30"
"04190","2024","COM","2022","123","0","123","2024-12-30"
"04191","2024","COM","2022","9","0","9","2024-12-30"
"04192","2024","COM","2022","1278","14","1292","2024-12-30"
"04193","2024","COM","2022","195","6","201","2024-12-30"
"04194","2024","COM","2022","97","3","100","2024-12-30"
"04195","2024","COM","2022","613","13","626","2024-12-30"
"04197","2024","COM","2022","3530","87","3617","2024-12-30"
"04199","2024","COM","2022","168","5","173","2024-12-30"
"04200","2024","COM","2022","679","21","700","2024-12-30"
"04201","2024","COM","2022","125","2","127","2024-12-30"
"04202","2024","COM","2022","129","2","131","2024-12-30"
"04203","2024","COM","2022","451","11","462","2024-12-30"
"04204","2024","COM","2022","156","4","160","2024-12-30"
"04205","2024","COM","2022","1365","30","1395","2024-12-30"
"04206","2024","COM","2022","421","8","429","2024-12-30"
"04207","2024","COM","2022","101","4","105","2024-12-30"
"04208","2024","COM","2022","608","12","620","2024-12-30"
"04209","2024","COM","2022","7776","244","8020","2024-12-30"
"04210","2024","COM","2022","91","1","92","2024-12-30"
"04211","2024","COM","2022","179","3","182","2024-12-30"
"04214","2024","COM","2022","127","3","130","2024-12-30"
"04216","2024","COM","2022","256","6","262","2024-12-30"
"04217","2024","COM","2022","741","18","759","2024-12-30"
"04218","2024","COM","2022","208","6","214","2024-12-30"
"04219","2024","COM","2022","247","4","251","2024-12-30"
"04220","2024","COM","2022","365","10","375","2024-12-30"
"04222","2024","COM","2022","345","8","353","2024-12-30"
"04224","2024","COM","2022","99","1","100","2024-12-30"
"04226","2024","COM","2022","502","12","514","2024-12-30"
"04227","2024","COM","2022","318","3","321","2024-12-30"
"04228","2024","COM","2022","39","0","39","2024-12-30"
"04229","2024","COM","2022","239","4","243","2024-12-30"
"04230","2024","COM","2022","3151","64","3215","2024-12-30"
"04231","2024","COM","2022","242","4","246","2024-12-30"
"04233","2024","COM","2022","268","8","276","2024-12-30"
"04234","2024","COM","2022","226","2","228","2024-12-30"
"04235","2024","COM","2022","60","1","61","2024-12-30"
"04236","2024","COM","2022","114","0","114","2024-12-30"
"04237","2024","COM","2022","124","3","127","2024-12-30"
"04240","2024","COM","2022","254","3","257","2024-12-30"
"04241","2024","COM","2022","193","2","195","2024-12-30"
"04242","2024","COM","2022","4386","85","4471","2024-12-30"
"04244","2024","COM","2022","1637","33","1670","2024-12-30"
"04245","2024","COM","2022","3227","75","3302","2024-12-30"
"05001","2024","COM","2022","379","4","383","2024-12-30"
"05003","2024","COM","2022","374","11","385","2024-12-30"
"05004","2024","COM","2022","966","20","986","2024-12-30"
"05006","2024","COM","2022","2278","69","2347","2024-12-30"
"05007","2024","COM","2022","343","8","351","2024-12-30"
"05008","2024","COM","2022","362","6","368","2024-12-30"
"05009","2024","COM","2022","93","3","96","2024-12-30"
"05010","2024","COM","2022","802","12","814","2024-12-30"
"05011","2024","COM","2022","418","9","427","2024-12-30"
"05012","2024","COM","2022","643","14","657","2024-12-30"
"05013","2024","COM","2022","140","1","141","2024-12-30"
"05014","2024","COM","2022","192","4","196","2024-12-30"
"05016","2024","COM","2022","288","4","292","2024-12-30"
"05017","2024","COM","2022","2611","72","2683","2024-12-30"
"05018","2024","COM","2022","325","10","335","2024-12-30"
"05019","2024","COM","2022","150","3","153","2024-12-30"
"05021","2024","COM","2022","139","1","140","2024-12-30"
"05022","2024","COM","2022","236","6","242","2024-12-30"
"05023","2024","COM","2022","10748","311","11059","2024-12-30"
"05024","2024","COM","2022","209","5","214","2024-12-30"
"05025","2024","COM","2022","194","3","197","2024-12-30"
"05026","2024","COM","2022","271","5","276","2024-12-30"
"05027","2024","COM","2022","189","3","192","2024-12-30"
"05028","2024","COM","2022","171","4","175","2024-12-30"
"05029","2024","COM","2022","955","25","980","2024-12-30"
"05031","2024","COM","2022","179","4","183","2024-12-30"
"05032","2024","COM","2022","139","5","144","2024-12-30"
"05033","2024","COM","2022","39","0","39","2024-12-30"
"05035","2024","COM","2022","30","2","32","2024-12-30"
"05036","2024","COM","2022","1223","35","1258","2024-12-30"
"05037","2024","COM","2022","536","15","551","2024-12-30"
"05038","2024","COM","2022","300","16","316","2024-12-30"
"05039","2024","COM","2022","743","16","759","2024-12-30"
"05040","2024","COM","2022","3106","69","3175","2024-12-30"
"05044","2024","COM","2022","122","2","124","2024-12-30"
"05045","2024","COM","2022","1161","23","1184","2024-12-30"
"05046","2024","COM","2022","6387","346","6733","2024-12-30"
"05047","2024","COM","2022","141","3","144","2024-12-30"
"05048","2024","COM","2022","202","5","207","2024-12-30"
"05049","2024","COM","2022","56","2","58","2024-12-30"
"05050","2024","COM","2022","792","11","803","2024-12-30"
"05051","2024","COM","2022","24","0","24","2024-12-30"
"05052","2024","COM","2022","845","22","867","2024-12-30"
"05053","2024","COM","2022","523","10","533","2024-12-30"
"05054","2024","COM","2022","478","10","488","2024-12-30"
"05055","2024","COM","2022","298","4","302","2024-12-30"
"05056","2024","COM","2022","344","6","350","2024-12-30"
"05057","2024","COM","2022","274","6","280","2024-12-30"
"05058","2024","COM","2022","189","4","193","2024-12-30"
"05059","2024","COM","2022","948","20","968","2024-12-30"
"05060","2024","COM","2022","175","4","179","2024-12-30"
"05061","2024","COM","2022","40656","1404","42060","2024-12-30"
"05062","2024","COM","2022","176","3","179","2024-12-30"
"05063","2024","COM","2022","479","9","488","2024-12-30"
"05064","2024","COM","2022","114","2","116","2024-12-30"
"05065","2024","COM","2022","2286","84","2370","2024-12-30"
"05066","2024","COM","2022","7","0","7","2024-12-30"
"05068","2024","COM","2022","465","13","478","2024-12-30"
"05070","2024","COM","2022","3566","51","3617","2024-12-30"
"05071","2024","COM","2022","371","6","377","2024-12-30"
"05072","2024","COM","2022","242","5","247","2024-12-30"
"05073","2024","COM","2022","336","13","349","2024-12-30"
"05074","2024","COM","2022","199","0","199","2024-12-30"
"05075","2024","COM","2022","500","17","517","2024-12-30"
"05076","2024","COM","2022","105","0","105","2024-12-30"
"05077","2024","COM","2022","307","2","309","2024-12-30"
"05078","2024","COM","2022","296","2","298","2024-12-30"
"05079","2024","COM","2022","968","27","995","2024-12-30"
"05080","2024","COM","2022","74","1","75","2024-12-30"
"05081","2024","COM","2022","47","4","51","2024-12-30"
"05082","2024","COM","2022","169","4","173","2024-12-30"
"05084","2024","COM","2022","481","7","488","2024-12-30"
"05085","2024","COM","2022","459","14","473","2024-12-30"
"05086","2024","COM","2022","104","0","104","2024-12-30"
"05087","2024","COM","2022","535","16","551","2024-12-30"
"05089","2024","COM","2022","89","0","89","2024-12-30"
"05090","2024","COM","2022","207","5","212","2024-12-30"
"05091","2024","COM","2022","39","4","43","2024-12-30"
"05092","2024","COM","2022","783","16","799","2024-12-30"
"05093","2024","COM","2022","360","19","379","2024-12-30"
"05094","2024","COM","2022","11","1","12","2024-12-30"
"05095","2024","COM","2022","306","3","309","2024-12-30"
"05096","2024","COM","2022","660","8","668","2024-12-30"
"05097","2024","COM","2022","319","31","350","2024-12-30"
"05098","2024","COM","2022","510","12","522","2024-12-30"
"05099","2024","COM","2022","103","1","104","2024-12-30"
"05100","2024","COM","2022","839","32","871","2024-12-30"
"05101","2024","COM","2022","1133","39","1172","2024-12-30"
"05102","2024","COM","2022","85","3","88","2024-12-30"
"05103","2024","COM","2022","784","25","809","2024-12-30"
"05104","2024","COM","2022","337","15","352","2024-12-30"
"05106","2024","COM","2022","312","4","316","2024-12-30"
"05107","2024","COM","2022","471","11","482","2024-12-30"
"05108","2024","COM","2022","190","6","196","2024-12-30"
"05109","2024","COM","2022","517","18","535","2024-12-30"
"05110","2024","COM","2022","270","4","274","2024-12-30"
"05111","2024","COM","2022","281","4","285","2024-12-30"
"05112","2024","COM","2022","90","0","90","2024-12-30"
"05113","2024","COM","2022","407","12","419","2024-12-30"
"05114","2024","COM","2022","243","1","244","2024-12-30"
"05115","2024","COM","2022","467","9","476","2024-12-30"
"05116","2024","COM","2022","213","2","215","2024-12-30"
"05117","2024","COM","2022","109","2","111","2024-12-30"
"05118","2024","COM","2022","1342","29","1371","2024-12-30"
"05119","2024","COM","2022","663","18","681","2024-12-30"
"05121","2024","COM","2022","197","7","204","2024-12-30"
"05122","2024","COM","2022","896","19","915","2024-12-30"
"05123","2024","COM","2022","1675","46","1721","2024-12-30"
"05124","2024","COM","2022","473","12","485","2024-12-30"
"05126","2024","COM","2022","496","15","511","2024-12-30"
"05127","2024","COM","2022","168","5","173","2024-12-30"
"05128","2024","COM","2022","708","22","730","2024-12-30"
"05129","2024","COM","2022","158","4","162","2024-12-30"
"05130","2024","COM","2022","204","5","209","2024-12-30"
"05131","2024","COM","2022","75","4","79","2024-12-30"
"05132","2024","COM","2022","2081","66","2147","2024-12-30"
"05133","2024","COM","2022","1504","45","1549","2024-12-30"
"05134","2024","COM","2022","332","8","340","2024-12-30"
"05135","2024","COM","2022","63","2","65","2024-12-30"
"05136","2024","COM","2022","716","13","729","2024-12-30"
"05139","2024","COM","2022","885","25","910","2024-12-30"
"05140","2024","COM","2022","335","6","341","2024-12-30"
"05142","2024","COM","2022","449","10","459","2024-12-30"
"05144","2024","COM","2022","115","4","119","2024-12-30"
"05145","2024","COM","2022","1090","98","1188","2024-12-30"
"05146","2024","COM","2022","135","1","136","2024-12-30"
"05147","2024","COM","2022","379","8","387","2024-12-30"
"05148","2024","COM","2022","575","8","583","2024-12-30"
"05149","2024","COM","2022","369","10","379","2024-12-30"
"05151","2024","COM","2022","1122","36","1158","2024-12-30"
"05152","2024","COM","2022","118","1","119","2024-12-30"
"05153","2024","COM","2022","367","5","372","2024-12-30"
"05154","2024","COM","2022","154","0","154","2024-12-30"
"05155","2024","COM","2022","33","1","34","2024-12-30"
"05156","2024","COM","2022","493","12","505","2024-12-30"
"05157","2024","COM","2022","165","5","170","2024-12-30"
"05158","2024","COM","2022","132","1","133","2024-12-30"
"05159","2024","COM","2022","81","3","84","2024-12-30"
"05160","2024","COM","2022","79","1","80","2024-12-30"
"05161","2024","COM","2022","919","21","940","2024-12-30"
"05162","2024","COM","2022","1375","33","1408","2024-12-30"
"05163","2024","COM","2022","158","1","159","2024-12-30"
"05164","2024","COM","2022","1109","46","1155","2024-12-30"
"05165","2024","COM","2022","244","6","250","2024-12-30"
"05166","2024","COM","2022","1303","27","1330","2024-12-30"
"05167","2024","COM","2022","84","2","86","2024-12-30"
"05168","2024","COM","2022","739","22","761","2024-12-30"
"05169","2024","COM","2022","49","0","49","2024-12-30"
"05170","2024","COM","2022","2272","58","2330","2024-12-30"
"05171","2024","COM","2022","230","4","234","2024-12-30"
"05172","2024","COM","2022","301","6","307","2024-12-30"
"05173","2024","COM","2022","483","10","493","2024-12-30"
"05174","2024","COM","2022","610","22","632","2024-12-30"
"05176","2024","COM","2022","285","7","292","2024-12-30"
"05177","2024","COM","2022","592","13","605","2024-12-30"
"05178","2024","COM","2022","560","52","612","2024-12-30"
"05179","2024","COM","2022","3244","149","3393","2024-12-30"
"05180","2024","COM","2022","515","14","529","2024-12-30"
"05181","2024","COM","2022","290","9","299","2024-12-30"
"05182","2024","COM","2022","31","0","31","2024-12-30"
"05183","2024","COM","2022","1433","34","1467","2024-12-30"
"05184","2024","COM","2022","217","1","218","2024-12-30"
"06001","2024","COM","2022","99","0","99","2024-12-30"
"06002","2024","COM","2022","49","0","49","2024-12-30"
"06003","2024","COM","2022","652","7","659","2024-12-30"
"06004","2024","COM","2022","76612","1006","77618","2024-12-30"
"06005","2024","COM","2022","180","0","180","2024-12-30"
"06006","2024","COM","2022","2321","35","2356","2024-12-30"
"06007","2024","COM","2022","3346","72","3418","2024-12-30"
"06008","2024","COM","2022","50","1","51","2024-12-30"
"06009","2024","COM","2022","133","1","134","2024-12-30"
"06010","2024","COM","2022","2960","61","3021","2024-12-30"
"06011","2024","COM","2022","3835","34","3869","2024-12-30"
"06012","2024","COM","2022","12430","128","12558","2024-12-30"
"06013","2024","COM","2022","595","16","611","2024-12-30"
"06014","2024","COM","2022","961","7","968","2024-12-30"
"06015","2024","COM","2022","1234","22","1256","2024-12-30"
"06016","2024","COM","2022","553","4","557","2024-12-30"
"06017","2024","COM","2022","260","4","264","2024-12-30"
"06018","2024","COM","2022","10196","322","10518","2024-12-30"
"06019","2024","COM","2022","1664","15","1679","2024-12-30"
"06020","2024","COM","2022","659","9","668","2024-12-30"
"06021","2024","COM","2022","728","7","735","2024-12-30"
"06022","2024","COM","2022","550","10","560","2024-12-30"
"06023","2024","COM","2022","2292","48","2340","2024-12-30"
"06024","2024","COM","2022","168","4","172","2024-12-30"
"06025","2024","COM","2022","1432","22","1454","2024-12-30"
"06026","2024","COM","2022","1421","28","1449","2024-12-30"
"06027","2024","COM","2022","52852","451","53303","2024-12-30"
"06028","2024","COM","2022","423","6","429","2024-12-30"
"06029","2024","COM","2022","74040","780","74820","2024-12-30"
"06030","2024","COM","2022","40198","372","40570","2024-12-30"
"06031","2024","COM","2022","1276","14","1290","2024-12-30"
"06032","2024","COM","2022","4491","75","4566","2024-12-30"
"06033","2024","COM","2022","13729","138","13867","2024-12-30"
"06034","2024","COM","2022","1674","15","1689","2024-12-30"
"06035","2024","COM","2022","1042","16","1058","2024-12-30"
"06036","2024","COM","2022","422","4","426","2024-12-30"
"06037","2024","COM","2022","322","8","330","2024-12-30"
"06038","2024","COM","2022","3765","85","3850","2024-12-30"
"06039","2024","COM","2022","985","10","995","2024-12-30"
"06040","2024","COM","2022","63","0","63","2024-12-30"
"06041","2024","COM","2022","398","5","403","2024-12-30"
"06042","2024","COM","2022","688","10","698","2024-12-30"
"06043","2024","COM","2022","822","5","827","2024-12-30"
"06044","2024","COM","2022","8143","149","8292","2024-12-30"
"06045","2024","COM","2022","80","0","80","2024-12-30"
"06046","2024","COM","2022","3507","42","3549","2024-12-30"
"06047","2024","COM","2022","99","0","99","2024-12-30"
"06048","2024","COM","2022","7722","90","7812","2024-12-30"
"06049","2024","COM","2022","108","2","110","2024-12-30"
"06050","2024","COM","2022","545","11","556","2024-12-30"
"06051","2024","COM","2022","98","1","99","2024-12-30"
"06052","2024","COM","2022","132","1","133","2024-12-30"
"06053","2024","COM","2022","145","1","146","2024-12-30"
"06054","2024","COM","2022","5300","18","5318","2024-12-30"
"06055","2024","COM","2022","159","3","162","2024-12-30"
"06056","2024","COM","2022","130","1","131","2024-12-30"
"06057","2024","COM","2022","2563","16","2579","2024-12-30"
"06058","2024","COM","2022","621","15","636","2024-12-30"
"06059","2024","COM","2022","2155","36","2191","2024-12-30"
"06060","2024","COM","2022","2170","47","2217","2024-12-30"
"06061","2024","COM","2022","93","3","96","2024-12-30"
"06062","2024","COM","2022","309","6","315","2024-12-30"
"06063","2024","COM","2022","70","0","70","2024-12-30"
"06064","2024","COM","2022","4345","46","4391","2024-12-30"
"06065","2024","COM","2022","7194","111","7305","2024-12-30"
"06066","2024","COM","2022","1617","18","1635","2024-12-30"
"06067","2024","COM","2022","1568","22","1590","2024-12-30"
"06068","2024","COM","2022","365","9","374","2024-12-30"
"06069","2024","COM","2022","48669","839","49508","2024-12-30"
"06070","2024","COM","2022","606","7","613","2024-12-30"
"06071","2024","COM","2022","586","7","593","2024-12-30"
"06072","2024","COM","2022","137","1","138","2024-12-30"
"06073","2024","COM","2022","652","13","665","2024-12-30"
"06074","2024","COM","2022","1197","9","1206","2024-12-30"
"06075","2024","COM","2022","5366","54","5420","2024-12-30"
"06076","2024","COM","2022","51","0","51","2024-12-30"
"06077","2024","COM","2022","1249","13","1262","2024-12-30"
"06078","2024","COM","2022","327","7","334","2024-12-30"
"06079","2024","COM","2022","21201","242","21443","2024-12-30"
"06080","2024","COM","2022","103","4","107","2024-12-30"
"06081","2024","COM","2022","98","2","100","2024-12-30"
"06082","2024","COM","2022","127","1","128","2024-12-30"
"06083","2024","COM","2022","30326","397","30723","2024-12-30"
"06084","2024","COM","2022","10847","193","11040","2024-12-30"
"06085","2024","COM","2022","19481","393","19874","2024-12-30"
"06086","2024","COM","2022","253","2","255","2024-12-30"
"06087","2024","COM","2022","38","0","38","2024-12-30"
"06088","2024","COM","2022","353701","2902","356603","2024-12-30"
"06089","2024","COM","2022","2408","79","2487","2024-12-30"
"06090","2024","COM","2022","8143","104","8247","2024-12-30"
"06091","2024","COM","2022","2205","23","2228","2024-12-30"
"06092","2024","COM","2022","1427","16","1443","2024-12-30"
"06093","2024","COM","2022","256","5","261","2024-12-30"
"06094","2024","COM","2022","1079","8","1087","2024-12-30"
"06095","2024","COM","2022","8491","200","8691","2024-12-30"
"06096","2024","COM","2022","99","2","101","2024-12-30"
"06097","2024","COM","2022","339","4","343","2024-12-30"
"06098","2024","COM","2022","121","2","123","2024-12-30"
"06099","2024","COM","2022","1803","77","1880","2024-12-30"
"06100","2024","COM","2022","235","1","236","2024-12-30"
"06101","2024","COM","2022","167","2","169","2024-12-30"
"06102","2024","COM","2022","154","2","156","2024-12-30"
"06103","2024","COM","2022","1816","58","1874","2024-12-30"
"06104","2024","COM","2022","12419","155","12574","2024-12-30"
"06105","2024","COM","2022","7284","193","7477","2024-12-30"
"06106","2024","COM","2022","557","9","566","2024-12-30"
"06107","2024","COM","2022","66","1","67","2024-12-30"
"06108","2024","COM","2022","5552","102","5654","2024-12-30"
"06109","2024","COM","2022","933","5","938","2024-12-30"
"06110","2024","COM","2022","114","1","115","2024-12-30"
"06111","2024","COM","2022","111","3","114","2024-12-30"
"06112","2024","COM","2022","4198","104","4302","2024-12-30"
"06113","2024","COM","2022","1365","17","1382","2024-12-30"
"06114","2024","COM","2022","5877","30","5907","2024-12-30"
"06115","2024","COM","2022","84","3","87","2024-12-30"
"06116","2024","COM","2022","204","4","208","2024-12-30"
"06117","2024","COM","2022","1391","11","1402","2024-12-30"
"06118","2024","COM","2022","3971","100","4071","2024-12-30"
"06119","2024","COM","2022","102","2","104","2024-12-30"
"06120","2024","COM","2022","1269","152","1421","2024-12-30"
"06121","2024","COM","2022","1476","8","1484","2024-12-30"
"06122","2024","COM","2022","4378","96","4474","2024-12-30"
"06123","2024","COM","2022","31645","208","31853","2024-12-30"
"06124","2024","COM","2022","57","0","57","2024-12-30"
"06125","2024","COM","2022","146","6","152","2024-12-30"
"06126","2024","COM","2022","3403","34","3437","2024-12-30"
"06127","2024","COM","2022","1379","12","1391","2024-12-30"
"06128","2024","COM","2022","3190","69","3259","2024-12-30"
"06129","2024","COM","2022","295","74","369","2024-12-30"
"06130","2024","COM","2022","3662","92","3754","2024-12-30"
"06131","2024","COM","2022","47","0","47","2024-12-30"
"06132","2024","COM","2022","432","8","440","2024-12-30"
"06133","2024","COM","2022","69","2","71","2024-12-30"
"06134","2024","COM","2022","537","15","552","2024-12-30"
"06135","2024","COM","2022","202","5","207","2024-12-30"
"06136","2024","COM","2022","3807","89","3896","2024-12-30"
"06137","2024","COM","2022","1180","23","1203","2024-12-30"
"06138","2024","COM","2022","1418","18","1436","2024-12-30"
"06139","2024","COM","2022","100","3","103","2024-12-30"
"06140","2024","COM","2022","3158","61","3219","2024-12-30"
"06141","2024","COM","2022","353","5","358","2024-12-30"
"06142","2024","COM","2022","303","1","304","2024-12-30"
"06143","2024","COM","2022","743","9","752","2024-12-30"
"06144","2024","COM","2022","540","6","546","2024-12-30"
"06145","2024","COM","2022","147","1","148","2024-12-30"
"06146","2024","COM","2022","147","1","148","2024-12-30"
"06147","2024","COM","2022","4633","34","4667","2024-12-30"
"06148","2024","COM","2022","4126","104","4230","2024-12-30"
"06149","2024","COM","2022","10485","69","10554","2024-12-30"
"06150","2024","COM","2022","3012","58","3070","2024-12-30"
"06151","2024","COM","2022","824","6","830","2024-12-30"
"06152","2024","COM","2022","12389","413","12802","2024-12-30"
"06153","2024","COM","2022","834","290","1124","2024-12-30"
"06154","2024","COM","2022","517","6","523","2024-12-30"
"06155","2024","COM","2022","28579","229","28808","2024-12-30"
"06156","2024","COM","2022","197","3","200","2024-12-30"
"06157","2024","COM","2022","19856","421","20277","2024-12-30"
"06158","2024","COM","2022","783","6","789","2024-12-30"
"06159","2024","COM","2022","5012","35","5047","2024-12-30"
"06160","2024","COM","2022","87","2","89","2024-12-30"
"06161","2024","COM","2022","16729","223","16952","2024-12-30"
"06162","2024","COM","2022","741","13","754","2024-12-30"
"06163","2024","COM","2022","1898","52","1950","2024-12-30"
"07001","2024","COM","2022","365","12","377","2024-12-30"
"07002","2024","COM","2022","553","16","569","2024-12-30"
"07003","2024","COM","2022","172","1","173","2024-12-30"
"07004","2024","COM","2022","78","1","79","2024-12-30"
"07005","2024","COM","2022","1538","45","1583","2024-12-30"
"07006","2024","COM","2022","158","3","161","2024-12-30"
"07007","2024","COM","2022","1026","19","1045","2024-12-30"
"07008","2024","COM","2022","1485","53","1538","2024-12-30"
"07009","2024","COM","2022","1193","22","1215","2024-12-30"
"07010","2024","COM","2022","17222","541","17763","2024-12-30"
"07011","2024","COM","2022","852","16","868","2024-12-30"
"07012","2024","COM","2022","358","5","363","2024-12-30"
"07013","2024","COM","2022","1302","23","1325","2024-12-30"
"07014","2024","COM","2022","361","9","370","2024-12-30"
"07015","2024","COM","2022","535","24","559","2024-12-30"
"07017","2024","COM","2022","768","13","781","2024-12-30"
"07018","2024","COM","2022","57","0","57","2024-12-30"
"07019","2024","COM","2022","12488","754","13242","2024-12-30"
"07020","2024","COM","2022","477","10","487","2024-12-30"
"07022","2024","COM","2022","1293","13","1306","2024-12-30"
"07023","2024","COM","2022","383","10","393","2024-12-30"
"07024","2024","COM","2022","650","21","671","2024-12-30"
"07025","2024","COM","2022","207","2","209","2024-12-30"
"07026","2024","COM","2022","255","5","260","2024-12-30"
"07027","2024","COM","2022","1847","29","1876","2024-12-30"
"07028","2024","COM","2022","538","7","545","2024-12-30"
"07029","2024","COM","2022","261","3","264","2024-12-30"
"07030","2024","COM","2022","202","5","207","2024-12-30"
"07031","2024","COM","2022","779","15","794","2024-12-30"
"07032","2024","COM","2022","159","1","160","2024-12-30"
"07033","2024","COM","2022","234","3","237","2024-12-30"
"07034","2024","COM","2022","256","3","259","2024-12-30"
"07035","2024","COM","2022","618","10","628","2024-12-30"
"07036","2024","COM","2022","471","14","485","2024-12-30"
"07037","2024","COM","2022","142","1","143","2024-12-30"
"07038","2024","COM","2022","45","0","45","2024-12-30"
"07039","2024","COM","2022","256","5","261","2024-12-30"
"07040","2024","COM","2022","247","5","252","2024-12-30"
"07041","2024","COM","2022","2255","57","2312","2024-12-30"
"07042","2024","COM","2022","7506","171","7677","2024-12-30"
"07044","2024","COM","2022","261","10","271","2024-12-30"
"07045","2024","COM","2022","529","8","537","2024-12-30"
"07047","2024","COM","2022","91","2","93","2024-12-30"
"07048","2024","COM","2022","339","6","345","2024-12-30"
"07049","2024","COM","2022","60","2","62","2024-12-30"
"07050","2024","COM","2022","978","14","992","2024-12-30"
"07051","2024","COM","2022","621","13","634","2024-12-30"
"07052","2024","COM","2022","659","12","671","2024-12-30"
"07053","2024","COM","2022","545","7","552","2024-12-30"
"07054","2024","COM","2022","262","9","271","2024-12-30"
"07055","2024","COM","2022","3160","79","3239","2024-12-30"
"07056","2024","COM","2022","918","19","937","2024-12-30"
"07058","2024","COM","2022","992","40","1032","2024-12-30"
"07059","2024","COM","2022","232","8","240","2024-12-30"
"07060","2024","COM","2022","278","7","285","2024-12-30"
"07061","2024","COM","2022","429","10","439","2024-12-30"
"07062","2024","COM","2022","134","2","136","2024-12-30"
"07063","2024","COM","2022","413","10","423","2024-12-30"
"07064","2024","COM","2022","2812","154","2966","2024-12-30"
"07065","2024","COM","2022","270","3","273","2024-12-30"
"07066","2024","COM","2022","3094","161","3255","2024-12-30"
"07067","2024","COM","2022","335","4","339","2024-12-30"
"07068","2024","COM","2022","566","9","575","2024-12-30"
"07069","2024","COM","2022","677","15","692","2024-12-30"
"07070","2024","COM","2022","2397","52","2449","2024-12-30"
"07071","2024","COM","2022","767","10","777","2024-12-30"
"07072","2024","COM","2022","1664","42","1706","2024-12-30"
"07073","2024","COM","2022","522","10","532","2024-12-30"
"07074","2024","COM","2022","156","5","161","2024-12-30"
"07075","2024","COM","2022","151","3","154","2024-12-30"
"07076","2024","COM","2022","2954","55","3009","2024-12-30"
"07077","2024","COM","2022","269","1","270","2024-12-30"
"07078","2024","COM","2022","3181","61","3242","2024-12-30"
"07079","2024","COM","2022","1145","19","1164","2024-12-30"
"07080","2024","COM","2022","306","6","312","2024-12-30"
"07081","2024","COM","2022","77","0","77","2024-12-30"
"07082","2024","COM","2022","198","11","209","2024-12-30"
"07083","2024","COM","2022","437","11","448","2024-12-30"
"07084","2024","COM","2022","1046","22","1068","2024-12-30"
"07085","2024","COM","2022","573","16","589","2024-12-30"
"07086","2024","COM","2022","979","22","1001","2024-12-30"
"07087","2024","COM","2022","458","8","466","2024-12-30"
"07088","2024","COM","2022","113","1","114","2024-12-30"
"07089","2024","COM","2022","1874","42","1916","2024-12-30"
"07090","2024","COM","2022","1239","20","1259","2024-12-30"
"07091","2024","COM","2022","317","9","326","2024-12-30"
"07092","2024","COM","2022","46","0","46","2024-12-30"
"07093","2024","COM","2022","269","8","277","2024-12-30"
"07094","2024","COM","2022","174","1","175","2024-12-30"
"07095","2024","COM","2022","473","4","477","2024-12-30"
"07096","2024","COM","2022","368","4","372","2024-12-30"
"07097","2024","COM","2022","686","18","704","2024-12-30"
"07098","2024","COM","2022","78","3","81","2024-12-30"
"07099","2024","COM","2022","588","20","608","2024-12-30"
"07100","2024","COM","2022","511","16","527","2024-12-30"
"07101","2024","COM","2022","931","12","943","2024-12-30"
"07102","2024","COM","2022","11277","177","11454","2024-12-30"
"07103","2024","COM","2022","305","4","309","2024-12-30"
"07104","2024","COM","2022","105","0","105","2024-12-30"
"07105","2024","COM","2022","103","2","105","2024-12-30"
"07106","2024","COM","2022","125","2","127","2024-12-30"
"07107","2024","COM","2022","1229","26","1255","2024-12-30"
"07108","2024","COM","2022","121","5","126","2024-12-30"
"07109","2024","COM","2022","317","5","322","2024-12-30"
"07110","2024","COM","2022","1760","31","1791","2024-12-30"
"07111","2024","COM","2022","186","3","189","2024-12-30"
"07112","2024","COM","2022","282","4","286","2024-12-30"
"07113","2024","COM","2022","322","5","327","2024-12-30"
"07114","2024","COM","2022","220","2","222","2024-12-30"
"07115","2024","COM","2022","684","11","695","2024-12-30"
"07116","2024","COM","2022","1376","16","1392","2024-12-30"
"07117","2024","COM","2022","2214","37","2251","2024-12-30"
"07118","2024","COM","2022","144","5","149","2024-12-30"
"07119","2024","COM","2022","251","5","256","2024-12-30"
"07120","2024","COM","2022","66","1","67","2024-12-30"
"07121","2024","COM","2022","188","0","188","2024-12-30"
"07122","2024","COM","2022","1840","32","1872","2024-12-30"
"07123","2024","COM","2022","159","5","164","2024-12-30"
"07124","2024","COM","2022","45","2","47","2024-12-30"
"07126","2024","COM","2022","1227","24","1251","2024-12-30"
"07127","2024","COM","2022","1153","12","1165","2024-12-30"
"07128","2024","COM","2022","383","6","389","2024-12-30"
"07129","2024","COM","2022","2336","39","2375","2024-12-30"
"07130","2024","COM","2022","209","5","214","2024-12-30"
"07131","2024","COM","2022","431","34","465","2024-12-30"
"07132","2024","COM","2022","1496","56","1552","2024-12-30"
"07133","2024","COM","2022","272","3","275","2024-12-30"
"07134","2024","COM","2022","1045","25","1070","2024-12-30"
"07136","2024","COM","2022","109","1","110","2024-12-30"
"07137","2024","COM","2022","43","0","43","2024-12-30"
"07138","2024","COM","2022","2248","50","2298","2024-12-30"
"07139","2024","COM","2022","99","0","99","2024-12-30"
"07140","2024","COM","2022","798","24","822","2024-12-30"
"07141","2024","COM","2022","236","7","243","2024-12-30"
"07142","2024","COM","2022","321","11","332","2024-12-30"
"07143","2024","COM","2022","817","15","832","2024-12-30"
"07144","2024","COM","2022","45","0","45","2024-12-30"
"07145","2024","COM","2022","1142","21","1163","2024-12-30"
"07146","2024","COM","2022","592","19","611","2024-12-30"
"07147","2024","COM","2022","257","4","261","2024-12-30"
"07148","2024","COM","2022","146","4","150","2024-12-30"
"07149","2024","COM","2022","283","5","288","2024-12-30"
"07150","2024","COM","2022","541","14","555","2024-12-30"
"07151","2024","COM","2022","246","12","258","2024-12-30"
"07152","2024","COM","2022","1192","26","1218","2024-12-30"
"07153","2024","COM","2022","264","7","271","2024-12-30"
"07154","2024","COM","2022","124","2","126","2024-12-30"
"07155","2024","COM","2022","1315","33","1348","2024-12-30"
"07156","2024","COM","2022","906","21","927","2024-12-30"
"07157","2024","COM","2022","1380","27","1407","2024-12-30"
"07158","2024","COM","2022","99","0","99","2024-12-30"
"07159","2024","COM","2022","777","10","787","2024-12-30"
"07160","2024","COM","2022","59","1","60","2024-12-30"
"07161","2024","COM","2022","756","22","778","2024-12-30"
"07162","2024","COM","2022","569","10","579","2024-12-30"
"07163","2024","COM","2022","86","3","89","2024-12-30"
"07165","2024","COM","2022","542","20","562","2024-12-30"
"07166","2024","COM","2022","240","2","242","2024-12-30"
"07167","2024","COM","2022","1020","24","1044","2024-12-30"
"07168","2024","COM","2022","566","9","575","2024-12-30"
"07169","2024","COM","2022","386","2","388","2024-12-30"
"07170","2024","COM","2022","288","5","293","2024-12-30"
"07171","2024","COM","2022","539","8","547","2024-12-30"
"07172","2024","COM","2022","2353","52","2405","2024-12-30"
"07173","2024","COM","2022","49","1","50","2024-12-30"
"07174","2024","COM","2022","517","8","525","2024-12-30"
"07175","2024","COM","2022","65","3","68","2024-12-30"
"07176","2024","COM","2022","162","1","163","2024-12-30"
"07177","2024","COM","2022","836","19","855","2024-12-30"
"07178","2024","COM","2022","572","7","579","2024-12-30"
"07179","2024","COM","2022","137","1","138","2024-12-30"
"07181","2024","COM","2022","2893","29","2922","2024-12-30"
"07182","2024","COM","2022","1184","30","1214","2024-12-30"
"07183","2024","COM","2022","537","10","547","2024-12-30"
"07184","2024","COM","2022","505","12","517","2024-12-30"
"07185","2024","COM","2022","706","10","716","2024-12-30"
"07186","2024","COM","2022","8552","251","8803","2024-12-30"
"07187","2024","COM","2022","134","1","135","2024-12-30"
"07188","2024","COM","2022","1750","33","1783","2024-12-30"
"07189","2024","COM","2022","328","7","335","2024-12-30"
"07190","2024","COM","2022","222","7","229","2024-12-30"
"07191","2024","COM","2022","2250","57","2307","2024-12-30"
"07192","2024","COM","2022","238","9","247","2024-12-30"
"07193","2024","COM","2022","296","2","298","2024-12-30"
"07194","2024","COM","2022","484","12","496","2024-12-30"
"07195","2024","COM","2022","63","2","65","2024-12-30"
"07196","2024","COM","2022","263","4","267","2024-12-30"
"07197","2024","COM","2022","2723","80","2803","2024-12-30"
"07198","2024","COM","2022","1141","27","1168","2024-12-30"
"07199","2024","COM","2022","1307","23","1330","2024-12-30"
"07200","2024","COM","2022","64","1","65","2024-12-30"
"07201","2024","COM","2022","2286","19","2305","2024-12-30"
"07202","2024","COM","2022","166","4","170","2024-12-30"
"07203","2024","COM","2022","119","3","122","2024-12-30"
"07204","2024","COM","2022","2300","57","2357","2024-12-30"
"07205","2024","COM","2022","1396","51","1447","2024-12-30"
"07206","2024","COM","2022","65","2","67","2024-12-30"
"07207","2024","COM","2022","1101","14","1115","2024-12-30"
"07208","2024","COM","2022","130","1","131","2024-12-30"
"07209","2024","COM","2022","53","2","55","2024-12-30"
"07210","2024","COM","2022","529","9","538","2024-12-30"
"07211","2024","COM","2022","464","14","478","2024-12-30"
"07212","2024","COM","2022","211","1","212","2024-12-30"
"07213","2024","COM","2022","166","4","170","2024-12-30"
"07214","2024","COM","2022","199","5","204","2024-12-30"
"07215","2024","COM","2022","203","5","208","2024-12-30"
"07216","2024","COM","2022","500","21","521","2024-12-30"
"07217","2024","COM","2022","859","12","871","2024-12-30"
"07218","2024","COM","2022","351","5","356","2024-12-30"
"07219","2024","COM","2022","316","10","326","2024-12-30"
"07220","2024","COM","2022","100","0","100","2024-12-30"
"07221","2024","COM","2022","246","9","255","2024-12-30"
"07222","2024","COM","2022","217","5","222","2024-12-30"
"07223","2024","COM","2022","140","1","141","2024-12-30"
"07224","2024","COM","2022","215","12","227","2024-12-30"
"07225","2024","COM","2022","1292","37","1329","2024-12-30"
"07226","2024","COM","2022","93","1","94","2024-12-30"
"07227","2024","COM","2022","1430","48","1478","2024-12-30"
"07228","2024","COM","2022","876","23","899","2024-12-30"
"07229","2024","COM","2022","924","25","949","2024-12-30"
"07230","2024","COM","2022","404","8","412","2024-12-30"
"07231","2024","COM","2022","2894","78","2972","2024-12-30"
"07232","2024","COM","2022","407","10","417","2024-12-30"
"07233","2024","COM","2022","217","1","218","2024-12-30"
"07234","2024","COM","2022","274","9","283","2024-12-30"
"07235","2024","COM","2022","209","3","212","2024-12-30"
"07236","2024","COM","2022","1114","21","1135","2024-12-30"
"07237","2024","COM","2022","806","24","830","2024-12-30"
"07238","2024","COM","2022","335","5","340","2024-12-30"
"07239","2024","COM","2022","112","1","113","2024-12-30"
"07240","2024","COM","2022","2415","52","2467","2024-12-30"
"07241","2024","COM","2022","704","16","720","2024-12-30"
"07242","2024","COM","2022","119","2","121","2024-12-30"
"07243","2024","COM","2022","279","5","284","2024-12-30"
"07244","2024","COM","2022","252","4","256","2024-12-30"
"07245","2024","COM","2022","2499","42","2541","2024-12-30"
"07247","2024","COM","2022","868","23","891","2024-12-30"
"07248","2024","COM","2022","264","2","266","2024-12-30"
"07249","2024","COM","2022","101","2","103","2024-12-30"
"07250","2024","COM","2022","497","5","502","2024-12-30"
"07251","2024","COM","2022","191","1","192","2024-12-30"
"07253","2024","COM","2022","169","3","172","2024-12-30"
"07254","2024","COM","2022","874","25","899","2024-12-30"
"07255","2024","COM","2022","1464","35","1499","2024-12-30"
"07257","2024","COM","2022","125","1","126","2024-12-30"
"07258","2024","COM","2022","222","4","226","2024-12-30"
"07259","2024","COM","2022","1611","39","1650","2024-12-30"
"07260","2024","COM","2022","959","19","978","2024-12-30"
"07261","2024","COM","2022","1617","33","1650","2024-12-30"
"07262","2024","COM","2022","184","2","186","2024-12-30"
"07263","2024","COM","2022","120","2","122","2024-12-30"
"07264","2024","COM","2022","2357","65","2422","2024-12-30"
"07265","2024","COM","2022","1378","39","1417","2024-12-30"
"07266","2024","COM","2022","116","2","118","2024-12-30"
"07267","2024","COM","2022","271","2","273","2024-12-30"
"07268","2024","COM","2022","941","12","953","2024-12-30"
"07269","2024","COM","2022","1084","27","1111","2024-12-30"
"07270","2024","COM","2022","430","9","439","2024-12-30"
"07272","2024","COM","2022","373","11","384","2024-12-30"
"07273","2024","COM","2022","213","1","214","2024-12-30"
"07274","2024","COM","2022","200","5","205","2024-12-30"
"07275","2024","COM","2022","107","0","107","2024-12-30"
"07276","2024","COM","2022","262","20","282","2024-12-30"
"07277","2024","COM","2022","148","5","153","2024-12-30"
"07278","2024","COM","2022","405","9","414","2024-12-30"
"07279","2024","COM","2022","1955","59","2014","2024-12-30"
"07280","2024","COM","2022","967","21","988","2024-12-30"
"07281","2024","COM","2022","7591","220","7811","2024-12-30"
"07282","2024","COM","2022","443","45","488","2024-12-30"
"07283","2024","COM","2022","63","2","65","2024-12-30"
"07284","2024","COM","2022","190","3","193","2024-12-30"
"07285","2024","COM","2022","110","0","110","2024-12-30"
"07286","2024","COM","2022","515","1","516","2024-12-30"
"07287","2024","COM","2022","302","10","312","2024-12-30"
"07288","2024","COM","2022","1337","46","1383","2024-12-30"
"07289","2024","COM","2022","1664","54","1718","2024-12-30"
"07290","2024","COM","2022","273","7","280","2024-12-30"
"07291","2024","COM","2022","848","22","870","2024-12-30"
"07292","2024","COM","2022","1168","29","1197","2024-12-30"
"07293","2024","COM","2022","989","14","1003","2024-12-30"
"07294","2024","COM","2022","566","13","579","2024-12-30"
"07295","2024","COM","2022","1112","22","1134","2024-12-30"
"07296","2024","COM","2022","1842","31","1873","2024-12-30"
"07297","2024","COM","2022","511","13","524","2024-12-30"
"07298","2024","COM","2022","855","19","874","2024-12-30"
"07299","2024","COM","2022","117","4","121","2024-12-30"
"07300","2024","COM","2022","475","11","486","2024-12-30"
"07301","2024","COM","2022","961","19","980","2024-12-30"
"07302","2024","COM","2022","827","14","841","2024-12-30"
"07303","2024","COM","2022","272","3","275","2024-12-30"
"07304","2024","COM","2022","731","20","751","2024-12-30"
"07305","2024","COM","2022","406","13","419","2024-12-30"
"07306","2024","COM","2022","244","6","250","2024-12-30"
"07307","2024","COM","2022","444","7","451","2024-12-30"
"07308","2024","COM","2022","2232","34","2266","2024-12-30"
"07309","2024","COM","2022","1502","30","1532","2024-12-30"
"07310","2024","COM","2022","896","32","928","2024-12-30"
"07311","2024","COM","2022","147","2","149","2024-12-30"
"07312","2024","COM","2022","517","16","533","2024-12-30"
"07313","2024","COM","2022","1074","17","1091","2024-12-30"
"07314","2024","COM","2022","399","5","404","2024-12-30"
"07315","2024","COM","2022","384","8","392","2024-12-30"
"07316","2024","COM","2022","2298","52","2350","2024-12-30"
"07317","2024","COM","2022","1116","37","1153","2024-12-30"
"07318","2024","COM","2022","203","1","204","2024-12-30"
"07319","2024","COM","2022","8812","230","9042","2024-12-30"
"07321","2024","COM","2022","322","6","328","2024-12-30"
"07322","2024","COM","2022","1208","10","1218","2024-12-30"
"07323","2024","COM","2022","1701","31","1732","2024-12-30"
"07324","2024","COM","2022","11302","566","11868","2024-12-30"
"07325","2024","COM","2022","2031","41","2072","2024-12-30"
"07326","2024","COM","2022","110","2","112","2024-12-30"
"07327","2024","COM","2022","418","15","433","2024-12-30"
"07328","2024","COM","2022","628","17","645","2024-12-30"
"07329","2024","COM","2022","415","8","423","2024-12-30"
"07330","2024","COM","2022","2469","40","2509","2024-12-30"
"07331","2024","COM","2022","3479","51","3530","2024-12-30"
"07332","2024","COM","2022","438","10","448","2024-12-30"
"07333","2024","COM","2022","934","30","964","2024-12-30"
"07334","2024","COM","2022","2680","43","2723","2024-12-30"
"07335","2024","COM","2022","218","2","220","2024-12-30"
"07336","2024","COM","2022","223","7","230","2024-12-30"
"07337","2024","COM","2022","2670","86","2756","2024-12-30"
"07338","2024","COM","2022","1985","34","2019","2024-12-30"
"07339","2024","COM","2022","2048","49","2097","2024-12-30"
"07340","2024","COM","2022","1504","49","1553","2024-12-30"
"07341","2024","COM","2022","3031","108","3139","2024-12-30"
"07342","2024","COM","2022","1181","26","1207","2024-12-30"
"07343","2024","COM","2022","1388","33","1421","2024-12-30"
"07344","2024","COM","2022","520","10","530","2024-12-30"
"07345","2024","COM","2022","932","20","952","2024-12-30"
"07346","2024","COM","2022","3659","67","3726","2024-12-30"
"07347","2024","COM","2022","615","11","626","2024-12-30"
"07348","2024","COM","2022","1035","13","1048","2024-12-30"
"07349","2024","COM","2022","4762","54","4816","2024-12-30"
"08001","2024","COM","2022","490","4","494","2024-12-30"
"08003","2024","COM","2022","1675","28","1703","2024-12-30"
"08004","2024","COM","2022","247","1","248","2024-12-30"
"08005","2024","COM","2022","161","2","163","2024-12-30"
"08006","2024","COM","2022","272","6","278","2024-12-30"
"08008","2024","COM","2022","787","12","799","2024-12-30"
"08010","2024","COM","2022","134","0","134","2024-12-30"
"08011","2024","COM","2022","215","4","219","2024-12-30"
"08013","2024","COM","2022","386","6","392","2024-12-30"
"08014","2024","COM","2022","130","5","135","2024-12-30"
"08015","2024","COM","2022","100","1","101","2024-12-30"
"08016","2024","COM","2022","202","2","204","2024-12-30"
"08017","2024","COM","2022","120","3","123","2024-12-30"
"08018","2024","COM","2022","79","2","81","2024-12-30"
"08019","2024","COM","2022","54","4","58","2024-12-30"
"08020","2024","COM","2022","59","0","59","2024-12-30"
"08021","2024","COM","2022","150","4","154","2024-12-30"
"08022","2024","COM","2022","342","10","352","2024-12-30"
"08023","2024","COM","2022","64","0","64","2024-12-30"
"08024","2024","COM","2022","1081","20","1101","2024-12-30"
"08025","2024","COM","2022","1106","24","1130","2024-12-30"
"08026","2024","COM","2022","306","10","316","2024-12-30"
"08027","2024","COM","2022","96","1","97","2024-12-30"
"08028","2024","COM","2022","984","21","1005","2024-12-30"
"08029","2024","COM","2022","81","0","81","2024-12-30"
"08030","2024","COM","2022","58","0","58","2024-12-30"
"08031","2024","COM","2022","38","3","41","2024-12-30"
"08032","2024","COM","2022","232","3","235","2024-12-30"
"08033","2024","COM","2022","93","2","95","2024-12-30"
"08034","2024","COM","2022","338","5","343","2024-12-30"
"08035","2024","COM","2022","50","4","54","2024-12-30"
"08036","2024","COM","2022","95","5","100","2024-12-30"
"08037","2024","COM","2022","902","16","918","2024-12-30"
"08038","2024","COM","2022","346","7","353","2024-12-30"
"08039","2024","COM","2022","511","5","516","2024-12-30"
"08040","2024","COM","2022","859","21","880","2024-12-30"
"08041","2024","COM","2022","208","9","217","2024-12-30"
"08043","2024","COM","2022","1596","26","1622","2024-12-30"
"08044","2024","COM","2022","150","2","152","2024-12-30"
"08045","2024","COM","2022","245","12","257","2024-12-30"
"08046","2024","COM","2022","163","3","166","2024-12-30"
"08047","2024","COM","2022","106","1","107","2024-12-30"
"08048","2024","COM","2022","388","6","394","2024-12-30"
"08049","2024","COM","2022","120","1","121","2024-12-30"
"08052","2024","COM","2022","68","2","70","2024-12-30"
"08053","2024","COM","2022","2459","176","2635","2024-12-30"
"08055","2024","COM","2022","422","6","428","2024-12-30"
"08056","2024","COM","2022","39","0","39","2024-12-30"
"08057","2024","COM","2022","241","24","265","2024-12-30"
"08058","2024","COM","2022","226","9","235","2024-12-30"
"08059","2024","COM","2022","27","1","28","2024-12-30"
"08060","2024","COM","2022","296","4","300","2024-12-30"
"08061","2024","COM","2022","37","2","39","2024-12-30"
"08062","2024","COM","2022","128","1","129","2024-12-30"
"08063","2024","COM","2022","134","1","135","2024-12-30"
"08064","2024","COM","2022","314","4","318","2024-12-30"
"08065","2024","COM","2022","46","1","47","2024-12-30"
"08066","2024","COM","2022","66","1","67","2024-12-30"
"08067","2024","COM","2022","1093","18","1111","2024-12-30"
"08069","2024","COM","2022","136","5","141","2024-12-30"
"08070","2024","COM","2022","397","5","402","2024-12-30"
"08071","2024","COM","2022","130","2","132","2024-12-30"
"08073","2024","COM","2022","95","2","97","2024-12-30"
"08074","2024","COM","2022","57","2","59","2024-12-30"
"08075","2024","COM","2022","151","2","153","2024-12-30"
"08076","2024","COM","2022","971","14","985","2024-12-30"
"08077","2024","COM","2022","51","0","51","2024-12-30"
"08078","2024","COM","2022","829","10","839","2024-12-30"
"08080","2024","COM","2022","118","1","119","2024-12-30"
"08081","2024","COM","2022","4947","62","5009","2024-12-30"
"08082","2024","COM","2022","76","4","80","2024-12-30"
"08083","2024","COM","2022","367","7","374","2024-12-30"
"08084","2024","COM","2022","276","4","280","2024-12-30"
"08085","2024","COM","2022","224","5","229","2024-12-30"
"08086","2024","COM","2022","89","2","91","2024-12-30"
"08087","2024","COM","2022","130","2","132","2024-12-30"
"08088","2024","COM","2022","138","4","142","2024-12-30"
"08089","2024","COM","2022","381","7","388","2024-12-30"
"08090","2024","COM","2022","2745","43","2788","2024-12-30"
"08092","2024","COM","2022","187","8","195","2024-12-30"
"08094","2024","COM","2022","54","0","54","2024-12-30"
"08095","2024","COM","2022","172","5","177","2024-12-30"
"08096","2024","COM","2022","726","16","742","2024-12-30"
"08097","2024","COM","2022","423","6","429","2024-12-30"
"08098","2024","COM","2022","53","2","55","2024-12-30"
"08099","2024","COM","2022","121","4","125","2024-12-30"
"08100","2024","COM","2022","74","0","74","2024-12-30"
"08101","2024","COM","2022","163","4","167","2024-12-30"
"08102","2024","COM","2022","82","7","89","2024-12-30"
"08103","2024","COM","2022","219","4","223","2024-12-30"
"08104","2024","COM","2022","57","0","57","2024-12-30"
"08105","2024","COM","2022","45634","996","46630","2024-12-30"
"08106","2024","COM","2022","72","0","72","2024-12-30"
"08107","2024","COM","2022","1297","19","1316","2024-12-30"
"08109","2024","COM","2022","129","1","130","2024-12-30"
"08110","2024","COM","2022","172","1","173","2024-12-30"
"08111","2024","COM","2022","775","2","777","2024-12-30"
"08113","2024","COM","2022","486","6","492","2024-12-30"
"08115","2024","COM","2022","521","7","528","2024-12-30"
"08116","2024","COM","2022","1030","31","1061","2024-12-30"
"08117","2024","COM","2022","162","0","162","2024-12-30"
"08119","2024","COM","2022","470","7","477","2024-12-30"
"08120","2024","COM","2022","46","1","47","2024-12-30"
"08121","2024","COM","2022","133","3","136","2024-12-30"
"08122","2024","COM","2022","792","19","811","2024-12-30"
"08123","2024","COM","2022","65","2","67","2024-12-30"
"08124","2024","COM","2022","342","11","353","2024-12-30"
"08125","2024","COM","2022","412","3","415","2024-12-30"
"08126","2024","COM","2022","219","1","220","2024-12-30"
"08128","2024","COM","2022","64","2","66","2024-12-30"
"08130","2024","COM","2022","85","1","86","2024-12-30"
"08131","2024","COM","2022","67","3","70","2024-12-30"
"08132","2024","COM","2022","193","2","195","2024-12-30"
"08133","2024","COM","2022","530","6","536","2024-12-30"
"08134","2024","COM","2022","75","4","79","2024-12-30"
"08135","2024","COM","2022","160","1","161","2024-12-30"
"08136","2024","COM","2022","358","3","361","2024-12-30"
"08137","2024","COM","2022","428","11","439","2024-12-30"
"08138","2024","COM","2022","249","9","258","2024-12-30"
"08139","2024","COM","2022","1044","12","1056","2024-12-30"
"08140","2024","COM","2022","1053","20","1073","2024-12-30"
"08141","2024","COM","2022","187","5","192","2024-12-30"
"08142","2024","COM","2022","1989","35","2024","2024-12-30"
"08143","2024","COM","2022","78","3","81","2024-12-30"
"08144","2024","COM","2022","102","3","105","2024-12-30"
"08145","2024","COM","2022","2149","41","2190","2024-12-30"
"08146","2024","COM","2022","90","2","92","2024-12-30"
"08147","2024","COM","2022","71","4","75","2024-12-30"
"08148","2024","COM","2022","260","4","264","2024-12-30"
"08149","2024","COM","2022","133","2","135","2024-12-30"
"08150","2024","COM","2022","169","6","175","2024-12-30"
"08151","2024","COM","2022","290","11","301","2024-12-30"
"08153","2024","COM","2022","343","4","347","2024-12-30"
"08154","2024","COM","2022","86","4","90","2024-12-30"
"08155","2024","COM","2022","96","0","96","2024-12-30"
"08156","2024","COM","2022","469","7","476","2024-12-30"
"08158","2024","COM","2022","272","6","278","2024-12-30"
"08159","2024","COM","2022","109","2","111","2024-12-30"
"08160","2024","COM","2022","188","5","193","2024-12-30"
"08161","2024","COM","2022","33","1","34","2024-12-30"
"08162","2024","COM","2022","341","2","343","2024-12-30"
"08163","2024","COM","2022","257","6","263","2024-12-30"
"08164","2024","COM","2022","342","9","351","2024-12-30"
"08165","2024","COM","2022","63","3","66","2024-12-30"
"08166","2024","COM","2022","236","9","245","2024-12-30"
"08167","2024","COM","2022","70","1","71","2024-12-30"
"08168","2024","COM","2022","176","3","179","2024-12-30"
"08169","2024","COM","2022","92","7","99","2024-12-30"
"08170","2024","COM","2022","223","3","226","2024-12-30"
"08171","2024","COM","2022","93","7","100","2024-12-30"
"08172","2024","COM","2022","155","1","156","2024-12-30"
"08173","2024","COM","2022","1682","44","1726","2024-12-30"
"08174","2024","COM","2022","2277","44","2321","2024-12-30"
"08175","2024","COM","2022","254","8","262","2024-12-30"
"08176","2024","COM","2022","61","1","62","2024-12-30"
"08178","2024","COM","2022","171","4","175","2024-12-30"
"08179","2024","COM","2022","590","6","596","2024-12-30"
"08180","2024","COM","2022","1647","45","1692","2024-12-30"
"08182","2024","COM","2022","61","1","62","2024-12-30"
"08183","2024","COM","2022","1038","22","1060","2024-12-30"
"08184","2024","COM","2022","85","2","87","2024-12-30"
"08185","2024","COM","2022","3118","47","3165","2024-12-30"
"08186","2024","COM","2022","51","0","51","2024-12-30"
"08187","2024","COM","2022","315","3","318","2024-12-30"
"08188","2024","COM","2022","969","16","985","2024-12-30"
"08189","2024","COM","2022","157","1","158","2024-12-30"
"08190","2024","COM","2022","6356","149","6505","2024-12-30"
"08191","2024","COM","2022","1055","28","1083","2024-12-30"
"08192","2024","COM","2022","94","0","94","2024-12-30"
"08193","2024","COM","2022","266","4","270","2024-12-30"
"08194","2024","COM","2022","824","13","837","2024-12-30"
"08195","2024","COM","2022","320","3","323","2024-12-30"
"08196","2024","COM","2022","89","3","92","2024-12-30"
"08197","2024","COM","2022","36","3","39","2024-12-30"
"08198","2024","COM","2022","506","17","523","2024-12-30"
"08199","2024","COM","2022","765","16","781","2024-12-30"
"08200","2024","COM","2022","183","2","185","2024-12-30"
"08201","2024","COM","2022","104","2","106","2024-12-30"
"08202","2024","COM","2022","504","10","514","2024-12-30"
"08203","2024","COM","2022","265","6","271","2024-12-30"
"08204","2024","COM","2022","74","1","75","2024-12-30"
"08205","2024","COM","2022","68","0","68","2024-12-30"
"08206","2024","COM","2022","360","11","371","2024-12-30"
"08207","2024","COM","2022","226","5","231","2024-12-30"
"08208","2024","COM","2022","134","4","138","2024-12-30"
"08209","2024","COM","2022","439","9","448","2024-12-30"
"08210","2024","COM","2022","111","3","114","2024-12-30"
"08211","2024","COM","2022","706","8","714","2024-12-30"
"08212","2024","COM","2022","503","9","512","2024-12-30"
"08214","2024","COM","2022","453","5","458","2024-12-30"
"08215","2024","COM","2022","45","1","46","2024-12-30"
"08216","2024","COM","2022","328","8","336","2024-12-30"
"08217","2024","COM","2022","87","0","87","2024-12-30"
"08218","2024","COM","2022","1253","24","1277","2024-12-30"
"08219","2024","COM","2022","123","1","124","2024-12-30"
"08220","2024","COM","2022","320","5","325","2024-12-30"
"08222","2024","COM","2022","1806","44","1850","2024-12-30"
"08223","2024","COM","2022","124","2","126","2024-12-30"
"08225","2024","COM","2022","213","6","219","2024-12-30"
"08226","2024","COM","2022","164","4","168","2024-12-30"
"08228","2024","COM","2022","152","5","157","2024-12-30"
"08229","2024","COM","2022","143","6","149","2024-12-30"
"08230","2024","COM","2022","404","6","410","2024-12-30"
"08232","2024","COM","2022","416","9","425","2024-12-30"
"08233","2024","COM","2022","43","1","44","2024-12-30"
"08234","2024","COM","2022","136","0","136","2024-12-30"
"08235","2024","COM","2022","399","4","403","2024-12-30"
"08236","2024","COM","2022","304","10","314","2024-12-30"
"08237","2024","COM","2022","631","19","650","2024-12-30"
"08238","2024","COM","2022","89","3","92","2024-12-30"
"08239","2024","COM","2022","1232","34","1266","2024-12-30"
"08240","2024","COM","2022","164","4","168","2024-12-30"
"08242","2024","COM","2022","410","6","416","2024-12-30"
"08243","2024","COM","2022","165","3","168","2024-12-30"
"08244","2024","COM","2022","76","3","79","2024-12-30"
"08245","2024","COM","2022","31","2","33","2024-12-30"
"08246","2024","COM","2022","68","2","70","2024-12-30"
"08247","2024","COM","2022","129","2","131","2024-12-30"
"08248","2024","COM","2022","686","7","693","2024-12-30"
"08249","2024","COM","2022","233","3","236","2024-12-30"
"08250","2024","COM","2022","189","1","190","2024-12-30"
"08251","2024","COM","2022","65","0","65","2024-12-30"
"08252","2024","COM","2022","110","2","112","2024-12-30"
"08254","2024","COM","2022","596","7","603","2024-12-30"
"08255","2024","COM","2022","219","3","222","2024-12-30"
"08256","2024","COM","2022","89","7","96","2024-12-30"
"08257","2024","COM","2022","153","4","157","2024-12-30"
"08259","2024","COM","2022","66","2","68","2024-12-30"
"08260","2024","COM","2022","618","9","627","2024-12-30"
"08262","2024","COM","2022","579","30","609","2024-12-30"
"08263","2024","COM","2022","1103","18","1121","2024-12-30"
"08264","2024","COM","2022","492","17","509","2024-12-30"
"08268","2024","COM","2022","69","2","71","2024-12-30"
"08269","2024","COM","2022","79","1","80","2024-12-30"
"08271","2024","COM","2022","105","1","106","2024-12-30"
"08272","2024","COM","2022","54","0","54","2024-12-30"
"08273","2024","COM","2022","79","1","80","2024-12-30"
"08274","2024","COM","2022","89","5","94","2024-12-30"
"08275","2024","COM","2022","210","6","216","2024-12-30"
"08276","2024","COM","2022","711","13","724","2024-12-30"
"08277","2024","COM","2022","125","4","129","2024-12-30"
"08278","2024","COM","2022","74","2","76","2024-12-30"
"08279","2024","COM","2022","62","2","64","2024-12-30"
"08280","2024","COM","2022","70","2","72","2024-12-30"
"08281","2024","COM","2022","439","6","445","2024-12-30"
"08282","2024","COM","2022","1025","57","1082","2024-12-30"
"08283","2024","COM","2022","128","1","129","2024-12-30"
"08284","2024","COM","2022","856","22","878","2024-12-30"
"08286","2024","COM","2022","102","1","103","2024-12-30"
"08287","2024","COM","2022","144","3","147","2024-12-30"
"08288","2024","COM","2022","91","1","92","2024-12-30"
"08289","2024","COM","2022","588","9","597","2024-12-30"
"08291","2024","COM","2022","231","5","236","2024-12-30"
"08293","2024","COM","2022","136","5","141","2024-12-30"
"08295","2024","COM","2022","193","6","199","2024-12-30"
"08296","2024","COM","2022","111","3","114","2024-12-30"
"08297","2024","COM","2022","299","9","308","2024-12-30"
"08298","2024","COM","2022","1560","45","1605","2024-12-30"
"08300","2024","COM","2022","11","1","12","2024-12-30"
"08301","2024","COM","2022","71","3","74","2024-12-30"
"08302","2024","COM","2022","2155","75","2230","2024-12-30"
"08303","2024","COM","2022","396","8","404","2024-12-30"
"08304","2024","COM","2022","77","2","79","2024-12-30"
"08305","2024","COM","2022","220","2","222","2024-12-30"
"08306","2024","COM","2022","51","3","54","2024-12-30"
"08307","2024","COM","2022","84","1","85","2024-12-30"
"08308","2024","COM","2022","88","1","89","2024-12-30"
"08309","2024","COM","2022","53","3","56","2024-12-30"
"08310","2024","COM","2022","74","2","76","2024-12-30"
"08311","2024","COM","2022","2236","39","2275","2024-12-30"
"08312","2024","COM","2022","175","4","179","2024-12-30"
"08313","2024","COM","2022","149","2","151","2024-12-30"
"08314","2024","COM","2022","850","18","868","2024-12-30"
"08315","2024","COM","2022","68","0","68","2024-12-30"
"08316","2024","COM","2022","988","15","1003","2024-12-30"
"08317","2024","COM","2022","111","2","113","2024-12-30"
"08318","2024","COM","2022","351","2","353","2024-12-30"
"08319","2024","COM","2022","327","8","335","2024-12-30"
"08320","2024","COM","2022","531","16","547","2024-12-30"
"08321","2024","COM","2022","170","4","174","2024-12-30"
"08322","2024","COM","2022","329","12","341","2024-12-30"
"08323","2024","COM","2022","162","1","163","2024-12-30"
"08324","2024","COM","2022","119","2","121","2024-12-30"
"08325","2024","COM","2022","24","2","26","2024-12-30"
"08326","2024","COM","2022","110","1","111","2024-12-30"
"08327","2024","COM","2022","2235","35","2270","2024-12-30"
"08328","2024","COM","2022","5548","68","5616","2024-12-30"
"08329","2024","COM","2022","519","10","529","2024-12-30"
"08330","2024","COM","2022","744","10","754","2024-12-30"
"08331","2024","COM","2022","670","17","687","2024-12-30"
"08332","2024","COM","2022","34","4","38","2024-12-30"
"08333","2024","COM","2022","224","8","232","2024-12-30"
"08334","2024","COM","2022","43","2","45","2024-12-30"
"08335","2024","COM","2022","72","3","75","2024-12-30"
"08336","2024","COM","2022","229","8","237","2024-12-30"
"08338","2024","COM","2022","198","2","200","2024-12-30"
"08339","2024","COM","2022","303","4","307","2024-12-30"
"08340","2024","COM","2022","169","4","173","2024-12-30"
"08341","2024","COM","2022","892","42","934","2024-12-30"
"08342","2024","COM","2022","234","3","237","2024-12-30"
"08343","2024","COM","2022","1129","36","1165","2024-12-30"
"08344","2024","COM","2022","132","5","137","2024-12-30"
"08346","2024","COM","2022","1387","37","1424","2024-12-30"
"08347","2024","COM","2022","218","3","221","2024-12-30"
"08348","2024","COM","2022","110","1","111","2024-12-30"
"08349","2024","COM","2022","563","8","571","2024-12-30"
"08350","2024","COM","2022","244","3","247","2024-12-30"
"08351","2024","COM","2022","66","2","68","2024-12-30"
"08352","2024","COM","2022","226","2","228","2024-12-30"
"08353","2024","COM","2022","707","18","725","2024-12-30"
"08354","2024","COM","2022","815","12","827","2024-12-30"
"08355","2024","COM","2022","377","6","383","2024-12-30"
"08356","2024","COM","2022","173","1","174","2024-12-30"
"08357","2024","COM","2022","762","22","784","2024-12-30"
"08358","2024","COM","2022","263","3","266","2024-12-30"
"08360","2024","COM","2022","192","1","193","2024-12-30"
"08361","2024","COM","2022","1637","55","1692","2024-12-30"
"08362","2024","COM","2022","7435","268","7703","2024-12-30"
"08363","2024","COM","2022","5795","129","5924","2024-12-30"
"08364","2024","COM","2022","124","1","125","2024-12-30"
"08365","2024","COM","2022","1328","16","1344","2024-12-30"
"08366","2024","COM","2022","652","6","658","2024-12-30"
"08367","2024","COM","2022","2256","30","2286","2024-12-30"
"08368","2024","COM","2022","220","3","223","2024-12-30"
"08369","2024","COM","2022","130","3","133","2024-12-30"
"08370","2024","COM","2022","528","10","538","2024-12-30"
"08372","2024","COM","2022","61","0","61","2024-12-30"
"08373","2024","COM","2022","269","5","274","2024-12-30"
"08374","2024","COM","2022","128","0","128","2024-12-30"
"08375","2024","COM","2022","178","4","182","2024-12-30"
"08376","2024","COM","2022","249","4","253","2024-12-30"
"08377","2024","COM","2022","151","2","153","2024-12-30"
"08378","2024","COM","2022","109","1","110","2024-12-30"
"08379","2024","COM","2022","245","10","255","2024-12-30"
"08380","2024","COM","2022","217","4","221","2024-12-30"
"08381","2024","COM","2022","813","11","824","2024-12-30"
"08382","2024","COM","2022","93","2","95","2024-12-30"
"08383","2024","COM","2022","100","4","104","2024-12-30"
"08384","2024","COM","2022","130","5","135","2024-12-30"
"08385","2024","COM","2022","1073","173","1246","2024-12-30"
"08386","2024","COM","2022","340","3","343","2024-12-30"
"08387","2024","COM","2022","179","0","179","2024-12-30"
"08388","2024","COM","2022","351","8","359","2024-12-30"
"08389","2024","COM","2022","320","3","323","2024-12-30"
"08390","2024","COM","2022","78","3","81","2024-12-30"
"08391","2024","COM","2022","934","15","949","2024-12-30"
"08392","2024","COM","2022","181","11","192","2024-12-30"
"08393","2024","COM","2022","66","0","66","2024-12-30"
"08394","2024","COM","2022","71","3","74","2024-12-30"
"08395","2024","COM","2022","148","4","152","2024-12-30"
"08396","2024","COM","2022","124","0","124","2024-12-30"
"08397","2024","COM","2022","55","0","55","2024-12-30"
"08398","2024","COM","2022","83","3","86","2024-12-30"
"08399","2024","COM","2022","149","1","150","2024-12-30"
"08400","2024","COM","2022","516","12","528","2024-12-30"
"08401","2024","COM","2022","221","3","224","2024-12-30"
"08402","2024","COM","2022","841","16","857","2024-12-30"
"08403","2024","COM","2022","1932","20","1952","2024-12-30"
"08404","2024","COM","2022","208","4","212","2024-12-30"
"08405","2024","COM","2022","240","4","244","2024-12-30"
"08406","2024","COM","2022","350","5","355","2024-12-30"
"08407","2024","COM","2022","60","0","60","2024-12-30"
"08408","2024","COM","2022","536","12","548","2024-12-30"
"08409","2024","COM","2022","16727","348","17075","2024-12-30"
"08410","2024","COM","2022","173","17","190","2024-12-30"
"08411","2024","COM","2022","87","0","87","2024-12-30"
"08412","2024","COM","2022","152","4","156","2024-12-30"
"08413","2024","COM","2022","257","3","260","2024-12-30"
"08415","2024","COM","2022","319","10","329","2024-12-30"
"08416","2024","COM","2022","182","2","184","2024-12-30"
"08417","2024","COM","2022","274","6","280","2024-12-30"
"08418","2024","COM","2022","222","3","225","2024-12-30"
"08419","2024","COM","2022","1346","18","1364","2024-12-30"
"08420","2024","COM","2022","1219","22","1241","2024-12-30"
"08421","2024","COM","2022","93","1","94","2024-12-30"
"08422","2024","COM","2022","137","3","140","2024-12-30"
"08424","2024","COM","2022","131","3","134","2024-12-30"
"08425","2024","COM","2022","48","0","48","2024-12-30"
"08426","2024","COM","2022","89","3","92","2024-12-30"
"08427","2024","COM","2022","222","1","223","2024-12-30"
"08428","2024","COM","2022","147","2","149","2024-12-30"
"08429","2024","COM","2022","527","7","534","2024-12-30"
"08430","2024","COM","2022","39","0","39","2024-12-30"
"08431","2024","COM","2022","94","7","101","2024-12-30"
"08432","2024","COM","2022","95","3","98","2024-12-30"
"08433","2024","COM","2022","56","2","58","2024-12-30"
"08434","2024","COM","2022","56","2","58","2024-12-30"
"08435","2024","COM","2022","892","18","910","2024-12-30"
"08436","2024","COM","2022","405","8","413","2024-12-30"
"08437","2024","COM","2022","179","5","184","2024-12-30"
"08438","2024","COM","2022","101","5","106","2024-12-30"
"08439","2024","COM","2022","151","10","161","2024-12-30"
"08440","2024","COM","2022","123","2","125","2024-12-30"
"08444","2024","COM","2022","131","4","135","2024-12-30"
"08445","2024","COM","2022","404","6","410","2024-12-30"
"08446","2024","COM","2022","85","2","87","2024-12-30"
"08448","2024","COM","2022","983","13","996","2024-12-30"
"08449","2024","COM","2022","682","15","697","2024-12-30"
"08450","2024","COM","2022","225","10","235","2024-12-30"
"08451","2024","COM","2022","363","8","371","2024-12-30"
"08452","2024","COM","2022","248","7","255","2024-12-30"
"08453","2024","COM","2022","95","2","97","2024-12-30"
"08454","2024","COM","2022","82","0","82","2024-12-30"
"08455","2024","COM","2022","87","0","87","2024-12-30"
"08456","2024","COM","2022","233","4","237","2024-12-30"
"08457","2024","COM","2022","1058","30","1088","2024-12-30"
"08458","2024","COM","2022","178","4","182","2024-12-30"
"08459","2024","COM","2022","135","4","139","2024-12-30"
"08460","2024","COM","2022","156","1","157","2024-12-30"
"08461","2024","COM","2022","200","1","201","2024-12-30"
"08462","2024","COM","2022","141","2","143","2024-12-30"
"08463","2024","COM","2022","54","1","55","2024-12-30"
"08464","2024","COM","2022","78","0","78","2024-12-30"
"08465","2024","COM","2022","44","0","44","2024-12-30"
"08466","2024","COM","2022","72","1","73","2024-12-30"
"08467","2024","COM","2022","108","0","108","2024-12-30"
"08468","2024","COM","2022","189","1","190","2024-12-30"
"08469","2024","COM","2022","479","10","489","2024-12-30"
"08470","2024","COM","2022","64","1","65","2024-12-30"
"08471","2024","COM","2022","33","0","33","2024-12-30"
"08472","2024","COM","2022","300","6","306","2024-12-30"
"08473","2024","COM","2022","298","4","302","2024-12-30"
"08476","2024","COM","2022","417","7","424","2024-12-30"
"08477","2024","COM","2022","104","2","106","2024-12-30"
"08478","2024","COM","2022","238","6","244","2024-12-30"
"08479","2024","COM","2022","216","5","221","2024-12-30"
"08480","2024","COM","2022","3628","69","3697","2024-12-30"
"08481","2024","COM","2022","240","8","248","2024-12-30"
"08482","2024","COM","2022","102","3","105","2024-12-30"
"08483","2024","COM","2022","529","13","542","2024-12-30"
"08484","2024","COM","2022","73","0","73","2024-12-30"
"08485","2024","COM","2022","195","11","206","2024-12-30"
"08486","2024","COM","2022","1482","26","1508","2024-12-30"
"08487","2024","COM","2022","1849","45","1894","2024-12-30"
"08488","2024","COM","2022","2811","74","2885","2024-12-30"
"08489","2024","COM","2022","211","2","213","2024-12-30"
"08490","2024","COM","2022","3862","117","3979","2024-12-30"
"08491","2024","COM","2022","3524","55","3579","2024-12-30"
"08492","2024","COM","2022","332","9","341","2024-12-30"
"08494","2024","COM","2022","447","7","454","2024-12-30"
"08496","2024","COM","2022","108","1","109","2024-12-30"
"08497","2024","COM","2022","1280","28","1308","2024-12-30"
"08498","2024","COM","2022","384","14","398","2024-12-30"
"08499","2024","COM","2022","280","2","282","2024-12-30"
"08500","2024","COM","2022","57","0","57","2024-12-30"
"08501","2024","COM","2022","40","2","42","2024-12-30"
"08502","2024","COM","2022","85","0","85","2024-12-30"
"08503","2024","COM","2022","121","1","122","2024-12-30"
"09001","2024","COM","2022","59","1","60","2024-12-30"
"09002","2024","COM","2022","631","19","650","2024-12-30"
"09003","2024","COM","2022","375","7","382","2024-12-30"
"09004","2024","COM","2022","122","0","122","2024-12-30"
"09005","2024","COM","2022","131","3","134","2024-12-30"
"09006","2024","COM","2022","56","0","56","2024-12-30"
"09007","2024","COM","2022","75","0","75","2024-12-30"
"09008","2024","COM","2022","116","1","117","2024-12-30"
"09009","2024","COM","2022","265","5","270","2024-12-30"
"09011","2024","COM","2022","74","1","75","2024-12-30"
"09012","2024","COM","2022","28","2","30","2024-12-30"
"09013","2024","COM","2022","80","1","81","2024-12-30"
"09014","2024","COM","2022","192","7","199","2024-12-30"
"09015","2024","COM","2022","722","17","739","2024-12-30"
"09016","2024","COM","2022","214","8","222","2024-12-30"
"09017","2024","COM","2022","123","2","125","2024-12-30"
"09018","2024","COM","2022","92","4","96","2024-12-30"
"09019","2024","COM","2022","555","9","564","2024-12-30"
"09020","2024","COM","2022","32","0","32","2024-12-30"
"09021","2024","COM","2022","113","2","115","2024-12-30"
"09022","2024","COM","2022","237","2","239","2024-12-30"
"09023","2024","COM","2022","115","5","120","2024-12-30"
"09024","2024","COM","2022","193","4","197","2024-12-30"
"09025","2024","COM","2022","62","2","64","2024-12-30"
"09026","2024","COM","2022","146","1","147","2024-12-30"
"09027","2024","COM","2022","80","0","80","2024-12-30"
"09029","2024","COM","2022","146","2","148","2024-12-30"
"09030","2024","COM","2022","562","6","568","2024-12-30"
"09031","2024","COM","2022","39","3","42","2024-12-30"
"09032","2024","COM","2022","1277","65","1342","2024-12-30"
"09033","2024","COM","2022","41","1","42","2024-12-30"
"09034","2024","COM","2022","47","0","47","2024-12-30"
"09035","2024","COM","2022","197","3","200","2024-12-30"
"09037","2024","COM","2022","43","0","43","2024-12-30"
"09038","2024","COM","2022","373","6","379","2024-12-30"
"09039","2024","COM","2022","336","10","346","2024-12-30"
"09040","2024","COM","2022","310","4","314","2024-12-30"
"09041","2024","COM","2022","202","7","209","2024-12-30"
"09042","2024","COM","2022","972","14","986","2024-12-30"
"09043","2024","COM","2022","676","16","692","2024-12-30"
"09044","2024","COM","2022","165","2","167","2024-12-30"
"09045","2024","COM","2022","195","1","196","2024-12-30"
"09046","2024","COM","2022","76","1","77","2024-12-30"
"09047","2024","COM","2022","1085","21","1106","2024-12-30"
"09048","2024","COM","2022","84","0","84","2024-12-30"
"09049","2024","COM","2022","174","3","177","2024-12-30"
"09050","2024","COM","2022","502","7","509","2024-12-30"
"09051","2024","COM","2022","151","4","155","2024-12-30"
"09052","2024","COM","2022","165","7","172","2024-12-30"
"09053","2024","COM","2022","30","3","33","2024-12-30"
"09054","2024","COM","2022","356","4","360","2024-12-30"
"09055","2024","COM","2022","100","2","102","2024-12-30"
"09056","2024","COM","2022","476","11","487","2024-12-30"
"09057","2024","COM","2022","307","4","311","2024-12-30"
"09058","2024","COM","2022","200","3","203","2024-12-30"
"09059","2024","COM","2022","125","4","129","2024-12-30"
"09060","2024","COM","2022","789","9","798","2024-12-30"
"09061","2024","COM","2022","472","5","477","2024-12-30"
"09062","2024","COM","2022","216","6","222","2024-12-30"
"09063","2024","COM","2022","114","2","116","2024-12-30"
"09064","2024","COM","2022","41","0","41","2024-12-30"
"09065","2024","COM","2022","243","2","245","2024-12-30"
"09066","2024","COM","2022","621","10","631","2024-12-30"
"09067","2024","COM","2022","206","2","208","2024-12-30"
"09068","2024","COM","2022","44","0","44","2024-12-30"
"09069","2024","COM","2022","40","0","40","2024-12-30"
"09070","2024","COM","2022","330","8","338","2024-12-30"
"09071","2024","COM","2022","214","9","223","2024-12-30"
"09072","2024","COM","2022","45","1","46","2024-12-30"
"09073","2024","COM","2022","209","1","210","2024-12-30"
"09074","2024","COM","2022","152","1","153","2024-12-30"
"09075","2024","COM","2022","286","6","292","2024-12-30"
"09076","2024","COM","2022","212","3","215","2024-12-30"
"09077","2024","COM","2022","191","1","192","2024-12-30"
"09078","2024","COM","2022","71","0","71","2024-12-30"
"09079","2024","COM","2022","792","14","806","2024-12-30"
"09080","2024","COM","2022","166","5","171","2024-12-30"
"09081","2024","COM","2022","286","10","296","2024-12-30"
"09082","2024","COM","2022","458","9","467","2024-12-30"
"09083","2024","COM","2022","22","0","22","2024-12-30"
"09084","2024","COM","2022","95","1","96","2024-12-30"
"09085","2024","COM","2022","433","3","436","2024-12-30"
"09086","2024","COM","2022","338","5","343","2024-12-30"
"09087","2024","COM","2022","47","2","49","2024-12-30"
"09088","2024","COM","2022","14","0","14","2024-12-30"
"09089","2024","COM","2022","56","1","57","2024-12-30"
"09090","2024","COM","2022","45","7","52","2024-12-30"
"09091","2024","COM","2022","192","5","197","2024-12-30"
"09092","2024","COM","2022","61","3","64","2024-12-30"
"09093","2024","COM","2022","143","1","144","2024-12-30"
"09094","2024","COM","2022","140","4","144","2024-12-30"
"09095","2024","COM","2022","162","3","165","2024-12-30"
"09096","2024","COM","2022","41","0","41","2024-12-30"
"09097","2024","COM","2022","118","0","118","2024-12-30"
"09098","2024","COM","2022","71","0","71","2024-12-30"
"09099","2024","COM","2022","358","14","372","2024-12-30"
"09100","2024","COM","2022","103","1","104","2024-12-30"
"09101","2024","COM","2022","278","4","282","2024-12-30"
"09102","2024","COM","2022","179","8","187","2024-12-30"
"09103","2024","COM","2022","952","21","973","2024-12-30"
"09104","2024","COM","2022","784","18","802","2024-12-30"
"09105","2024","COM","2022","804","11","815","2024-12-30"
"09106","2024","COM","2022","363","17","380","2024-12-30"
"09107","2024","COM","2022","650","12","662","2024-12-30"
"09108","2024","COM","2022","179","7","186","2024-12-30"
"09109","2024","COM","2022","185","3","188","2024-12-30"
"09110","2024","COM","2022","98","2","100","2024-12-30"
"09111","2024","COM","2022","314","14","328","2024-12-30"
"09113","2024","COM","2022","580","3","583","2024-12-30"
"09114","2024","COM","2022","132","2","134","2024-12-30"
"09115","2024","COM","2022","121","0","121","2024-12-30"
"09116","2024","COM","2022","362","5","367","2024-12-30"
"09117","2024","COM","2022","105","0","105","2024-12-30"
"09118","2024","COM","2022","171","2","173","2024-12-30"
"09119","2024","COM","2022","530","11","541","2024-12-30"
"09120","2024","COM","2022","353","4","357","2024-12-30"
"09121","2024","COM","2022","775","87","862","2024-12-30"
"09122","2024","COM","2022","9731","320","10051","2024-12-30"
"09123","2024","COM","2022","107","5","112","2024-12-30"
"09124","2024","COM","2022","1061","16","1077","2024-12-30"
"09125","2024","COM","2022","430","5","435","2024-12-30"
"09126","2024","COM","2022","82","3","85","2024-12-30"
"09127","2024","COM","2022","124","1","125","2024-12-30"
"09128","2024","COM","2022","330","14","344","2024-12-30"
"09129","2024","COM","2022","113","4","117","2024-12-30"
"09130","2024","COM","2022","746","17","763","2024-12-30"
"09131","2024","COM","2022","146","0","146","2024-12-30"
"09132","2024","COM","2022","235","4","239","2024-12-30"
"09133","2024","COM","2022","24","0","24","2024-12-30"
"09134","2024","COM","2022","36","0","36","2024-12-30"
"09136","2024","COM","2022","79","0","79","2024-12-30"
"09137","2024","COM","2022","197","7","204","2024-12-30"
"09138","2024","COM","2022","189","28","217","2024-12-30"
"09139","2024","COM","2022","95","5","100","2024-12-30"
"09140","2024","COM","2022","126","6","132","2024-12-30"
"09141","2024","COM","2022","73","0","73","2024-12-30"
"09142","2024","COM","2022","124","0","124","2024-12-30"
"09143","2024","COM","2022","38","0","38","2024-12-30"
"09145","2024","COM","2022","253","11","264","2024-12-30"
"09146","2024","COM","2022","58","0","58","2024-12-30"
"09147","2024","COM","2022","177","2","179","2024-12-30"
"09148","2024","COM","2022","116","5","121","2024-12-30"
"09149","2024","COM","2022","201","2","203","2024-12-30"
"09150","2024","COM","2022","210","4","214","2024-12-30"
"09151","2024","COM","2022","62","0","62","2024-12-30"
"09152","2024","COM","2022","18","1","19","2024-12-30"
"09153","2024","COM","2022","120","4","124","2024-12-30"
"09154","2024","COM","2022","60","1","61","2024-12-30"
"09155","2024","COM","2022","49","0","49","2024-12-30"
"09156","2024","COM","2022","19","2","21","2024-12-30"
"09157","2024","COM","2022","2414","29","2443","2024-12-30"
"09158","2024","COM","2022","252","7","259","2024-12-30"
"09159","2024","COM","2022","84","2","86","2024-12-30"
"09160","2024","COM","2022","6018","115","6133","2024-12-30"
"09161","2024","COM","2022","616","18","634","2024-12-30"
"09162","2024","COM","2022","14","0","14","2024-12-30"
"09163","2024","COM","2022","82","0","82","2024-12-30"
"09164","2024","COM","2022","483","16","499","2024-12-30"
"09165","2024","COM","2022","233","5","238","2024-12-30"
"09166","2024","COM","2022","112","2","114","2024-12-30"
"09167","2024","COM","2022","2341","38","2379","2024-12-30"
"09168","2024","COM","2022","180","7","187","2024-12-30"
"09169","2024","COM","2022","119","3","122","2024-12-30"
"09170","2024","COM","2022","240","8","248","2024-12-30"
"09171","2024","COM","2022","63","1","64","2024-12-30"
"09172","2024","COM","2022","28","0","28","2024-12-30"
"09173","2024","COM","2022","277","4","281","2024-12-30"
"09174","2024","COM","2022","359","9","368","2024-12-30"
"09175","2024","COM","2022","99","4","103","2024-12-30"
"09176","2024","COM","2022","514","10","524","2024-12-30"
"09177","2024","COM","2022","272","7","279","2024-12-30"
"09178","2024","COM","2022","37","2","39","2024-12-30"
"09179","2024","COM","2022","79","3","82","2024-12-30"
"09180","2024","COM","2022","128","1","129","2024-12-30"
"09181","2024","COM","2022","1236","20","1256","2024-12-30"
"09182","2024","COM","2022","741","13","754","2024-12-30"
"09183","2024","COM","2022","99","5","104","2024-12-30"
"09184","2024","COM","2022","52","1","53","2024-12-30"
"09185","2024","COM","2022","3866","83","3949","2024-12-30"
"09186","2024","COM","2022","97","0","97","2024-12-30"
"09187","2024","COM","2022","352","7","359","2024-12-30"
"09188","2024","COM","2022","1226","20","1246","2024-12-30"
"09189","2024","COM","2022","168","4","172","2024-12-30"
"09190","2024","COM","2022","113","2","115","2024-12-30"
"09192","2024","COM","2022","132","5","137","2024-12-30"
"09193","2024","COM","2022","58","0","58","2024-12-30"
"09194","2024","COM","2022","3106","124","3230","2024-12-30"
"09195","2024","COM","2022","26","0","26","2024-12-30"
"09196","2024","COM","2022","82","1","83","2024-12-30"
"09197","2024","COM","2022","17","0","17","2024-12-30"
"09198","2024","COM","2022","223","6","229","2024-12-30"
"09199","2024","COM","2022","694","17","711","2024-12-30"
"09200","2024","COM","2022","93","3","96","2024-12-30"
"09201","2024","COM","2022","73","1","74","2024-12-30"
"09202","2024","COM","2022","319","9","328","2024-12-30"
"09203","2024","COM","2022","157","5","162","2024-12-30"
"09204","2024","COM","2022","261","10","271","2024-12-30"
"09205","2024","COM","2022","94","1","95","2024-12-30"
"09206","2024","COM","2022","544","12","556","2024-12-30"
"09207","2024","COM","2022","1456","37","1493","2024-12-30"
"09208","2024","COM","2022","112","1","113","2024-12-30"
"09209","2024","COM","2022","1001","24","1025","2024-12-30"
"09210","2024","COM","2022","416","7","423","2024-12-30"
"09211","2024","COM","2022","116","1","117","2024-12-30"
"09212","2024","COM","2022","103","3","106","2024-12-30"
"09213","2024","COM","2022","235","2","237","2024-12-30"
"09214","2024","COM","2022","796","14","810","2024-12-30"
"09215","2024","COM","2022","112","2","114","2024-12-30"
"09216","2024","COM","2022","58","0","58","2024-12-30"
"09217","2024","COM","2022","151","3","154","2024-12-30"
"09218","2024","COM","2022","101","1","102","2024-12-30"
"09219","2024","COM","2022","164","2","166","2024-12-30"
"09220","2024","COM","2022","160","4","164","2024-12-30"
"09221","2024","COM","2022","248","3","251","2024-12-30"
"09222","2024","COM","2022","24","0","24","2024-12-30"
"09223","2024","COM","2022","574","7","581","2024-12-30"
"09224","2024","COM","2022","511","1","512","2024-12-30"
"09225","2024","COM","2022","16512","524","17036","2024-12-30"
"09226","2024","COM","2022","37","0","37","2024-12-30"
"09227","2024","COM","2022","186","1","187","2024-12-30"
"09228","2024","COM","2022","219","4","223","2024-12-30"
"09229","2024","COM","2022","496","12","508","2024-12-30"
"09230","2024","COM","2022","61","0","61","2024-12-30"
"09231","2024","COM","2022","167","2","169","2024-12-30"
"09232","2024","COM","2022","46","1","47","2024-12-30"
"09233","2024","COM","2022","44","1","45","2024-12-30"
"09234","2024","COM","2022","124","3","127","2024-12-30"
"09235","2024","COM","2022","858","15","873","2024-12-30"
"09236","2024","COM","2022","366","12","378","2024-12-30"
"09237","2024","COM","2022","28","1","29","2024-12-30"
"09238","2024","COM","2022","862","16","878","2024-12-30"
"09239","2024","COM","2022","137","2","139","2024-12-30"
"09240","2024","COM","2022","298","2","300","2024-12-30"
"09241","2024","COM","2022","368","6","374","2024-12-30"
"09242","2024","COM","2022","49","1","50","2024-12-30"
"09243","2024","COM","2022","94","2","96","2024-12-30"
"09244","2024","COM","2022","720","12","732","2024-12-30"
"09245","2024","COM","2022","1261","36","1297","2024-12-30"
"09246","2024","COM","2022","542","24","566","2024-12-30"
"09247","2024","COM","2022","192","2","194","2024-12-30"
"09249","2024","COM","2022","150","4","154","2024-12-30"
"09250","2024","COM","2022","83","1","84","2024-12-30"
"09251","2024","COM","2022","169","0","169","2024-12-30"
"09252","2024","COM","2022","85","0","85","2024-12-30"
"09253","2024","COM","2022","377","6","383","2024-12-30"
"09254","2024","COM","2022","272","7","279","2024-12-30"
"09256","2024","COM","2022","57","0","57","2024-12-30"
"09257","2024","COM","2022","652","9","661","2024-12-30"
"09258","2024","COM","2022","469","10","479","2024-12-30"
"09259","2024","COM","2022","152","4","156","2024-12-30"
"09260","2024","COM","2022","30","0","30","2024-12-30"
"09261","2024","COM","2022","6129","401","6530","2024-12-30"
"09262","2024","COM","2022","370","5","375","2024-12-30"
"09263","2024","COM","2022","28","0","28","2024-12-30"
"09264","2024","COM","2022","1288","17","1305","2024-12-30"
"09265","2024","COM","2022","2864","60","2924","2024-12-30"
"09266","2024","COM","2022","83","2","85","2024-12-30"
"09267","2024","COM","2022","147","2","149","2024-12-30"
"09268","2024","COM","2022","1384","38","1422","2024-12-30"
"09269","2024","COM","2022","375","9","384","2024-12-30"
"09270","2024","COM","2022","251","5","256","2024-12-30"
"09271","2024","COM","2022","91","3","94","2024-12-30"
"09272","2024","COM","2022","1354","25","1379","2024-12-30"
"09273","2024","COM","2022","676","18","694","2024-12-30"
"09274","2024","COM","2022","320","5","325","2024-12-30"
"09275","2024","COM","2022","369","10","379","2024-12-30"
"09276","2024","COM","2022","215","7","222","2024-12-30"
"09277","2024","COM","2022","670","9","679","2024-12-30"
"09279","2024","COM","2022","46","2","48","2024-12-30"
"09280","2024","COM","2022","697","13","710","2024-12-30"
"09281","2024","COM","2022","127","2","129","2024-12-30"
"09282","2024","COM","2022","4808","152","4960","2024-12-30"
"09283","2024","COM","2022","397","16","413","2024-12-30"
"09284","2024","COM","2022","194","6","200","2024-12-30"
"09285","2024","COM","2022","743","10","753","2024-12-30"
"09287","2024","COM","2022","6","0","6","2024-12-30"
"09289","2024","COM","2022","1392","23","1415","2024-12-30"
"09290","2024","COM","2022","170","1","171","2024-12-30"
"09291","2024","COM","2022","105","2","107","2024-12-30"
"09292","2024","COM","2022","47","0","47","2024-12-30"
"09293","2024","COM","2022","772","16","788","2024-12-30"
"09294","2024","COM","2022","94","2","96","2024-12-30"
"09295","2024","COM","2022","95","1","96","2024-12-30"
"09296","2024","COM","2022","157","2","159","2024-12-30"
"09297","2024","COM","2022","28","0","28","2024-12-30"
"09298","2024","COM","2022","90","1","91","2024-12-30"
"09299","2024","COM","2022","425","6","431","2024-12-30"
"09300","2024","COM","2022","171","5","176","2024-12-30"
"09301","2024","COM","2022","391","1","392","2024-12-30"
"09303","2024","COM","2022","333","5","338","2024-12-30"
"09304","2024","COM","2022","24","0","24","2024-12-30"
"09305","2024","COM","2022","342","6","348","2024-12-30"
"09306","2024","COM","2022","3060","35","3095","2024-12-30"
"09307","2024","COM","2022","160","5","165","2024-12-30"
"09308","2024","COM","2022","206","8","214","2024-12-30"
"09309","2024","COM","2022","162","5","167","2024-12-30"
"09310","2024","COM","2022","40","2","42","2024-12-30"
"09311","2024","COM","2022","20","0","20","2024-12-30"
"09312","2024","COM","2022","3268","73","3341","2024-12-30"
"09313","2024","COM","2022","165","4","169","2024-12-30"
"09314","2024","COM","2022","247","14","261","2024-12-30"
"09315","2024","COM","2022","105","1","106","2024-12-30"
"09316","2024","COM","2022","110","1","111","2024-12-30"
"09318","2024","COM","2022","127","2","129","2024-12-30"
"09319","2024","COM","2022","119","4","123","2024-12-30"
"09320","2024","COM","2022","27","1","28","2024-12-30"
"09321","2024","COM","2022","308","4","312","2024-12-30"
"09322","2024","COM","2022","259","10","269","2024-12-30"
"09323","2024","COM","2022","87","1","88","2024-12-30"
"09324","2024","COM","2022","3491","66","3557","2024-12-30"
"09325","2024","COM","2022","35","0","35","2024-12-30"
"09326","2024","COM","2022","115","3","118","2024-12-30"
"09327","2024","COM","2022","235","4","239","2024-12-30"
"09328","2024","COM","2022","208","9","217","2024-12-30"
"09329","2024","COM","2022","710","20","730","2024-12-30"
"09330","2024","COM","2022","34","2","36","2024-12-30"
"09331","2024","COM","2022","693","16","709","2024-12-30"
"09332","2024","COM","2022","2381","52","2433","2024-12-30"
"09334","2024","COM","2022","571","57","628","2024-12-30"
"09335","2024","COM","2022","42","0","42","2024-12-30"
"09336","2024","COM","2022","962","15","977","2024-12-30"
"09338","2024","COM","2022","154","3","157","2024-12-30"
"09339","2024","COM","2022","752","16","768","2024-12-30"
"09340","2024","COM","2022","158","4","162","2024-12-30"
"09341","2024","COM","2022","156","0","156","2024-12-30"
"09342","2024","COM","2022","249","4","253","2024-12-30"
"10002","2024","COM","2022","223","6","229","2024-12-30"
"10003","2024","COM","2022","3336","40","3376","2024-12-30"
"10004","2024","COM","2022","211","5","216","2024-12-30"
"10005","2024","COM","2022","244","10","254","2024-12-30"
"10006","2024","COM","2022","2779","82","2861","2024-12-30"
"10007","2024","COM","2022","107","0","107","2024-12-30"
"10008","2024","COM","2022","107","1","108","2024-12-30"
"10009","2024","COM","2022","88","1","89","2024-12-30"
"10010","2024","COM","2022","47","2","49","2024-12-30"
"10011","2024","COM","2022","187","2","189","2024-12-30"
"10012","2024","COM","2022","289","5","294","2024-12-30"
"10013","2024","COM","2022","137","5","142","2024-12-30"
"10014","2024","COM","2022","189","3","192","2024-12-30"
"10015","2024","COM","2022","391","6","397","2024-12-30"
"10017","2024","COM","2022","110","4","114","2024-12-30"
"10018","2024","COM","2022","934","16","950","2024-12-30"
"10019","2024","COM","2022","364","8","372","2024-12-30"
"10020","2024","COM","2022","513","10","523","2024-12-30"
"10021","2024","COM","2022","156","2","158","2024-12-30"
"10022","2024","COM","2022","198","12","210","2024-12-30"
"10023","2024","COM","2022","209","4","213","2024-12-30"
"10024","2024","COM","2022","168","3","171","2024-12-30"
"10025","2024","COM","2022","177","6","183","2024-12-30"
"10026","2024","COM","2022","36","1","37","2024-12-30"
"10027","2024","COM","2022","57","2","59","2024-12-30"
"10028","2024","COM","2022","112","2","114","2024-12-30"
"10029","2024","COM","2022","157","2","159","2024-12-30"
"10030","2024","COM","2022","1551","30","1581","2024-12-30"
"10031","2024","COM","2022","447","12","459","2024-12-30"
"10032","2024","COM","2022","268","7","275","2024-12-30"
"10033","2024","COM","2022","4743","204","4947","2024-12-30"
"10034","2024","COM","2022","2869","197","3066","2024-12-30"
"10035","2024","COM","2022","741","9","750","2024-12-30"
"10037","2024","COM","2022","419","10","429","2024-12-30"
"10038","2024","COM","2022","190","1","191","2024-12-30"
"10039","2024","COM","2022","111","6","117","2024-12-30"
"10040","2024","COM","2022","162","3","165","2024-12-30"
"10041","2024","COM","2022","52","0","52","2024-12-30"
"10042","2024","COM","2022","196","3","199","2024-12-30"
"10043","2024","COM","2022","114","3","117","2024-12-30"
"10044","2024","COM","2022","33","0","33","2024-12-30"
"10045","2024","COM","2022","178","9","187","2024-12-30"
"10046","2024","COM","2022","98","2","100","2024-12-30"
"10047","2024","COM","2022","43","0","43","2024-12-30"
"10048","2024","COM","2022","161","5","166","2024-12-30"
"10049","2024","COM","2022","539","9","548","2024-12-30"
"10050","2024","COM","2022","193","3","196","2024-12-30"
"10051","2024","COM","2022","1074","51","1125","2024-12-30"
"10052","2024","COM","2022","227","5","232","2024-12-30"
"10053","2024","COM","2022","623","15","638","2024-12-30"
"10054","2024","COM","2022","123","0","123","2024-12-30"
"10055","2024","COM","2022","252","11","263","2024-12-30"
"10056","2024","COM","2022","248","2","250","2024-12-30"
"10057","2024","COM","2022","54","1","55","2024-12-30"
"10058","2024","COM","2022","221","4","225","2024-12-30"
"10059","2024","COM","2022","113","3","116","2024-12-30"
"10060","2024","COM","2022","3091","57","3148","2024-12-30"
"10061","2024","COM","2022","667","17","684","2024-12-30"
"10062","2024","COM","2022","196","3","199","2024-12-30"
"10063","2024","COM","2022","386","9","395","2024-12-30"
"10064","2024","COM","2022","2703","36","2739","2024-12-30"
"10065","2024","COM","2022","87","1","88","2024-12-30"
"10066","2024","COM","2022","433","7","440","2024-12-30"
"10067","2024","COM","2022","1959","31","1990","2024-12-30"
"10068","2024","COM","2022","112","2","114","2024-12-30"
"10069","2024","COM","2022","107","2","109","2024-12-30"
"10070","2024","COM","2022","489","20","509","2024-12-30"
"10071","2024","COM","2022","52","1","53","2024-12-30"
"10072","2024","COM","2022","32","0","32","2024-12-30"
"10073","2024","COM","2022","128","1","129","2024-12-30"
"10074","2024","COM","2022","503","8","511","2024-12-30"
"10075","2024","COM","2022","109","1","110","2024-12-30"
"10076","2024","COM","2022","259","9","268","2024-12-30"
"10077","2024","COM","2022","95","1","96","2024-12-30"
"10078","2024","COM","2022","26","0","26","2024-12-30"
"10079","2024","COM","2022","116","2","118","2024-12-30"
"10080","2024","COM","2022","1012","10","1022","2024-12-30"
"10081","2024","COM","2022","12603","85","12688","2024-12-30"
"10082","2024","COM","2022","232","4","236","2024-12-30"
"10083","2024","COM","2022","356","5","361","2024-12-30"
"10084","2024","COM","2022","1039","26","1065","2024-12-30"
"10085","2024","COM","2022","63","1","64","2024-12-30"
"10086","2024","COM","2022","242","7","249","2024-12-30"
"10087","2024","COM","2022","46","0","46","2024-12-30"
"10089","2024","COM","2022","705","7","712","2024-12-30"
"10090","2024","COM","2022","222","2","224","2024-12-30"
"10091","2024","COM","2022","140","4","144","2024-12-30"
"10092","2024","COM","2022","135","0","135","2024-12-30"
"10093","2024","COM","2022","109","2","111","2024-12-30"
"10094","2024","COM","2022","580","11","591","2024-12-30"
"10095","2024","COM","2022","280","3","283","2024-12-30"
"10096","2024","COM","2022","471","11","482","2024-12-30"
"10097","2024","COM","2022","149","2","151","2024-12-30"
"10098","2024","COM","2022","295","4","299","2024-12-30"
"10099","2024","COM","2022","534","13","547","2024-12-30"
"10100","2024","COM","2022","1150","22","1172","2024-12-30"
"10101","2024","COM","2022","171","2","173","2024-12-30"
"10102","2024","COM","2022","163","1","164","2024-12-30"
"10103","2024","COM","2022","155","1","156","2024-12-30"
"10104","2024","COM","2022","291","5","296","2024-12-30"
"10105","2024","COM","2022","23","1","24","2024-12-30"
"10106","2024","COM","2022","147","5","152","2024-12-30"
"10107","2024","COM","2022","103","0","103","2024-12-30"
"10108","2024","COM","2022","90","3","93","2024-12-30"
"10109","2024","COM","2022","213","2","215","2024-12-30"
"10110","2024","COM","2022","587","18","605","2024-12-30"
"10111","2024","COM","2022","100","2","102","2024-12-30"
"10112","2024","COM","2022","190","2","192","2024-12-30"
"10113","2024","COM","2022","197","2","199","2024-12-30"
"10114","2024","COM","2022","697","12","709","2024-12-30"
"10115","2024","COM","2022","1996","36","2032","2024-12-30"
"10116","2024","COM","2022","310","9","319","2024-12-30"
"10117","2024","COM","2022","125","1","126","2024-12-30"
"10118","2024","COM","2022","96","1","97","2024-12-30"
"10119","2024","COM","2022","167","4","171","2024-12-30"
"10120","2024","COM","2022","201","2","203","2024-12-30"
"10121","2024","COM","2022","343","8","351","2024-12-30"
"10122","2024","COM","2022","225","6","231","2024-12-30"
"10123","2024","COM","2022","821","24","845","2024-12-30"
"10124","2024","COM","2022","274","3","277","2024-12-30"
"10125","2024","COM","2022","307","2","309","2024-12-30"
"10126","2024","COM","2022","125","3","128","2024-12-30"
"10127","2024","COM","2022","53","1","54","2024-12-30"
"10128","2024","COM","2022","73","0","73","2024-12-30"
"10129","2024","COM","2022","312","9","321","2024-12-30"
"10130","2024","COM","2022","99","3","102","2024-12-30"
"10131","2024","COM","2022","342","6","348","2024-12-30"
"10132","2024","COM","2022","256","0","256","2024-12-30"
"10133","2024","COM","2022","251","5","256","2024-12-30"
"10134","2024","COM","2022","84","2","86","2024-12-30"
"10135","2024","COM","2022","87","3","90","2024-12-30"
"10136","2024","COM","2022","114","1","115","2024-12-30"
"10137","2024","COM","2022","28","0","28","2024-12-30"
"10138","2024","COM","2022","131","3","134","2024-12-30"
"10139","2024","COM","2022","154","4","158","2024-12-30"
"10140","2024","COM","2022","1108","10","1118","2024-12-30"
"10141","2024","COM","2022","711","14","725","2024-12-30"
"10142","2024","COM","2022","1797","21","1818","2024-12-30"
"10143","2024","COM","2022","144","4","148","2024-12-30"
"10144","2024","COM","2022","157","6","163","2024-12-30"
"10145","2024","COM","2022","215","6","221","2024-12-30"
"10146","2024","COM","2022","84","3","87","2024-12-30"
"10147","2024","COM","2022","120","1","121","2024-12-30"
"10148","2024","COM","2022","405","6","411","2024-12-30"
"10149","2024","COM","2022","332","5","337","2024-12-30"
"10150","2024","COM","2022","247","6","253","2024-12-30"
"10151","2024","COM","2022","903","13","916","2024-12-30"
"10153","2024","COM","2022","618","14","632","2024-12-30"
"10154","2024","COM","2022","70","2","72","2024-12-30"
"10155","2024","COM","2022","179","6","185","2024-12-30"
"10156","2024","COM","2022","715","8","723","2024-12-30"
"10157","2024","COM","2022","213","4","217","2024-12-30"
"10158","2024","COM","2022","507","7","514","2024-12-30"
"10159","2024","COM","2022","96","1","97","2024-12-30"
"10160","2024","COM","2022","36","0","36","2024-12-30"
"10161","2024","COM","2022","50","3","53","2024-12-30"
"10162","2024","COM","2022","285","4","289","2024-12-30"
"10163","2024","COM","2022","40","0","40","2024-12-30"
"10164","2024","COM","2022","704","8","712","2024-12-30"
"10165","2024","COM","2022","339","7","346","2024-12-30"
"10166","2024","COM","2022","398","5","403","2024-12-30"
"10167","2024","COM","2022","87","1","88","2024-12-30"
"10168","2024","COM","2022","80","1","81","2024-12-30"
"10169","2024","COM","2022","220","6","226","2024-12-30"
"10170","2024","COM","2022","464","9","473","2024-12-30"
"10171","2024","COM","2022","220","1","221","2024-12-30"
"10172","2024","COM","2022","150","1","151","2024-12-30"
"10173","2024","COM","2022","490","3","493","2024-12-30"
"10174","2024","COM","2022","171","3","174","2024-12-30"
"10175","2024","COM","2022","160","4","164","2024-12-30"
"10176","2024","COM","2022","141","5","146","2024-12-30"
"10177","2024","COM","2022","160","1","161","2024-12-30"
"10178","2024","COM","2022","253","5","258","2024-12-30"
"10179","2024","COM","2022","462","10","472","2024-12-30"
"10180","2024","COM","2022","96","3","99","2024-12-30"
"10181","2024","COM","2022","221","6","227","2024-12-30"
"10182","2024","COM","2022","108","1","109","2024-12-30"
"10183","2024","COM","2022","35","1","36","2024-12-30"
"10184","2024","COM","2022","130","1","131","2024-12-30"
"10185","2024","COM","2022","209","5","214","2024-12-30"
"10186","2024","COM","2022","530","17","547","2024-12-30"
"10187","2024","COM","2022","385","12","397","2024-12-30"
"10188","2024","COM","2022","214","3","217","2024-12-30"
"10189","2024","COM","2022","53","0","53","2024-12-30"
"10190","2024","COM","2022","559","10","569","2024-12-30"
"10191","2024","COM","2022","971","11","982","2024-12-30"
"10192","2024","COM","2022","128","1","129","2024-12-30"
"10193","2024","COM","2022","301","4","305","2024-12-30"
"10194","2024","COM","2022","91","1","92","2024-12-30"
"10195","2024","COM","2022","271","6","277","2024-12-30"
"10196","2024","COM","2022","222","4","226","2024-12-30"
"10197","2024","COM","2022","160","9","169","2024-12-30"
"10198","2024","COM","2022","115","2","117","2024-12-30"
"10199","2024","COM","2022","350","6","356","2024-12-30"
"10200","2024","COM","2022","94","3","97","2024-12-30"
"10201","2024","COM","2022","58","0","58","2024-12-30"
"10202","2024","COM","2022","214","80","294","2024-12-30"
"10203","2024","COM","2022","366","13","379","2024-12-30"
"10204","2024","COM","2022","138","4","142","2024-12-30"
"10205","2024","COM","2022","69","2","71","2024-12-30"
"10206","2024","COM","2022","132","1","133","2024-12-30"
"10207","2024","COM","2022","133","1","134","2024-12-30"
"10208","2024","COM","2022","300","13","313","2024-12-30"
"10209","2024","COM","2022","2265","59","2324","2024-12-30"
"10210","2024","COM","2022","460","12","472","2024-12-30"
"10211","2024","COM","2022","982","18","1000","2024-12-30"
"10212","2024","COM","2022","108","2","110","2024-12-30"
"10213","2024","COM","2022","163","3","166","2024-12-30"
"10214","2024","COM","2022","85","0","85","2024-12-30"
"10215","2024","COM","2022","261","2","263","2024-12-30"
"10216","2024","COM","2022","2012","25","2037","2024-12-30"
"10217","2024","COM","2022","35","0","35","2024-12-30"
"10218","2024","COM","2022","176","1","177","2024-12-30"
"10219","2024","COM","2022","64","1","65","2024-12-30"
"10220","2024","COM","2022","1521","32","1553","2024-12-30"
"10221","2024","COM","2022","160","0","160","2024-12-30"
"10222","2024","COM","2022","429","8","437","2024-12-30"
"10223","2024","COM","2022","713","4","717","2024-12-30"
"10224","2024","COM","2022","1753","46","1799","2024-12-30"
"10225","2024","COM","2022","235","6","241","2024-12-30"
"10226","2024","COM","2022","120","3","123","2024-12-30"
"10227","2024","COM","2022","363","4","367","2024-12-30"
"10228","2024","COM","2022","212","2","214","2024-12-30"
"10229","2024","COM","2022","99","1","100","2024-12-30"
"10230","2024","COM","2022","663","12","675","2024-12-30"
"10231","2024","COM","2022","617","15","632","2024-12-30"
"10232","2024","COM","2022","325","3","328","2024-12-30"
"10233","2024","COM","2022","1442","31","1473","2024-12-30"
"10234","2024","COM","2022","260","3","263","2024-12-30"
"10235","2024","COM","2022","56","0","56","2024-12-30"
"10236","2024","COM","2022","58","1","59","2024-12-30"
"10237","2024","COM","2022","583","30","613","2024-12-30"
"10238","2024","COM","2022","438","9","447","2024-12-30"
"10239","2024","COM","2022","574","24","598","2024-12-30"
"10240","2024","COM","2022","470","10","480","2024-12-30"
"10241","2024","COM","2022","55","0","55","2024-12-30"
"10242","2024","COM","2022","155","3","158","2024-12-30"
"10243","2024","COM","2022","103","1","104","2024-12-30"
"10245","2024","COM","2022","818","19","837","2024-12-30"
"10246","2024","COM","2022","246","21","267","2024-12-30"
"10247","2024","COM","2022","115","4","119","2024-12-30"
"10248","2024","COM","2022","388","12","400","2024-12-30"
"10249","2024","COM","2022","405","8","413","2024-12-30"
"10250","2024","COM","2022","218","6","224","2024-12-30"
"10251","2024","COM","2022","250","9","259","2024-12-30"
"10252","2024","COM","2022","64","2","66","2024-12-30"
"10253","2024","COM","2022","142","1","143","2024-12-30"
"10254","2024","COM","2022","329","14","343","2024-12-30"
"10255","2024","COM","2022","291","3","294","2024-12-30"
"10256","2024","COM","2022","396","8","404","2024-12-30"
"10257","2024","COM","2022","29","1","30","2024-12-30"
"10258","2024","COM","2022","270","7","277","2024-12-30"
"10259","2024","COM","2022","369","6","375","2024-12-30"
"10260","2024","COM","2022","661","17","678","2024-12-30"
"10261","2024","COM","2022","944","11","955","2024-12-30"
"10262","2024","COM","2022","383","8","391","2024-12-30"
"10263","2024","COM","2022","469","6","475","2024-12-30"
"10264","2024","COM","2022","104","3","107","2024-12-30"
"10265","2024","COM","2022","3260","36","3296","2024-12-30"
"10266","2024","COM","2022","44","0","44","2024-12-30"
"10267","2024","COM","2022","311","6","317","2024-12-30"
"10268","2024","COM","2022","5673","97","5770","2024-12-30"
"10269","2024","COM","2022","156","2","158","2024-12-30"
"10270","2024","COM","2022","260","7","267","2024-12-30"
"10271","2024","COM","2022","603","6","609","2024-12-30"
"10272","2024","COM","2022","168","1","169","2024-12-30"
"10273","2024","COM","2022","22","0","22","2024-12-30"
"10274","2024","COM","2022","312","4","316","2024-12-30"
"10275","2024","COM","2022","589","7","596","2024-12-30"
"10276","2024","COM","2022","334","5","339","2024-12-30"
"10278","2024","COM","2022","142","4","146","2024-12-30"
"10279","2024","COM","2022","47","0","47","2024-12-30"
"10280","2024","COM","2022","834","10","844","2024-12-30"
"10281","2024","COM","2022","278","3","281","2024-12-30"
"10282","2024","COM","2022","1396","21","1417","2024-12-30"
"10283","2024","COM","2022","128","3","131","2024-12-30"
"10284","2024","COM","2022","160","10","170","2024-12-30"
"10285","2024","COM","2022","63","0","63","2024-12-30"
"10286","2024","COM","2022","202","4","206","2024-12-30"
"10287","2024","COM","2022","1417","19","1436","2024-12-30"
"10288","2024","COM","2022","267","6","273","2024-12-30"
"10289","2024","COM","2022","963","15","978","2024-12-30"
"10290","2024","COM","2022","231","2","233","2024-12-30"
"10291","2024","COM","2022","183","6","189","2024-12-30"
"10293","2024","COM","2022","156","3","159","2024-12-30"
"10294","2024","COM","2022","58","0","58","2024-12-30"
"10295","2024","COM","2022","322","9","331","2024-12-30"
"10296","2024","COM","2022","176","2","178","2024-12-30"
"10297","2024","COM","2022","5202","87","5289","2024-12-30"
"10298","2024","COM","2022","1117","20","1137","2024-12-30"
"10299","2024","COM","2022","503","17","520","2024-12-30"
"10300","2024","COM","2022","266","5","271","2024-12-30"
"10301","2024","COM","2022","181","4","185","2024-12-30"
"10302","2024","COM","2022","91","2","93","2024-12-30"
"10303","2024","COM","2022","68","1","69","2024-12-30"
"10304","2024","COM","2022","179","1","180","2024-12-30"
"10305","2024","COM","2022","90","1","91","2024-12-30"
"10306","2024","COM","2022","223","3","226","2024-12-30"
"10307","2024","COM","2022","366","7","373","2024-12-30"
"10308","2024","COM","2022","222","5","227","2024-12-30"
"10309","2024","COM","2022","88","3","91","2024-12-30"
"10310","2024","COM","2022","201","7","208","2024-12-30"
"10312","2024","COM","2022","177","5","182","2024-12-30"
"10313","2024","COM","2022","326","8","334","2024-12-30"
"10314","2024","COM","2022","415","4","419","2024-12-30"
"10315","2024","COM","2022","46","2","48","2024-12-30"
"10316","2024","COM","2022","208","4","212","2024-12-30"
"10317","2024","COM","2022","1192","23","1215","2024-12-30"
"10318","2024","COM","2022","158","2","160","2024-12-30"
"10319","2024","COM","2022","322","9","331","2024-12-30"
"10320","2024","COM","2022","230","8","238","2024-12-30"
"10321","2024","COM","2022","3681","67","3748","2024-12-30"
"10323","2024","COM","2022","14751","289","15040","2024-12-30"
"10324","2024","COM","2022","170","4","174","2024-12-30"
"10325","2024","COM","2022","4866","303","5169","2024-12-30"
"10326","2024","COM","2022","160","2","162","2024-12-30"
"10327","2024","COM","2022","125","2","127","2024-12-30"
"10328","2024","COM","2022","388","7","395","2024-12-30"
"10329","2024","COM","2022","536","31","567","2024-12-30"
"10330","2024","COM","2022","114","0","114","2024-12-30"
"10331","2024","COM","2022","580","10","590","2024-12-30"
"10332","2024","COM","2022","502","11","513","2024-12-30"
"10333","2024","COM","2022","12695","201","12896","2024-12-30"
"10334","2024","COM","2022","591","7","598","2024-12-30"
"10335","2024","COM","2022","229","3","232","2024-12-30"
"10336","2024","COM","2022","428","8","436","2024-12-30"
"10337","2024","COM","2022","32","1","33","2024-12-30"
"10338","2024","COM","2022","175","0","175","2024-12-30"
"10339","2024","COM","2022","297","10","307","2024-12-30"
"10340","2024","COM","2022","2402","50","2452","2024-12-30"
"10341","2024","COM","2022","339","9","348","2024-12-30"
"10342","2024","COM","2022","403","7","410","2024-12-30"
"10343","2024","COM","2022","6752","113","6865","2024-12-30"
"10344","2024","COM","2022","915","16","931","2024-12-30"
"10345","2024","COM","2022","386","12","398","2024-12-30"
"10346","2024","COM","2022","52","0","52","2024-12-30"
"10347","2024","COM","2022","213","2","215","2024-12-30"
"10348","2024","COM","2022","231","5","236","2024-12-30"
"10349","2024","COM","2022","2867","58","2925","2024-12-30"
"10350","2024","COM","2022","639","13","652","2024-12-30"
"10351","2024","COM","2022","350","7","357","2024-12-30"
"10352","2024","COM","2022","1792","295","2087","2024-12-30"
"10353","2024","COM","2022","907","10","917","2024-12-30"
"10354","2024","COM","2022","140","4","144","2024-12-30"
"10355","2024","COM","2022","75","1","76","2024-12-30"
"10356","2024","COM","2022","326","6","332","2024-12-30"
"10357","2024","COM","2022","3214","46","3260","2024-12-30"
"10358","2024","COM","2022","1079","16","1095","2024-12-30"
"10359","2024","COM","2022","517","8","525","2024-12-30"
"10360","2024","COM","2022","1000","232","1232","2024-12-30"
"10361","2024","COM","2022","254","4","258","2024-12-30"
"10362","2024","COM","2022","10457","338","10795","2024-12-30"
"10363","2024","COM","2022","551","2","553","2024-12-30"
"10364","2024","COM","2022","69","2","71","2024-12-30"
"10365","2024","COM","2022","128","9","137","2024-12-30"
"10366","2024","COM","2022","62","2","64","2024-12-30"
"10367","2024","COM","2022","681","8","689","2024-12-30"
"10368","2024","COM","2022","1075","16","1091","2024-12-30"
"10369","2024","COM","2022","219","3","222","2024-12-30"
"10370","2024","COM","2022","259","5","264","2024-12-30"
"10371","2024","COM","2022","301","6","307","2024-12-30"
"10372","2024","COM","2022","419","10","429","2024-12-30"
"10373","2024","COM","2022","377","8","385","2024-12-30"
"10374","2024","COM","2022","147","1","148","2024-12-30"
"10375","2024","COM","2022","336","14","350","2024-12-30"
"10376","2024","COM","2022","156","3","159","2024-12-30"
"10377","2024","COM","2022","106","2","108","2024-12-30"
"10378","2024","COM","2022","68","3","71","2024-12-30"
"10379","2024","COM","2022","441","5","446","2024-12-30"
"10380","2024","COM","2022","72","2","74","2024-12-30"
"10381","2024","COM","2022","1035","27","1062","2024-12-30"
"10382","2024","COM","2022","1064","14","1078","2024-12-30"
"10383","2024","COM","2022","181","4","185","2024-12-30"
"10384","2024","COM","2022","198","6","204","2024-12-30"
"10386","2024","COM","2022","203","5","208","2024-12-30"
"10387","2024","COM","2022","62443","1123","63566","2024-12-30"
"10388","2024","COM","2022","44","1","45","2024-12-30"
"10389","2024","COM","2022","108","4","112","2024-12-30"
"10390","2024","COM","2022","110","0","110","2024-12-30"
"10391","2024","COM","2022","310","1","311","2024-12-30"
"10392","2024","COM","2022","417","8","425","2024-12-30"
"10393","2024","COM","2022","186","1","187","2024-12-30"
"10394","2024","COM","2022","169","1","170","2024-12-30"
"10395","2024","COM","2022","287","7","294","2024-12-30"
"10396","2024","COM","2022","498","7","505","2024-12-30"
"10397","2024","COM","2022","172","1","173","2024-12-30"
"10398","2024","COM","2022","71","1","72","2024-12-30"
"10399","2024","COM","2022","708","11","719","2024-12-30"
"10400","2024","COM","2022","127","2","129","2024-12-30"
"10401","2024","COM","2022","2256","43","2299","2024-12-30"
"10402","2024","COM","2022","242","5","247","2024-12-30"
"10403","2024","COM","2022","57","2","59","2024-12-30"
"10404","2024","COM","2022","109","3","112","2024-12-30"
"10405","2024","COM","2022","60","0","60","2024-12-30"
"10406","2024","COM","2022","1888","35","1923","2024-12-30"
"10408","2024","COM","2022","127","3","130","2024-12-30"
"10409","2024","COM","2022","600","7","607","2024-12-30"
"10410","2024","COM","2022","105","4","109","2024-12-30"
"10411","2024","COM","2022","28","0","28","2024-12-30"
"10412","2024","COM","2022","945","23","968","2024-12-30"
"10414","2024","COM","2022","129","4","133","2024-12-30"
"10416","2024","COM","2022","240","4","244","2024-12-30"
"10417","2024","COM","2022","204","5","209","2024-12-30"
"10418","2024","COM","2022","203","10","213","2024-12-30"
"10419","2024","COM","2022","731","13","744","2024-12-30"
"10420","2024","COM","2022","2604","37","2641","2024-12-30"
"10421","2024","COM","2022","148","4","152","2024-12-30"
"10422","2024","COM","2022","196","1","197","2024-12-30"
"10423","2024","COM","2022","404","14","418","2024-12-30"
"10424","2024","COM","2022","64","2","66","2024-12-30"
"10425","2024","COM","2022","267","4","271","2024-12-30"
"10426","2024","COM","2022","908","12","920","2024-12-30"
"10427","2024","COM","2022","203","8","211","2024-12-30"
"10428","2024","COM","2022","97","5","102","2024-12-30"
"10429","2024","COM","2022","252","9","261","2024-12-30"
"10430","2024","COM","2022","82","2","84","2024-12-30"
"10431","2024","COM","2022","106","1","107","2024-12-30"
"10432","2024","COM","2022","68","6","74","2024-12-30"
"10433","2024","COM","2022","260","8","268","2024-12-30"
"10434","2024","COM","2022","58","1","59","2024-12-30"
"10435","2024","COM","2022","192","6","198","2024-12-30"
"10436","2024","COM","2022","187","5","192","2024-12-30"
"10437","2024","COM","2022","591","10","601","2024-12-30"
"10438","2024","COM","2022","224","3","227","2024-12-30"
"10439","2024","COM","2022","120","0","120","2024-12-30"
"10440","2024","COM","2022","141","6","147","2024-12-30"
"10441","2024","COM","2022","237","2","239","2024-12-30"
"10442","2024","COM","2022","696","17","713","2024-12-30"
"10443","2024","COM","2022","41","1","42","2024-12-30"
"10444","2024","COM","2022","225","3","228","2024-12-30"
"10445","2024","COM","2022","54","0","54","2024-12-30"
"11001","2024","COM","2022","536","11","547","2024-12-30"
"11002","2024","COM","2022","189","5","194","2024-12-30"
"11003","2024","COM","2022","198","3","201","2024-12-30"
"11004","2024","COM","2022","331","4","335","2024-12-30"
"11005","2024","COM","2022","1389","33","1422","2024-12-30"
"11006","2024","COM","2022","78","2","80","2024-12-30"
"11007","2024","COM","2022","111","4","115","2024-12-30"
"11008","2024","COM","2022","384","5","389","2024-12-30"
"11009","2024","COM","2022","1590","24","1614","2024-12-30"
"11010","2024","COM","2022","292","4","296","2024-12-30"
"11011","2024","COM","2022","476","14","490","2024-12-30"
"11012","2024","COM","2022","2128","34","2162","2024-12-30"
"11013","2024","COM","2022","375","5","380","2024-12-30"
"11014","2024","COM","2022","1474","45","1519","2024-12-30"
"11015","2024","COM","2022","253","2","255","2024-12-30"
"11016","2024","COM","2022","79","3","82","2024-12-30"
"11017","2024","COM","2022","73","1","74","2024-12-30"
"11018","2024","COM","2022","1196","33","1229","2024-12-30"
"11019","2024","COM","2022","61","0","61","2024-12-30"
"11020","2024","COM","2022","33","0","33","2024-12-30"
"11021","2024","COM","2022","482","7","489","2024-12-30"
"11022","2024","COM","2022","1125","23","1148","2024-12-30"
"11023","2024","COM","2022","729","15","744","2024-12-30"
"11024","2024","COM","2022","750","10","760","2024-12-30"
"11025","2024","COM","2022","315","3","318","2024-12-30"
"11026","2024","COM","2022","164","3","167","2024-12-30"
"11027","2024","COM","2022","787","22","809","2024-12-30"
"11028","2024","COM","2022","369","7","376","2024-12-30"
"11029","2024","COM","2022","60","3","63","2024-12-30"
"11030","2024","COM","2022","111","5","116","2024-12-30"
"11031","2024","COM","2022","24","1","25","2024-12-30"
"11032","2024","COM","2022","252","1","253","2024-12-30"
"11033","2024","COM","2022","1339","29","1368","2024-12-30"
"11034","2024","COM","2022","841","12","853","2024-12-30"
"11035","2024","COM","2022","259","4","263","2024-12-30"
"11036","2024","COM","2022","162","6","168","2024-12-30"
"11037","2024","COM","2022","958","6","964","2024-12-30"
"11038","2024","COM","2022","57","0","57","2024-12-30"
"11039","2024","COM","2022","47","1","48","2024-12-30"
"11040","2024","COM","2022","1749","26","1775","2024-12-30"
"11041","2024","COM","2022","1292","17","1309","2024-12-30"
"11042","2024","COM","2022","254","3","257","2024-12-30"
"11043","2024","COM","2022","222","11","233","2024-12-30"
"11044","2024","COM","2022","103","0","103","2024-12-30"
"11045","2024","COM","2022","151","1","152","2024-12-30"
"11046","2024","COM","2022","55","0","55","2024-12-30"
"11047","2024","COM","2022","44","1","45","2024-12-30"
"11048","2024","COM","2022","739","17","756","2024-12-30"
"11049","2024","COM","2022","3252","65","3317","2024-12-30"
"11051","2024","COM","2022","176","1","177","2024-12-30"
"11052","2024","COM","2022","352","7","359","2024-12-30"
"11053","2024","COM","2022","301","4","305","2024-12-30"
"11054","2024","COM","2022","268","1","269","2024-12-30"
"11055","2024","COM","2022","242","4","246","2024-12-30"
"11056","2024","COM","2022","179","0","179","2024-12-30"
"11057","2024","COM","2022","30","0","30","2024-12-30"
"11058","2024","COM","2022","250","11","261","2024-12-30"
"11059","2024","COM","2022","150","2","152","2024-12-30"
"11060","2024","COM","2022","52","0","52","2024-12-30"
"11061","2024","COM","2022","322","3","325","2024-12-30"
"11062","2024","COM","2022","19","0","19","2024-12-30"
"11063","2024","COM","2022","616","5","621","2024-12-30"
"11064","2024","COM","2022","385","4","389","2024-12-30"
"11065","2024","COM","2022","61","0","61","2024-12-30"
"11066","2024","COM","2022","108","1","109","2024-12-30"
"11067","2024","COM","2022","1853","29","1882","2024-12-30"
"11068","2024","COM","2022","1461","40","1501","2024-12-30"
"11069","2024","COM","2022","46429","1122","47551","2024-12-30"
"11070","2024","COM","2022","338","6","344","2024-12-30"
"11071","2024","COM","2022","216","1","217","2024-12-30"
"11072","2024","COM","2022","188","6","194","2024-12-30"
"11073","2024","COM","2022","59","1","60","2024-12-30"
"11074","2024","COM","2022","317","10","327","2024-12-30"
"11075","2024","COM","2022","127","2","129","2024-12-30"
"11076","2024","COM","2022","12212","522","12734","2024-12-30"
"11077","2024","COM","2022","494","12","506","2024-12-30"
"11078","2024","COM","2022","207","2","209","2024-12-30"
"11079","2024","COM","2022","220","3","223","2024-12-30"
"11080","2024","COM","2022","171","4","175","2024-12-30"
"11081","2024","COM","2022","1571","29","1600","2024-12-30"
"11082","2024","COM","2022","11","0","11","2024-12-30"
"11083","2024","COM","2022","56","0","56","2024-12-30"
"11084","2024","COM","2022","1013","15","1028","2024-12-30"
"11085","2024","COM","2022","1012","43","1055","2024-12-30"
"11086","2024","COM","2022","879","11","890","2024-12-30"
"11087","2024","COM","2022","102","3","105","2024-12-30"
"11088","2024","COM","2022","1637","53","1690","2024-12-30"
"11089","2024","COM","2022","411","10","421","2024-12-30"
"11090","2024","COM","2022","603","10","613","2024-12-30"
"11091","2024","COM","2022","1115","12","1127","2024-12-30"
"11092","2024","COM","2022","99","2","101","2024-12-30"
"11093","2024","COM","2022","28","1","29","2024-12-30"
"11094","2024","COM","2022","30","0","30","2024-12-30"
"11095","2024","COM","2022","329","5","334","2024-12-30"
"11096","2024","COM","2022","33","0","33","2024-12-30"
"11098","2024","COM","2022","947","21","968","2024-12-30"
"11099","2024","COM","2022","2549","46","2595","2024-12-30"
"11100","2024","COM","2022","36","2","38","2024-12-30"
"11101","2024","COM","2022","53","2","55","2024-12-30"
"11102","2024","COM","2022","538","13","551","2024-12-30"
"11103","2024","COM","2022","1130","19","1149","2024-12-30"
"11104","2024","COM","2022","56","1","57","2024-12-30"
"11105","2024","COM","2022","664","21","685","2024-12-30"
"11106","2024","COM","2022","5762","94","5856","2024-12-30"
"11107","2024","COM","2022","76","3","79","2024-12-30"
"11108","2024","COM","2022","48","1","49","2024-12-30"
"11109","2024","COM","2022","50","1","51","2024-12-30"
"11110","2024","COM","2022","116","1","117","2024-12-30"
"11111","2024","COM","2022","940","9","949","2024-12-30"
"11112","2024","COM","2022","81","1","82","2024-12-30"
"11113","2024","COM","2022","121","1","122","2024-12-30"
"11114","2024","COM","2022","43","0","43","2024-12-30"
"11115","2024","COM","2022","953","14","967","2024-12-30"
"11116","2024","COM","2022","4070","57","4127","2024-12-30"
"11117","2024","COM","2022","147","2","149","2024-12-30"
"11118","2024","COM","2022","44","0","44","2024-12-30"
"11119","2024","COM","2022","290","4","294","2024-12-30"
"11120","2024","COM","2022","526","11","537","2024-12-30"
"11121","2024","COM","2022","111","0","111","2024-12-30"
"11122","2024","COM","2022","780","14","794","2024-12-30"
"11123","2024","COM","2022","145","6","151","2024-12-30"
"11124","2024","COM","2022","644","11","655","2024-12-30"
"11125","2024","COM","2022","158","0","158","2024-12-30"
"11126","2024","COM","2022","497","10","507","2024-12-30"
"11127","2024","COM","2022","69","4","73","2024-12-30"
"11128","2024","COM","2022","151","5","156","2024-12-30"
"11129","2024","COM","2022","1695","30","1725","2024-12-30"
"11130","2024","COM","2022","233","4","237","2024-12-30"
"11131","2024","COM","2022","580","14","594","2024-12-30"
"11132","2024","COM","2022","1254","20","1274","2024-12-30"
"11133","2024","COM","2022","51","0","51","2024-12-30"
"11134","2024","COM","2022","51","4","55","2024-12-30"
"11135","2024","COM","2022","13","0","13","2024-12-30"
"11136","2024","COM","2022","886","94","980","2024-12-30"
"11137","2024","COM","2022","133","4","137","2024-12-30"
"11138","2024","COM","2022","613","14","627","2024-12-30"
"11139","2024","COM","2022","76","1","77","2024-12-30"
"11140","2024","COM","2022","1267","23","1290","2024-12-30"
"11141","2024","COM","2022","132","2","134","2024-12-30"
"11142","2024","COM","2022","187","5","192","2024-12-30"
"11143","2024","COM","2022","107","0","107","2024-12-30"
"11144","2024","COM","2022","1147","16","1163","2024-12-30"
"11145","2024","COM","2022","4071","42","4113","2024-12-30"
"11146","2024","COM","2022","427","9","436","2024-12-30"
"11147","2024","COM","2022","5","0","5","2024-12-30"
"11148","2024","COM","2022","574","7","581","2024-12-30"
"11149","2024","COM","2022","74","1","75","2024-12-30"
"11150","2024","COM","2022","467","49","516","2024-12-30"
"11151","2024","COM","2022","555","12","567","2024-12-30"
"11152","2024","COM","2022","139","2","141","2024-12-30"
"11153","2024","COM","2022","259","7","266","2024-12-30"
"11154","2024","COM","2022","52","0","52","2024-12-30"
"11155","2024","COM","2022","78","1","79","2024-12-30"
"11156","2024","COM","2022","104","1","105","2024-12-30"
"11157","2024","COM","2022","221","3","224","2024-12-30"
"11158","2024","COM","2022","309","4","313","2024-12-30"
"11159","2024","COM","2022","136","2","138","2024-12-30"
"11160","2024","COM","2022","31","1","32","2024-12-30"
"11161","2024","COM","2022","128","6","134","2024-12-30"
"11162","2024","COM","2022","51","2","53","2024-12-30"
"11163","2024","COM","2022","47","1","48","2024-12-30"
"11164","2024","COM","2022","1579","22","1601","2024-12-30"
"11165","2024","COM","2022","298","8","306","2024-12-30"
"11166","2024","COM","2022","69","2","71","2024-12-30"
"11167","2024","COM","2022","128","4","132","2024-12-30"
"11168","2024","COM","2022","116","3","119","2024-12-30"
"11169","2024","COM","2022","94","4","98","2024-12-30"
"11170","2024","COM","2022","5068","81","5149","2024-12-30"
"11172","2024","COM","2022","604","17","621","2024-12-30"
"11173","2024","COM","2022","133","3","136","2024-12-30"
"11174","2024","COM","2022","61","0","61","2024-12-30"
"11175","2024","COM","2022","484","9","493","2024-12-30"
"11176","2024","COM","2022","46","0","46","2024-12-30"
"11177","2024","COM","2022","30","0","30","2024-12-30"
"11178","2024","COM","2022","1261","15","1276","2024-12-30"
"11179","2024","COM","2022","89","2","91","2024-12-30"
"11180","2024","COM","2022","62","1","63","2024-12-30"
"11181","2024","COM","2022","419","8","427","2024-12-30"
"11182","2024","COM","2022","184","6","190","2024-12-30"
"11183","2024","COM","2022","257","7","264","2024-12-30"
"11184","2024","COM","2022","96","3","99","2024-12-30"
"11185","2024","COM","2022","548","12","560","2024-12-30"
"11186","2024","COM","2022","52","0","52","2024-12-30"
"11187","2024","COM","2022","59","1","60","2024-12-30"
"11188","2024","COM","2022","1889","20","1909","2024-12-30"
"11189","2024","COM","2022","116","2","118","2024-12-30"
"11190","2024","COM","2022","1275","16","1291","2024-12-30"
"11191","2024","COM","2022","141","2","143","2024-12-30"
"11192","2024","COM","2022","824","19","843","2024-12-30"
"11193","2024","COM","2022","290","5","295","2024-12-30"
"11194","2024","COM","2022","148","3","151","2024-12-30"
"11195","2024","COM","2022","411","20","431","2024-12-30"
"11196","2024","COM","2022","180","8","188","2024-12-30"
"11197","2024","COM","2022","621","13","634","2024-12-30"
"11198","2024","COM","2022","1030","16","1046","2024-12-30"
"11199","2024","COM","2022","1572","41","1613","2024-12-30"
"11200","2024","COM","2022","136","2","138","2024-12-30"
"11201","2024","COM","2022","823","17","840","2024-12-30"
"11202","2024","COM","2022","4531","53","4584","2024-12-30"
"11203","2024","COM","2022","10855","220","11075","2024-12-30"
"11204","2024","COM","2022","34","0","34","2024-12-30"
"11205","2024","COM","2022","124","2","126","2024-12-30"
"11206","2024","COM","2022","10339","397","10736","2024-12-30"
"11207","2024","COM","2022","253","6","259","2024-12-30"
"11208","2024","COM","2022","80","3","83","2024-12-30"
"11209","2024","COM","2022","253","5","258","2024-12-30"
"11210","2024","COM","2022","1159","15","1174","2024-12-30"
"11211","2024","COM","2022","543","6","549","2024-12-30"
"11212","2024","COM","2022","585","10","595","2024-12-30"
"11213","2024","COM","2022","52","0","52","2024-12-30"
"11214","2024","COM","2022","437","6","443","2024-12-30"
"11215","2024","COM","2022","880","12","892","2024-12-30"
"11216","2024","COM","2022","362","3","365","2024-12-30"
"11217","2024","COM","2022","1318","24","1342","2024-12-30"
"11218","2024","COM","2022","80","1","81","2024-12-30"
"11219","2024","COM","2022","22","0","22","2024-12-30"
"11220","2024","COM","2022","706","12","718","2024-12-30"
"11221","2024","COM","2022","307","2","309","2024-12-30"
"11222","2024","COM","2022","173","5","178","2024-12-30"
"11223","2024","COM","2022","23","1","24","2024-12-30"
"11224","2024","COM","2022","28","0","28","2024-12-30"
"11225","2024","COM","2022","937","18","955","2024-12-30"
"11226","2024","COM","2022","86","1","87","2024-12-30"
"11227","2024","COM","2022","44","1","45","2024-12-30"
"11228","2024","COM","2022","154","4","158","2024-12-30"
"11229","2024","COM","2022","23","1","24","2024-12-30"
"11230","2024","COM","2022","30","0","30","2024-12-30"
"11231","2024","COM","2022","97","3","100","2024-12-30"
"11232","2024","COM","2022","55","2","57","2024-12-30"
"11233","2024","COM","2022","743","13","756","2024-12-30"
"11234","2024","COM","2022","193","5","198","2024-12-30"
"11235","2024","COM","2022","64","2","66","2024-12-30"
"11236","2024","COM","2022","251","2","253","2024-12-30"
"11238","2024","COM","2022","136","3","139","2024-12-30"
"11239","2024","COM","2022","84","1","85","2024-12-30"
"11240","2024","COM","2022","537","14","551","2024-12-30"
"11241","2024","COM","2022","340","1","341","2024-12-30"
"11242","2024","COM","2022","177","6","183","2024-12-30"
"11243","2024","COM","2022","648","10","658","2024-12-30"
"11244","2024","COM","2022","88","1","89","2024-12-30"
"11245","2024","COM","2022","37","0","37","2024-12-30"
"11246","2024","COM","2022","49","0","49","2024-12-30"
"11247","2024","COM","2022","37","1","38","2024-12-30"
"11248","2024","COM","2022","67","1","68","2024-12-30"
"11249","2024","COM","2022","80","1","81","2024-12-30"
"11250","2024","COM","2022","40","2","42","2024-12-30"
"11251","2024","COM","2022","731","16","747","2024-12-30"
"11252","2024","COM","2022","350","1","351","2024-12-30"
"11253","2024","COM","2022","829","24","853","2024-12-30"
"11254","2024","COM","2022","2116","214","2330","2024-12-30"
"11255","2024","COM","2022","1477","20","1497","2024-12-30"
"11256","2024","COM","2022","620","11","631","2024-12-30"
"11257","2024","COM","2022","243","4","247","2024-12-30"
"11258","2024","COM","2022","2079","47","2126","2024-12-30"
"11259","2024","COM","2022","988","31","1019","2024-12-30"
"11260","2024","COM","2022","115","1","116","2024-12-30"
"11261","2024","COM","2022","715","7","722","2024-12-30"
"11262","2024","COM","2022","56692","1073","57765","2024-12-30"
"11263","2024","COM","2022","257","8","265","2024-12-30"
"11264","2024","COM","2022","1283","29","1312","2024-12-30"
"11265","2024","COM","2022","36","1","37","2024-12-30"
"11266","2024","COM","2022","5882","70","5952","2024-12-30"
"11267","2024","COM","2022","1097","26","1123","2024-12-30"
"11268","2024","COM","2022","97","0","97","2024-12-30"
"11269","2024","COM","2022","2635","50","2685","2024-12-30"
"11270","2024","COM","2022","142","1","143","2024-12-30"
"11271","2024","COM","2022","31","0","31","2024-12-30"
"11272","2024","COM","2022","2692","77","2769","2024-12-30"
"11273","2024","COM","2022","700","10","710","2024-12-30"
"11274","2024","COM","2022","363","8","371","2024-12-30"
"11275","2024","COM","2022","208","0","208","2024-12-30"
"11276","2024","COM","2022","528","17","545","2024-12-30"
"11277","2024","COM","2022","29","2","31","2024-12-30"
"11278","2024","COM","2022","76","2","78","2024-12-30"
"11279","2024","COM","2022","2875","54","2929","2024-12-30"
"11280","2024","COM","2022","1105","33","1138","2024-12-30"
"11281","2024","COM","2022","1264","32","1296","2024-12-30"
"11282","2024","COM","2022","54","1","55","2024-12-30"
"11283","2024","COM","2022","76","0","76","2024-12-30"
"11284","2024","COM","2022","459","16","475","2024-12-30"
"11285","2024","COM","2022","1191","21","1212","2024-12-30"
"11286","2024","COM","2022","1142","17","1159","2024-12-30"
"11287","2024","COM","2022","89","4","93","2024-12-30"
"11288","2024","COM","2022","1598","125","1723","2024-12-30"
"11289","2024","COM","2022","967","27","994","2024-12-30"
"11290","2024","COM","2022","120","3","123","2024-12-30"
"11291","2024","COM","2022","142","1","143","2024-12-30"
"11292","2024","COM","2022","184","1","185","2024-12-30"
"11293","2024","COM","2022","985","16","1001","2024-12-30"
"11294","2024","COM","2022","51","1","52","2024-12-30"
"11295","2024","COM","2022","1288","20","1308","2024-12-30"
"11296","2024","COM","2022","597","5","602","2024-12-30"
"11297","2024","COM","2022","160","1","161","2024-12-30"
"11299","2024","COM","2022","637","13","650","2024-12-30"
"11300","2024","COM","2022","154","3","157","2024-12-30"
"11301","2024","COM","2022","1194","16","1210","2024-12-30"
"11302","2024","COM","2022","272","4","276","2024-12-30"
"11303","2024","COM","2022","461","17","478","2024-12-30"
"11304","2024","COM","2022","2992","90","3082","2024-12-30"
"11305","2024","COM","2022","57","0","57","2024-12-30"
"11306","2024","COM","2022","50","2","52","2024-12-30"
"11307","2024","COM","2022","234","3","237","2024-12-30"
"11308","2024","COM","2022","466","8","474","2024-12-30"
"11309","2024","COM","2022","87","2","89","2024-12-30"
"11310","2024","COM","2022","224","2","226","2024-12-30"
"11311","2024","COM","2022","264","3","267","2024-12-30"
"11312","2024","COM","2022","101","1","102","2024-12-30"
"11313","2024","COM","2022","328","6","334","2024-12-30"
"11314","2024","COM","2022","86","7","93","2024-12-30"
"11315","2024","COM","2022","1966","23","1989","2024-12-30"
"11316","2024","COM","2022","218","1","219","2024-12-30"
"11317","2024","COM","2022","99","3","102","2024-12-30"
"11318","2024","COM","2022","140","0","140","2024-12-30"
"11319","2024","COM","2022","71","2","73","2024-12-30"
"11320","2024","COM","2022","285","9","294","2024-12-30"
"11321","2024","COM","2022","82","0","82","2024-12-30"
"11322","2024","COM","2022","1021","19","1040","2024-12-30"
"11323","2024","COM","2022","269","3","272","2024-12-30"
"11324","2024","COM","2022","514","9","523","2024-12-30"
"11325","2024","COM","2022","493","6","499","2024-12-30"
"11326","2024","COM","2022","71","2","73","2024-12-30"
"11327","2024","COM","2022","581","12","593","2024-12-30"
"11328","2024","COM","2022","234","3","237","2024-12-30"
"11330","2024","COM","2022","515","11","526","2024-12-30"
"11331","2024","COM","2022","62","2","64","2024-12-30"
"11332","2024","COM","2022","1400","16","1416","2024-12-30"
"11333","2024","COM","2022","108","4","112","2024-12-30"
"11334","2024","COM","2022","124","0","124","2024-12-30"
"11335","2024","COM","2022","40","0","40","2024-12-30"
"11336","2024","COM","2022","444","5","449","2024-12-30"
"11337","2024","COM","2022","366","4","370","2024-12-30"
"11338","2024","COM","2022","43","1","44","2024-12-30"
"11339","2024","COM","2022","511","8","519","2024-12-30"
"11340","2024","COM","2022","569","6","575","2024-12-30"
"11341","2024","COM","2022","114","1","115","2024-12-30"
"11342","2024","COM","2022","225","4","229","2024-12-30"
"11343","2024","COM","2022","108","2","110","2024-12-30"
"11344","2024","COM","2022","713","13","726","2024-12-30"
"11345","2024","COM","2022","269","0","269","2024-12-30"
"11346","2024","COM","2022","137","4","141","2024-12-30"
"11347","2024","COM","2022","99","2","101","2024-12-30"
"11348","2024","COM","2022","80","2","82","2024-12-30"
"11350","2024","COM","2022","50","3","53","2024-12-30"
"11351","2024","COM","2022","757","15","772","2024-12-30"
"11352","2024","COM","2022","53","0","53","2024-12-30"
"11353","2024","COM","2022","2019","45","2064","2024-12-30"
"11354","2024","COM","2022","30","1","31","2024-12-30"
"11355","2024","COM","2022","386","12","398","2024-12-30"
"11356","2024","COM","2022","1109","24","1133","2024-12-30"
"11357","2024","COM","2022","214","7","221","2024-12-30"
"11358","2024","COM","2022","24","0","24","2024-12-30"
"11359","2024","COM","2022","487","6","493","2024-12-30"
"11360","2024","COM","2022","2104","36","2140","2024-12-30"
"11361","2024","COM","2022","832","15","847","2024-12-30"
"11362","2024","COM","2022","203","4","207","2024-12-30"
"11363","2024","COM","2022","202","4","206","2024-12-30"
"11364","2024","COM","2022","160","1","161","2024-12-30"
"11365","2024","COM","2022","42","2","44","2024-12-30"
"11366","2024","COM","2022","524","10","534","2024-12-30"
"11367","2024","COM","2022","909","21","930","2024-12-30"
"11368","2024","COM","2022","117","2","119","2024-12-30"
"11369","2024","COM","2022","3104","44","3148","2024-12-30"
"11370","2024","COM","2022","3280","78","3358","2024-12-30"
"11371","2024","COM","2022","752","6","758","2024-12-30"
"11372","2024","COM","2022","388","9","397","2024-12-30"
"11373","2024","COM","2022","70","1","71","2024-12-30"
"11374","2024","COM","2022","28","0","28","2024-12-30"
"11375","2024","COM","2022","30","0","30","2024-12-30"
"11376","2024","COM","2022","95","3","98","2024-12-30"
"11377","2024","COM","2022","88","0","88","2024-12-30"
"11378","2024","COM","2022","207","4","211","2024-12-30"
"11379","2024","COM","2022","5620","111","5731","2024-12-30"
"11380","2024","COM","2022","137","2","139","2024-12-30"
"11381","2024","COM","2022","127","4","131","2024-12-30"
"11382","2024","COM","2022","356","52","408","2024-12-30"
"11383","2024","COM","2022","342","8","350","2024-12-30"
"11384","2024","COM","2022","130","3","133","2024-12-30"
"11385","2024","COM","2022","240","2","242","2024-12-30"
"11386","2024","COM","2022","436","7","443","2024-12-30"
"11387","2024","COM","2022","106","1","107","2024-12-30"
"11388","2024","COM","2022","49","0","49","2024-12-30"
"11389","2024","COM","2022","14","0","14","2024-12-30"
"11390","2024","COM","2022","568","6","574","2024-12-30"
"11391","2024","COM","2022","22","0","22","2024-12-30"
"11392","2024","COM","2022","284","1","285","2024-12-30"
"11393","2024","COM","2022","493","7","500","2024-12-30"
"11394","2024","COM","2022","132","0","132","2024-12-30"
"11395","2024","COM","2022","26","0","26","2024-12-30"
"11396","2024","COM","2022","609","11","620","2024-12-30"
"11397","2024","COM","2022","5386","119","5505","2024-12-30"
"11398","2024","COM","2022","263","10","273","2024-12-30"
"11399","2024","COM","2022","109","3","112","2024-12-30"
"11400","2024","COM","2022","100","2","102","2024-12-30"
"11401","2024","COM","2022","790","10","800","2024-12-30"
"11402","2024","COM","2022","27","0","27","2024-12-30"
"11404","2024","COM","2022","959","30","989","2024-12-30"
"11405","2024","COM","2022","587","10","597","2024-12-30"
"11406","2024","COM","2022","32","2","34","2024-12-30"
"11407","2024","COM","2022","289","5","294","2024-12-30"
"11408","2024","COM","2022","457","15","472","2024-12-30"
"11409","2024","COM","2022","106","2","108","2024-12-30"
"11410","2024","COM","2022","968","21","989","2024-12-30"
"11411","2024","COM","2022","147","4","151","2024-12-30"
"11412","2024","COM","2022","61","1","62","2024-12-30"
"11413","2024","COM","2022","510","12","522","2024-12-30"
"11414","2024","COM","2022","23","2","25","2024-12-30"
"11415","2024","COM","2022","117","1","118","2024-12-30"
"11416","2024","COM","2022","270","8","278","2024-12-30"
"11417","2024","COM","2022","95","2","97","2024-12-30"
"11418","2024","COM","2022","1216","36","1252","2024-12-30"
"11419","2024","COM","2022","66","0","66","2024-12-30"
"11420","2024","COM","2022","140","3","143","2024-12-30"
"11421","2024","COM","2022","573","5","578","2024-12-30"
"11422","2024","COM","2022","340","15","355","2024-12-30"
"11423","2024","COM","2022","157","7","164","2024-12-30"
"11424","2024","COM","2022","86","1","87","2024-12-30"
"11425","2024","COM","2022","1687","52","1739","2024-12-30"
"11426","2024","COM","2022","1227","18","1245","2024-12-30"
"11427","2024","COM","2022","314","5","319","2024-12-30"
"11428","2024","COM","2022","242","7","249","2024-12-30"
"11429","2024","COM","2022","4434","92","4526","2024-12-30"
"11430","2024","COM","2022","1424","30","1454","2024-12-30"
"11431","2024","COM","2022","252","7","259","2024-12-30"
"11432","2024","COM","2022","337","9","346","2024-12-30"
"11433","2024","COM","2022","980","13","993","2024-12-30"
"11434","2024","COM","2022","1252","27","1279","2024-12-30"
"11435","2024","COM","2022","163","3","166","2024-12-30"
"11436","2024","COM","2022","379","5","384","2024-12-30"
"11437","2024","COM","2022","875","28","903","2024-12-30"
"11438","2024","COM","2022","366","9","375","2024-12-30"
"11439","2024","COM","2022","425","9","434","2024-12-30"
"11440","2024","COM","2022","34","0","34","2024-12-30"
"11441","2024","COM","2022","2665","52","2717","2024-12-30"
"12001","2024","COM","2022","1120","27","1147","2024-12-30"
"12002","2024","COM","2022","924","29","953","2024-12-30"
"12003","2024","COM","2022","344","5","349","2024-12-30"
"12004","2024","COM","2022","438","18","456","2024-12-30"
"12006","2024","COM","2022","333","10","343","2024-12-30"
"12007","2024","COM","2022","181","7","188","2024-12-30"
"12008","2024","COM","2022","918","18","936","2024-12-30"
"12009","2024","COM","2022","44","0","44","2024-12-30"
"12010","2024","COM","2022","165","1","166","2024-12-30"
"12011","2024","COM","2022","765","22","787","2024-12-30"
"12012","2024","COM","2022","770","10","780","2024-12-30"
"12013","2024","COM","2022","3465","146","3611","2024-12-30"
"12015","2024","COM","2022","229","5","234","2024-12-30"
"12016","2024","COM","2022","813","20","833","2024-12-30"
"12017","2024","COM","2022","221","4","225","2024-12-30"
"12018","2024","COM","2022","175","7","182","2024-12-30"
"12019","2024","COM","2022","89","5","94","2024-12-30"
"12021","2024","COM","2022","1610","31","1641","2024-12-30"
"12022","2024","COM","2022","120","0","120","2024-12-30"
"12023","2024","COM","2022","110","3","113","2024-12-30"
"12024","2024","COM","2022","190","3","193","2024-12-30"
"12025","2024","COM","2022","990","17","1007","2024-12-30"
"12026","2024","COM","2022","1049","17","1066","2024-12-30"
"12027","2024","COM","2022","223","7","230","2024-12-30"
"12028","2024","COM","2022","515","8","523","2024-12-30"
"12029","2024","COM","2022","198","5","203","2024-12-30"
"12030","2024","COM","2022","368","14","382","2024-12-30"
"12031","2024","COM","2022","325","14","339","2024-12-30"
"12032","2024","COM","2022","605","20","625","2024-12-30"
"12033","2024","COM","2022","3006","88","3094","2024-12-30"
"12034","2024","COM","2022","291","11","302","2024-12-30"
"12035","2024","COM","2022","172","7","179","2024-12-30"
"12036","2024","COM","2022","632","7","639","2024-12-30"
"12037","2024","COM","2022","612","4","616","2024-12-30"
"12038","2024","COM","2022","165","4","169","2024-12-30"
"12039","2024","COM","2022","259","2","261","2024-12-30"
"12041","2024","COM","2022","279","10","289","2024-12-30"
"12042","2024","COM","2022","186","6","192","2024-12-30"
"12043","2024","COM","2022","2208","76","2284","2024-12-30"
"12044","2024","COM","2022","1028","23","1051","2024-12-30"
"12045","2024","COM","2022","401","17","418","2024-12-30"
"12046","2024","COM","2022","575","12","587","2024-12-30"
"12047","2024","COM","2022","437","11","448","2024-12-30"
"12048","2024","COM","2022","330","6","336","2024-12-30"
"12049","2024","COM","2022","452","9","461","2024-12-30"
"12050","2024","COM","2022","450","12","462","2024-12-30"
"12051","2024","COM","2022","312","4","316","2024-12-30"
"12052","2024","COM","2022","4394","118","4512","2024-12-30"
"12053","2024","COM","2022","345","9","354","2024-12-30"
"12054","2024","COM","2022","355","12","367","2024-12-30"
"12055","2024","COM","2022","91","0","91","2024-12-30"
"12056","2024","COM","2022","3168","107","3275","2024-12-30"
"12057","2024","COM","2022","946","34","980","2024-12-30"
"12058","2024","COM","2022","106","4","110","2024-12-30"
"12059","2024","COM","2022","525","24","549","2024-12-30"
"12060","2024","COM","2022","118","4","122","2024-12-30"
"12061","2024","COM","2022","567","11","578","2024-12-30"
"12062","2024","COM","2022","346","5","351","2024-12-30"
"12063","2024","COM","2022","2208","26","2234","2024-12-30"
"12064","2024","COM","2022","253","6","259","2024-12-30"
"12065","2024","COM","2022","462","18","480","2024-12-30"
"12066","2024","COM","2022","1154","29","1183","2024-12-30"
"12067","2024","COM","2022","88","2","90","2024-12-30"
"12068","2024","COM","2022","880","25","905","2024-12-30"
"12069","2024","COM","2022","258","7","265","2024-12-30"
"12070","2024","COM","2022","526","27","553","2024-12-30"
"12071","2024","COM","2022","334","7","341","2024-12-30"
"12072","2024","COM","2022","217","7","224","2024-12-30"
"12073","2024","COM","2022","637","18","655","2024-12-30"
"12074","2024","COM","2022","289","14","303","2024-12-30"
"12075","2024","COM","2022","101","2","103","2024-12-30"
"12076","2024","COM","2022","1555","54","1609","2024-12-30"
"12077","2024","COM","2022","513","8","521","2024-12-30"
"12078","2024","COM","2022","165","3","168","2024-12-30"
"12079","2024","COM","2022","475","16","491","2024-12-30"
"12080","2024","COM","2022","358","11","369","2024-12-30"
"12082","2024","COM","2022","200","7","207","2024-12-30"
"12083","2024","COM","2022","1464","47","1511","2024-12-30"
"12084","2024","COM","2022","1564","56","1620","2024-12-30"
"12085","2024","COM","2022","317","6","323","2024-12-30"
"12086","2024","COM","2022","323","16","339","2024-12-30"
"12088","2024","COM","2022","214","5","219","2024-12-30"
"12089","2024","COM","2022","5025","212","5237","2024-12-30"
"12090","2024","COM","2022","3179","91","3270","2024-12-30"
"12091","2024","COM","2022","451","8","459","2024-12-30"
"12092","2024","COM","2022","524","10","534","2024-12-30"
"12093","2024","COM","2022","192","4","196","2024-12-30"
"12094","2024","COM","2022","970","16","986","2024-12-30"
"12095","2024","COM","2022","222","5","227","2024-12-30"
"12096","2024","COM","2022","4607","155","4762","2024-12-30"
"12097","2024","COM","2022","248","10","258","2024-12-30"
"12098","2024","COM","2022","507","15","522","2024-12-30"
"12099","2024","COM","2022","236","4","240","2024-12-30"
"12100","2024","COM","2022","2333","52","2385","2024-12-30"
"12101","2024","COM","2022","1081","32","1113","2024-12-30"
"12102","2024","COM","2022","2376","78","2454","2024-12-30"
"12103","2024","COM","2022","281","4","285","2024-12-30"
"12104","2024","COM","2022","470","29","499","2024-12-30"
"12105","2024","COM","2022","1113","35","1148","2024-12-30"
"12106","2024","COM","2022","558","11","569","2024-12-30"
"12107","2024","COM","2022","326","6","332","2024-12-30"
"12108","2024","COM","2022","367","15","382","2024-12-30"
"12109","2024","COM","2022","96","1","97","2024-12-30"
"12110","2024","COM","2022","370","8","378","2024-12-30"
"12111","2024","COM","2022","478","17","495","2024-12-30"
"12113","2024","COM","2022","539","12","551","2024-12-30"
"12115","2024","COM","2022","344","6","350","2024-12-30"
"12116","2024","COM","2022","252","7","259","2024-12-30"
"12118","2024","COM","2022","531","10","541","2024-12-30"
"12119","2024","COM","2022","1215","21","1236","2024-12-30"
"12120","2024","COM","2022","2148","81","2229","2024-12-30"
"12121","2024","COM","2022","761","22","783","2024-12-30"
"12122","2024","COM","2022","121","3","124","2024-12-30"
"12124","2024","COM","2022","318","10","328","2024-12-30"
"12125","2024","COM","2022","294","6","300","2024-12-30"
"12127","2024","COM","2022","664","13","677","2024-12-30"
"12128","2024","COM","2022","222","9","231","2024-12-30"
"12129","2024","COM","2022","442","13","455","2024-12-30"
"12130","2024","COM","2022","1102","27","1129","2024-12-30"
"12131","2024","COM","2022","1529","44","1573","2024-12-30"
"12133","2024","COM","2022","6054","165","6219","2024-12-30"
"12134","2024","COM","2022","359","7","366","2024-12-30"
"12135","2024","COM","2022","435","7","442","2024-12-30"
"12136","2024","COM","2022","953","35","988","2024-12-30"
"12137","2024","COM","2022","873","12","885","2024-12-30"
"12138","2024","COM","2022","1714","56","1770","2024-12-30"
"12139","2024","COM","2022","144","2","146","2024-12-30"
"12140","2024","COM","2022","989","24","1013","2024-12-30"
"12141","2024","COM","2022","234","4","238","2024-12-30"
"12142","2024","COM","2022","614","16","630","2024-12-30"
"12143","2024","COM","2022","56","2","58","2024-12-30"
"12144","2024","COM","2022","135","3","138","2024-12-30"
"12145","2024","COM","2022","21859","633","22492","2024-12-30"
"12146","2024","COM","2022","2301","73","2374","2024-12-30"
"12147","2024","COM","2022","147","1","148","2024-12-30"
"12148","2024","COM","2022","1444","42","1486","2024-12-30"
"12149","2024","COM","2022","140","3","143","2024-12-30"
"12150","2024","COM","2022","469","87","556","2024-12-30"
"12151","2024","COM","2022","226","5","231","2024-12-30"
"12152","2024","COM","2022","130","3","133","2024-12-30"
"12153","2024","COM","2022","435","10","445","2024-12-30"
"12154","2024","COM","2022","660","10","670","2024-12-30"
"12155","2024","COM","2022","335","8","343","2024-12-30"
"12156","2024","COM","2022","519","15","534","2024-12-30"
"12157","2024","COM","2022","1748","51","1799","2024-12-30"
"12158","2024","COM","2022","323","9","332","2024-12-30"
"12159","2024","COM","2022","555","14","569","2024-12-30"
"12160","2024","COM","2022","329","4","333","2024-12-30"
"12161","2024","COM","2022","558","11","569","2024-12-30"
"12162","2024","COM","2022","1085","39","1124","2024-12-30"
"12163","2024","COM","2022","213","4","217","2024-12-30"
"12164","2024","COM","2022","685","13","698","2024-12-30"
"12165","2024","COM","2022","365","14","379","2024-12-30"
"12166","2024","COM","2022","102","3","105","2024-12-30"
"12167","2024","COM","2022","736","18","754","2024-12-30"
"12168","2024","COM","2022","1017","15","1032","2024-12-30"
"12169","2024","COM","2022","2017","114","2131","2024-12-30"
"12170","2024","COM","2022","414","13","427","2024-12-30"
"12171","2024","COM","2022","591","20","611","2024-12-30"
"12172","2024","COM","2022","546","7","553","2024-12-30"
"12174","2024","COM","2022","3531","90","3621","2024-12-30"
"12175","2024","COM","2022","168","7","175","2024-12-30"
"12176","2024","COM","2022","12062","604","12666","2024-12-30"
"12177","2024","COM","2022","1027","16","1043","2024-12-30"
"12178","2024","COM","2022","365","10","375","2024-12-30"
"12179","2024","COM","2022","87","1","88","2024-12-30"
"12180","2024","COM","2022","71","2","73","2024-12-30"
"12181","2024","COM","2022","202","6","208","2024-12-30"
"12182","2024","COM","2022","293","7","300","2024-12-30"
"12183","2024","COM","2022","221","7","228","2024-12-30"
"12184","2024","COM","2022","118","4","122","2024-12-30"
"12185","2024","COM","2022","1630","72","1702","2024-12-30"
"12186","2024","COM","2022","212","8","220","2024-12-30"
"12187","2024","COM","2022","310","4","314","2024-12-30"
"12188","2024","COM","2022","315","11","326","2024-12-30"
"12189","2024","COM","2022","359","9","368","2024-12-30"
"12190","2024","COM","2022","275","10","285","2024-12-30"
"12191","2024","COM","2022","342","11","353","2024-12-30"
"12192","2024","COM","2022","193","4","197","2024-12-30"
"12193","2024","COM","2022","287","7","294","2024-12-30"
"12194","2024","COM","2022","885","17","902","2024-12-30"
"12195","2024","COM","2022","287","10","297","2024-12-30"
"12197","2024","COM","2022","1940","75","2015","2024-12-30"
"12198","2024","COM","2022","1922","79","2001","2024-12-30"
"12199","2024","COM","2022","2019","144","2163","2024-12-30"
"12200","2024","COM","2022","1045","25","1070","2024-12-30"
"12201","2024","COM","2022","1097","37","1134","2024-12-30"
"12202","2024","COM","2022","24136","1784","25920","2024-12-30"
"12203","2024","COM","2022","502","12","514","2024-12-30"
"12204","2024","COM","2022","178","4","182","2024-12-30"
"12205","2024","COM","2022","774","18","792","2024-12-30"
"12206","2024","COM","2022","618","20","638","2024-12-30"
"12207","2024","COM","2022","342","14","356","2024-12-30"
"12208","2024","COM","2022","7924","590","8514","2024-12-30"
"12209","2024","COM","2022","732","13","745","2024-12-30"
"12210","2024","COM","2022","455","8","463","2024-12-30"
"12211","2024","COM","2022","132","1","133","2024-12-30"
"12212","2024","COM","2022","100","1","101","2024-12-30"
"12213","2024","COM","2022","575","15","590","2024-12-30"
"12214","2024","COM","2022","517","6","523","2024-12-30"
"12215","2024","COM","2022","1181","41","1222","2024-12-30"
"12216","2024","COM","2022","1446","38","1484","2024-12-30"
"12217","2024","COM","2022","736","26","762","2024-12-30"
"12219","2024","COM","2022","371","9","380","2024-12-30"
"12220","2024","COM","2022","321","2","323","2024-12-30"
"12221","2024","COM","2022","384","5","389","2024-12-30"
"12222","2024","COM","2022","193","3","196","2024-12-30"
"12223","2024","COM","2022","1597","43","1640","2024-12-30"
"12224","2024","COM","2022","2167","33","2200","2024-12-30"
"12225","2024","COM","2022","1584","54","1638","2024-12-30"
"12226","2024","COM","2022","426","8","434","2024-12-30"
"12227","2024","COM","2022","181","5","186","2024-12-30"
"12228","2024","COM","2022","318","8","326","2024-12-30"
"12229","2024","COM","2022","223","11","234","2024-12-30"
"12230","2024","COM","2022","382","16","398","2024-12-30"
"12231","2024","COM","2022","665","11","676","2024-12-30"
"12232","2024","COM","2022","284","8","292","2024-12-30"
"12233","2024","COM","2022","276","8","284","2024-12-30"
"12234","2024","COM","2022","634","7","641","2024-12-30"
"12235","2024","COM","2022","210","7","217","2024-12-30"
"12236","2024","COM","2022","157","4","161","2024-12-30"
"12237","2024","COM","2022","631","71","702","2024-12-30"
"12238","2024","COM","2022","427","15","442","2024-12-30"
"12239","2024","COM","2022","334","12","346","2024-12-30"
"12240","2024","COM","2022","406","11","417","2024-12-30"
"12241","2024","COM","2022","1774","63","1837","2024-12-30"
"12242","2024","COM","2022","307","8","315","2024-12-30"
"12243","2024","COM","2022","961","12","973","2024-12-30"
"12244","2024","COM","2022","899","9","908","2024-12-30"
"12246","2024","COM","2022","517","16","533","2024-12-30"
"12247","2024","COM","2022","325","6","331","2024-12-30"
"12248","2024","COM","2022","586","134","720","2024-12-30"
"12249","2024","COM","2022","180","7","187","2024-12-30"
"12250","2024","COM","2022","219","6","225","2024-12-30"
"12251","2024","COM","2022","313","6","319","2024-12-30"
"12252","2024","COM","2022","480","14","494","2024-12-30"
"12253","2024","COM","2022","1030","26","1056","2024-12-30"
"12254","2024","COM","2022","2313","70","2383","2024-12-30"
"12255","2024","COM","2022","764","26","790","2024-12-30"
"12256","2024","COM","2022","361","10","371","2024-12-30"
"12257","2024","COM","2022","783","20","803","2024-12-30"
"12258","2024","COM","2022","1001","16","1017","2024-12-30"
"12259","2024","COM","2022","643","19","662","2024-12-30"
"12260","2024","COM","2022","182","3","185","2024-12-30"
"12261","2024","COM","2022","125","2","127","2024-12-30"
"12262","2024","COM","2022","711","14","725","2024-12-30"
"12263","2024","COM","2022","755","19","774","2024-12-30"
"12264","2024","COM","2022","3266","73","3339","2024-12-30"
"12265","2024","COM","2022","533","14","547","2024-12-30"
"12266","2024","COM","2022","540","13","553","2024-12-30"
"12267","2024","COM","2022","583","9","592","2024-12-30"
"12268","2024","COM","2022","424","9","433","2024-12-30"
"12269","2024","COM","2022","127","4","131","2024-12-30"
"12270","2024","COM","2022","4044","116","4160","2024-12-30"
"12272","2024","COM","2022","517","13","530","2024-12-30"
"12273","2024","COM","2022","302","8","310","2024-12-30"
"12274","2024","COM","2022","116","2","118","2024-12-30"
"12275","2024","COM","2022","35","1","36","2024-12-30"
"12276","2024","COM","2022","386","6","392","2024-12-30"
"12277","2024","COM","2022","508","9","517","2024-12-30"
"12278","2024","COM","2022","188","5","193","2024-12-30"
"12280","2024","COM","2022","359","11","370","2024-12-30"
"12281","2024","COM","2022","752","17","769","2024-12-30"
"12282","2024","COM","2022","420","9","429","2024-12-30"
"12283","2024","COM","2022","473","16","489","2024-12-30"
"12284","2024","COM","2022","349","1","350","2024-12-30"
"12286","2024","COM","2022","1209","33","1242","2024-12-30"
"12287","2024","COM","2022","651","19","670","2024-12-30"
"12288","2024","COM","2022","1617","38","1655","2024-12-30"
"12289","2024","COM","2022","204","8","212","2024-12-30"
"12290","2024","COM","2022","489","20","509","2024-12-30"
"12291","2024","COM","2022","364","9","373","2024-12-30"
"12292","2024","COM","2022","419","11","430","2024-12-30"
"12293","2024","COM","2022","129","1","130","2024-12-30"
"12294","2024","COM","2022","650","19","669","2024-12-30"
"12295","2024","COM","2022","88","1","89","2024-12-30"
"12296","2024","COM","2022","527","12","539","2024-12-30"
"12297","2024","COM","2022","524","19","543","2024-12-30"
"12298","2024","COM","2022","426","19","445","2024-12-30"
"12299","2024","COM","2022","678","21","699","2024-12-30"
"12300","2024","COM","2022","11502","463","11965","2024-12-30"
"12301","2024","COM","2022","1952","57","2009","2024-12-30"
"12303","2024","COM","2022","249","4","253","2024-12-30"
"12305","2024","COM","2022","1214","22","1236","2024-12-30"
"12307","2024","COM","2022","302","7","309","2024-12-30"
"13001","2024","COM","2022","147933","3100","151033","2024-12-30"
"13002","2024","COM","2022","21404","212","21616","2024-12-30"
"13003","2024","COM","2022","2833","70","2903","2024-12-30"
"13004","2024","COM","2022","51156","684","51840","2024-12-30"
"13005","2024","COM","2022","47724","400","48124","2024-12-30"
"13006","2024","COM","2022","1537","33","1570","2024-12-30"
"13007","2024","COM","2022","12986","169","13155","2024-12-30"
"13008","2024","COM","2022","559","12","571","2024-12-30"
"13009","2024","COM","2022","852","36","888","2024-12-30"
"13010","2024","COM","2022","4262","140","4402","2024-12-30"
"13011","2024","COM","2022","262","4","266","2024-12-30"
"13012","2024","COM","2022","595","49","644","2024-12-30"
"13013","2024","COM","2022","1978","36","2014","2024-12-30"
"13014","2024","COM","2022","13941","70","14011","2024-12-30"
"13015","2024","COM","2022","15367","277","15644","2024-12-30"
"13016","2024","COM","2022","6447","100","6547","2024-12-30"
"13017","2024","COM","2022","1531","24","1555","2024-12-30"
"13018","2024","COM","2022","4576","57","4633","2024-12-30"
"13019","2024","COM","2022","10143","332","10475","2024-12-30"
"13020","2024","COM","2022","2219","46","2265","2024-12-30"
"13021","2024","COM","2022","5717","128","5845","2024-12-30"
"13022","2024","COM","2022","6706","102","6808","2024-12-30"
"13023","2024","COM","2022","4847","109","4956","2024-12-30"
"13024","2024","COM","2022","2634","48","2682","2024-12-30"
"13025","2024","COM","2022","2331","74","2405","2024-12-30"
"13026","2024","COM","2022","18364","104","18468","2024-12-30"
"13027","2024","COM","2022","16668","240","16908","2024-12-30"
"13028","2024","COM","2022","37599","370","37969","2024-12-30"
"13029","2024","COM","2022","1619","31","1650","2024-12-30"
"13030","2024","COM","2022","5949","63","6012","2024-12-30"
"13031","2024","COM","2022","4023","50","4073","2024-12-30"
"13032","2024","COM","2022","8349","163","8512","2024-12-30"
"13033","2024","COM","2022","5796","101","5897","2024-12-30"
"13034","2024","COM","2022","1740","31","1771","2024-12-30"
"13035","2024","COM","2022","6915","160","7075","2024-12-30"
"13036","2024","COM","2022","4289","124","4413","2024-12-30"
"13037","2024","COM","2022","8953","113","9066","2024-12-30"
"13038","2024","COM","2022","3555","68","3623","2024-12-30"
"13039","2024","COM","2022","15694","197","15891","2024-12-30"
"13040","2024","COM","2022","10235","217","10452","2024-12-30"
"13041","2024","COM","2022","21534","326","21860","2024-12-30"
"13042","2024","COM","2022","6678","140","6818","2024-12-30"
"13043","2024","COM","2022","10030","96","10126","2024-12-30"
"13044","2024","COM","2022","5382","88","5470","2024-12-30"
"13045","2024","COM","2022","4743","73","4816","2024-12-30"
"13046","2024","COM","2022","4469","82","4551","2024-12-30"
"13047","2024","COM","2022","44044","648","44692","2024-12-30"
"13048","2024","COM","2022","4478","81","4559","2024-12-30"
"13049","2024","COM","2022","2069","38","2107","2024-12-30"
"13050","2024","COM","2022","9951","248","10199","2024-12-30"
"13051","2024","COM","2022","9627","131","9758","2024-12-30"
"13052","2024","COM","2022","2779","33","2812","2024-12-30"
"13053","2024","COM","2022","6190","162","6352","2024-12-30"
"13054","2024","COM","2022","33164","240","33404","2024-12-30"
"13056","2024","COM","2022","48818","528","49346","2024-12-30"
"13057","2024","COM","2022","537","8","545","2024-12-30"
"13058","2024","COM","2022","2396","49","2445","2024-12-30"
"13059","2024","COM","2022","3818","63","3881","2024-12-30"
"13060","2024","COM","2022","6341","88","6429","2024-12-30"
"13061","2024","COM","2022","228","4","232","2024-12-30"
"13062","2024","COM","2022","4147","74","4221","2024-12-30"
"13063","2024","COM","2022","25891","371","26262","2024-12-30"
"13064","2024","COM","2022","2651","49","2700","2024-12-30"
"13065","2024","COM","2022","3471","64","3535","2024-12-30"
"13066","2024","COM","2022","5918","68","5986","2024-12-30"
"13067","2024","COM","2022","2662","33","2695","2024-12-30"
"13068","2024","COM","2022","2181","60","2241","2024-12-30"
"13069","2024","COM","2022","10799","241","11040","2024-12-30"
"13070","2024","COM","2022","6618","51","6669","2024-12-30"
"13071","2024","COM","2022","22423","248","22671","2024-12-30"
"13072","2024","COM","2022","3692","76","3768","2024-12-30"
"13073","2024","COM","2022","5612","75","5687","2024-12-30"
"13074","2024","COM","2022","5316","77","5393","2024-12-30"
"13075","2024","COM","2022","11504","94","11598","2024-12-30"
"13076","2024","COM","2022","3562","51","3613","2024-12-30"
"13077","2024","COM","2022","16138","143","16281","2024-12-30"
"13078","2024","COM","2022","8510","73","8583","2024-12-30"
"13079","2024","COM","2022","1780","135","1915","2024-12-30"
"13080","2024","COM","2022","5794","111","5905","2024-12-30"
"13081","2024","COM","2022","12335","123","12458","2024-12-30"
"13082","2024","COM","2022","4640","106","4746","2024-12-30"
"13083","2024","COM","2022","4186","56","4242","2024-12-30"
"13084","2024","COM","2022","5355","121","5476","2024-12-30"
"13085","2024","COM","2022","5784","62","5846","2024-12-30"
"13086","2024","COM","2022","8823","124","8947","2024-12-30"
"13087","2024","COM","2022","5357","148","5505","2024-12-30"
"13088","2024","COM","2022","5205","49","5254","2024-12-30"
"13089","2024","COM","2022","3369","54","3423","2024-12-30"
"13090","2024","COM","2022","125","4","129","2024-12-30"
"13091","2024","COM","2022","5877","100","5977","2024-12-30"
"13092","2024","COM","2022","8669","133","8802","2024-12-30"
"13093","2024","COM","2022","364","11","375","2024-12-30"
"13094","2024","COM","2022","2480","43","2523","2024-12-30"
"13095","2024","COM","2022","1270","72","1342","2024-12-30"
"13096","2024","COM","2022","2278","24","2302","2024-12-30"
"13097","2024","COM","2022","13962","307","14269","2024-12-30"
"13098","2024","COM","2022","5996","116","6112","2024-12-30"
"13099","2024","COM","2022","886","13","899","2024-12-30"
"13100","2024","COM","2022","9547","175","9722","2024-12-30"
"13101","2024","COM","2022","3449","72","3521","2024-12-30"
"13102","2024","COM","2022","6689","29","6718","2024-12-30"
"13103","2024","COM","2022","44553","527","45080","2024-12-30"
"13104","2024","COM","2022","7556","117","7673","2024-12-30"
"13105","2024","COM","2022","6829","87","6916","2024-12-30"
"13106","2024","COM","2022","12018","80","12098","2024-12-30"
"13107","2024","COM","2022","5823","124","5947","2024-12-30"
"13108","2024","COM","2022","15525","138","15663","2024-12-30"
"13109","2024","COM","2022","2370","57","2427","2024-12-30"
"13110","2024","COM","2022","10933","184","11117","2024-12-30"
"13111","2024","COM","2022","1058","22","1080","2024-12-30"
"13112","2024","COM","2022","8827","149","8976","2024-12-30"
"13113","2024","COM","2022","8420","162","8582","2024-12-30"
"13114","2024","COM","2022","5613","140","5753","2024-12-30"
"13115","2024","COM","2022","2158","44","2202","2024-12-30"
"13116","2024","COM","2022","775","14","789","2024-12-30"
"13117","2024","COM","2022","36612","385","36997","2024-12-30"
"13118","2024","COM","2022","3775","80","3855","2024-12-30"
"13119","2024","COM","2022","6872","80","6952","2024-12-30"
"13201","2024","ARM","2022","38482","166","38648","2024-12-30"
"13202","2024","ARM","2022","24153","76","24229","2024-12-30"
"13203","2024","ARM","2022","55653","118","55771","2024-12-30"
"13204","2024","ARM","2022","49744","286","50030","2024-12-30"
"13205","2024","ARM","2022","45020","256","45276","2024-12-30"
"13206","2024","ARM","2022","38804","353","39157","2024-12-30"
"13207","2024","ARM","2022","34866","296","35162","2024-12-30"
"13208","2024","ARM","2022","83414","1340","84754","2024-12-30"
"13209","2024","ARM","2022","76347","651","76998","2024-12-30"
"13210","2024","ARM","2022","59852","394","60246","2024-12-30"
"13211","2024","ARM","2022","59033","456","59489","2024-12-30"
"13212","2024","ARM","2022","64276","568","64844","2024-12-30"
"13213","2024","ARM","2022","93425","724","94149","2024-12-30"
"13214","2024","ARM","2022","59230","221","59451","2024-12-30"
"13215","2024","ARM","2022","79501","259","79760","2024-12-30"
"13216","2024","ARM","2022","15415","87","15502","2024-12-30"
"14001","2024","COM","2022","1177","32","1209","2024-12-30"
"14003","2024","COM","2022","317","8","325","2024-12-30"
"14005","2024","COM","2022","1672","37","1709","2024-12-30"
"14006","2024","COM","2022","1070","19","1089","2024-12-30"
"14007","2024","COM","2022","211","4","215","2024-12-30"
"14009","2024","COM","2022","1373","25","1398","2024-12-30"
"14011","2024","COM","2022","1908","20","1928","2024-12-30"
"14012","2024","COM","2022","191","1","192","2024-12-30"
"14014","2024","COM","2022","1356","22","1378","2024-12-30"
"14015","2024","COM","2022","796","23","819","2024-12-30"
"14016","2024","COM","2022","502","12","514","2024-12-30"
"14019","2024","COM","2022","216","3","219","2024-12-30"
"14020","2024","COM","2022","3940","31","3971","2024-12-30"
"14021","2024","COM","2022","431","6","437","2024-12-30"
"14022","2024","COM","2022","641","8","649","2024-12-30"
"14023","2024","COM","2022","71","1","72","2024-12-30"
"14024","2024","COM","2022","603","11","614","2024-12-30"
"14025","2024","COM","2022","299","7","306","2024-12-30"
"14026","2024","COM","2022","1156","21","1177","2024-12-30"
"14027","2024","COM","2022","4664","69","4733","2024-12-30"
"14030","2024","COM","2022","1691","42","1733","2024-12-30"
"14032","2024","COM","2022","276","11","287","2024-12-30"
"14033","2024","COM","2022","224","4","228","2024-12-30"
"14034","2024","COM","2022","561","9","570","2024-12-30"
"14035","2024","COM","2022","1317","79","1396","2024-12-30"
"14036","2024","COM","2022","188","1","189","2024-12-30"
"14037","2024","COM","2022","573","10","583","2024-12-30"
"14038","2024","COM","2022","802","11","813","2024-12-30"
"14039","2024","COM","2022","758","17","775","2024-12-30"
"14040","2024","COM","2022","228","4","232","2024-12-30"
"14041","2024","COM","2022","121","3","124","2024-12-30"
"14042","2024","COM","2022","1104","25","1129","2024-12-30"
"14043","2024","COM","2022","64","0","64","2024-12-30"
"14044","2024","COM","2022","1043","17","1060","2024-12-30"
"14045","2024","COM","2022","249","2","251","2024-12-30"
"14046","2024","COM","2022","1912","33","1945","2024-12-30"
"14047","2024","COM","2022","12754","337","13091","2024-12-30"
"14049","2024","COM","2022","144","6","150","2024-12-30"
"14050","2024","COM","2022","195","2","197","2024-12-30"
"14053","2024","COM","2022","167","3","170","2024-12-30"
"14054","2024","COM","2022","207","5","212","2024-12-30"
"14055","2024","COM","2022","387","6","393","2024-12-30"
"14057","2024","COM","2022","1474","9","1483","2024-12-30"
"14059","2024","COM","2022","389","18","407","2024-12-30"
"14060","2024","COM","2022","2001","25","2026","2024-12-30"
"14061","2024","COM","2022","8643","146","8789","2024-12-30"
"14062","2024","COM","2022","455","10","465","2024-12-30"
"14063","2024","COM","2022","211","5","216","2024-12-30"
"14064","2024","COM","2022","212","7","219","2024-12-30"
"14066","2024","COM","2022","2446","32","2478","2024-12-30"
"14068","2024","COM","2022","3855","92","3947","2024-12-30"
"14069","2024","COM","2022","1301","22","1323","2024-12-30"
"14070","2024","COM","2022","201","4","205","2024-12-30"
"14076","2024","COM","2022","5991","81","6072","2024-12-30"
"14077","2024","COM","2022","781","65","846","2024-12-30"
"14078","2024","COM","2022","358","4","362","2024-12-30"
"14079","2024","COM","2022","1585","38","1623","2024-12-30"
"14080","2024","COM","2022","126","4","130","2024-12-30"
"14082","2024","COM","2022","188","8","196","2024-12-30"
"14083","2024","COM","2022","659","18","677","2024-12-30"
"14084","2024","COM","2022","401","8","409","2024-12-30"
"14085","2024","COM","2022","822","19","841","2024-12-30"
"14086","2024","COM","2022","323","12","335","2024-12-30"
"14087","2024","COM","2022","123","2","125","2024-12-30"
"14088","2024","COM","2022","392","8","400","2024-12-30"
"14089","2024","COM","2022","381","9","390","2024-12-30"
"14090","2024","COM","2022","816","8","824","2024-12-30"
"14091","2024","COM","2022","101","1","102","2024-12-30"
"14092","2024","COM","2022","2561","27","2588","2024-12-30"
"14093","2024","COM","2022","225","5","230","2024-12-30"
"14096","2024","COM","2022","257","5","262","2024-12-30"
"14097","2024","COM","2022","297","3","300","2024-12-30"
"14098","2024","COM","2022","6189","68","6257","2024-12-30"
"14100","2024","COM","2022","1911","14","1925","2024-12-30"
"14101","2024","COM","2022","4392","73","4465","2024-12-30"
"14102","2024","COM","2022","959","22","981","2024-12-30"
"14103","2024","COM","2022","411","9","420","2024-12-30"
"14104","2024","COM","2022","203","7","210","2024-12-30"
"14106","2024","COM","2022","651","6","657","2024-12-30"
"14107","2024","COM","2022","153","0","153","2024-12-30"
"14110","2024","COM","2022","128","1","129","2024-12-30"
"14111","2024","COM","2022","450","6","456","2024-12-30"
"14116","2024","COM","2022","118","5","123","2024-12-30"
"14117","2024","COM","2022","3654","38","3692","2024-12-30"
"14118","2024","COM","2022","108398","2122","110520","2024-12-30"
"14119","2024","COM","2022","2075","13","2088","2024-12-30"
"14120","2024","COM","2022","1408","26","1434","2024-12-30"
"14121","2024","COM","2022","253","5","258","2024-12-30"
"14122","2024","COM","2022","160","1","161","2024-12-30"
"14123","2024","COM","2022","2044","41","2085","2024-12-30"
"14124","2024","COM","2022","552","9","561","2024-12-30"
"14125","2024","COM","2022","1804","57","1861","2024-12-30"
"14126","2024","COM","2022","1307","38","1345","2024-12-30"
"14127","2024","COM","2022","555","5","560","2024-12-30"
"14130","2024","COM","2022","185","5","190","2024-12-30"
"14131","2024","COM","2022","231","4","235","2024-12-30"
"14132","2024","COM","2022","202","3","205","2024-12-30"
"14134","2024","COM","2022","189","2","191","2024-12-30"
"14135","2024","COM","2022","275","2","277","2024-12-30"
"14136","2024","COM","2022","90","0","90","2024-12-30"
"14137","2024","COM","2022","3266","33","3299","2024-12-30"
"14138","2024","COM","2022","301","4","305","2024-12-30"
"14140","2024","COM","2022","368","6","374","2024-12-30"
"14141","2024","COM","2022","164","0","164","2024-12-30"
"14143","2024","COM","2022","2439","27","2466","2024-12-30"
"14145","2024","COM","2022","560","4","564","2024-12-30"
"14146","2024","COM","2022","170","4","174","2024-12-30"
"14147","2024","COM","2022","138","0","138","2024-12-30"
"14149","2024","COM","2022","419","4","423","2024-12-30"
"14150","2024","COM","2022","1415","18","1433","2024-12-30"
"14159","2024","COM","2022","234","14","248","2024-12-30"
"14160","2024","COM","2022","176","2","178","2024-12-30"
"14161","2024","COM","2022","321","15","336","2024-12-30"
"14162","2024","COM","2022","1301","15","1316","2024-12-30"
"14163","2024","COM","2022","391","3","394","2024-12-30"
"14165","2024","COM","2022","203","1","204","2024-12-30"
"14166","2024","COM","2022","2529","40","2569","2024-12-30"
"14167","2024","COM","2022","7015","38","7053","2024-12-30"
"14168","2024","COM","2022","206","5","211","2024-12-30"
"14169","2024","COM","2022","153","0","153","2024-12-30"
"14171","2024","COM","2022","143","1","144","2024-12-30"
"14172","2024","COM","2022","470","7","477","2024-12-30"
"14173","2024","COM","2022","447","12","459","2024-12-30"
"14174","2024","COM","2022","6018","339","6357","2024-12-30"
"14175","2024","COM","2022","303","10","313","2024-12-30"
"14177","2024","COM","2022","844","16","860","2024-12-30"
"14179","2024","COM","2022","163","4","167","2024-12-30"
"14180","2024","COM","2022","153","3","156","2024-12-30"
"14181","2024","COM","2022","5273","65","5338","2024-12-30"
"14182","2024","COM","2022","391","5","396","2024-12-30"
"14183","2024","COM","2022","105","0","105","2024-12-30"
"14184","2024","COM","2022","232","6","238","2024-12-30"
"14190","2024","COM","2022","137","2","139","2024-12-30"
"14191","2024","COM","2022","4202","42","4244","2024-12-30"
"14193","2024","COM","2022","684","20","704","2024-12-30"
"14194","2024","COM","2022","629","20","649","2024-12-30"
"14195","2024","COM","2022","287","1","288","2024-12-30"
"14196","2024","COM","2022","222","8","230","2024-12-30"
"14197","2024","COM","2022","1078","14","1092","2024-12-30"
"14198","2024","COM","2022","255","10","265","2024-12-30"
"14200","2024","COM","2022","2272","30","2302","2024-12-30"
"14202","2024","COM","2022","266","5","271","2024-12-30"
"14203","2024","COM","2022","184","2","186","2024-12-30"
"14204","2024","COM","2022","170","1","171","2024-12-30"
"14205","2024","COM","2022","214","6","220","2024-12-30"
"14206","2024","COM","2022","287","0","287","2024-12-30"
"14207","2024","COM","2022","646","9","655","2024-12-30"
"14209","2024","COM","2022","507","10","517","2024-12-30"
"14211","2024","COM","2022","379","1","380","2024-12-30"
"14214","2024","COM","2022","170","1","171","2024-12-30"
"14215","2024","COM","2022","2273","30","2303","2024-12-30"
"14216","2024","COM","2022","231","5","236","2024-12-30"
"14218","2024","COM","2022","379","5","384","2024-12-30"
"14220","2024","COM","2022","3563","52","3615","2024-12-30"
"14221","2024","COM","2022","3017","60","3077","2024-12-30"
"14223","2024","COM","2022","92","1","93","2024-12-30"
"14224","2024","COM","2022","56","2","58","2024-12-30"
"14225","2024","COM","2022","5129","167","5296","2024-12-30"
"14226","2024","COM","2022","318","2","320","2024-12-30"
"14227","2024","COM","2022","221","1","222","2024-12-30"
"14228","2024","COM","2022","5123","171","5294","2024-12-30"
"14229","2024","COM","2022","2279","23","2302","2024-12-30"
"14230","2024","COM","2022","111","0","111","2024-12-30"
"14231","2024","COM","2022","444","7","451","2024-12-30"
"14232","2024","COM","2022","178","3","181","2024-12-30"
"14236","2024","COM","2022","632","6","638","2024-12-30"
"14237","2024","COM","2022","626","6","632","2024-12-30"
"14238","2024","COM","2022","113","2","115","2024-12-30"
"14239","2024","COM","2022","93","0","93","2024-12-30"
"14240","2024","COM","2022","495","6","501","2024-12-30"
"14241","2024","COM","2022","629","13","642","2024-12-30"
"14242","2024","COM","2022","1883","23","1906","2024-12-30"
"14243","2024","COM","2022","1557","27","1584","2024-12-30"
"14244","2024","COM","2022","286","9","295","2024-12-30"
"14245","2024","COM","2022","323","7","330","2024-12-30"
"14246","2024","COM","2022","851","6","857","2024-12-30"
"14248","2024","COM","2022","246","6","252","2024-12-30"
"14249","2024","COM","2022","1447","22","1469","2024-12-30"
"14250","2024","COM","2022","292","6","298","2024-12-30"
"14251","2024","COM","2022","570","5","575","2024-12-30"
"14252","2024","COM","2022","252","2","254","2024-12-30"
"14254","2024","COM","2022","1567","38","1605","2024-12-30"
"14256","2024","COM","2022","327","5","332","2024-12-30"
"14257","2024","COM","2022","2052","38","2090","2024-12-30"
"14258","2024","COM","2022","7744","232","7976","2024-12-30"
"14260","2024","COM","2022","228","7","235","2024-12-30"
"14261","2024","COM","2022","325","6","331","2024-12-30"
"14266","2024","COM","2022","1512","27","1539","2024-12-30"
"14269","2024","COM","2022","236","4","240","2024-12-30"
"14270","2024","COM","2022","367","9","376","2024-12-30"
"14271","2024","COM","2022","5622","53","5675","2024-12-30"
"14272","2024","COM","2022","107","2","109","2024-12-30"
"14273","2024","COM","2022","140","1","141","2024-12-30"
"14274","2024","COM","2022","2812","69","2881","2024-12-30"
"14275","2024","COM","2022","519","7","526","2024-12-30"
"14276","2024","COM","2022","340","8","348","2024-12-30"
"14277","2024","COM","2022","2040","16","2056","2024-12-30"
"14278","2024","COM","2022","1237","18","1255","2024-12-30"
"14280","2024","COM","2022","268","7","275","2024-12-30"
"14281","2024","COM","2022","760","11","771","2024-12-30"
"14282","2024","COM","2022","217","7","224","2024-12-30"
"14283","2024","COM","2022","217","7","224","2024-12-30"
"14284","2024","COM","2022","154","2","156","2024-12-30"
"14285","2024","COM","2022","76","2","78","2024-12-30"
"14286","2024","COM","2022","478","20","498","2024-12-30"
"14287","2024","COM","2022","2022","16","2038","2024-12-30"
"14288","2024","COM","2022","951","13","964","2024-12-30"
"14289","2024","COM","2022","572","10","582","2024-12-30"
"14290","2024","COM","2022","803","9","812","2024-12-30"
"14291","2024","COM","2022","324","4","328","2024-12-30"
"14293","2024","COM","2022","268","2","270","2024-12-30"
"14297","2024","COM","2022","623","8","631","2024-12-30"
"14298","2024","COM","2022","131","3","134","2024-12-30"
"14299","2024","COM","2022","819","14","833","2024-12-30"
"14300","2024","COM","2022","51","1","52","2024-12-30"
"14301","2024","COM","2022","4956","40","4996","2024-12-30"
"14302","2024","COM","2022","158","6","164","2024-12-30"
"14303","2024","COM","2022","924","22","946","2024-12-30"
"14304","2024","COM","2022","855","23","878","2024-12-30"
"14305","2024","COM","2022","652","7","659","2024-12-30"
"14306","2024","COM","2022","392","6","398","2024-12-30"
"14308","2024","COM","2022","327","0","327","2024-12-30"
"14309","2024","COM","2022","828","5","833","2024-12-30"
"14310","2024","COM","2022","786","12","798","2024-12-30"
"14311","2024","COM","2022","1078","9","1087","2024-12-30"
"14312","2024","COM","2022","1525","22","1547","2024-12-30"
"14316","2024","COM","2022","289","3","292","2024-12-30"
"14318","2024","COM","2022","767","11","778","2024-12-30"
"14319","2024","COM","2022","1005","9","1014","2024-12-30"
"14320","2024","COM","2022","284","4","288","2024-12-30"
"14322","2024","COM","2022","245","6","251","2024-12-30"
"14325","2024","COM","2022","3263","51","3314","2024-12-30"
"14326","2024","COM","2022","860","17","877","2024-12-30"
"14327","2024","COM","2022","22473","227","22700","2024-12-30"
"14328","2024","COM","2022","1353","17","1370","2024-12-30"
"14329","2024","COM","2022","137","1","138","2024-12-30"
"14332","2024","COM","2022","664","10","674","2024-12-30"
"14333","2024","COM","2022","6751","192","6943","2024-12-30"
"14334","2024","COM","2022","318","7","325","2024-12-30"
"14335","2024","COM","2022","291","5","296","2024-12-30"
"14336","2024","COM","2022","461","4","465","2024-12-30"
"14337","2024","COM","2022","325","8","333","2024-12-30"
"14338","2024","COM","2022","1657","33","1690","2024-12-30"
"14341","2024","COM","2022","11868","229","12097","2024-12-30"
"14342","2024","COM","2022","3549","40","3589","2024-12-30"
"14343","2024","COM","2022","71","1","72","2024-12-30"
"14344","2024","COM","2022","385","2","387","2024-12-30"
"14345","2024","COM","2022","303","2","305","2024-12-30"
"14346","2024","COM","2022","697","9","706","2024-12-30"
"14347","2024","COM","2022","1009","12","1021","2024-12-30"
"14348","2024","COM","2022","83","1","84","2024-12-30"
"14349","2024","COM","2022","2150","32","2182","2024-12-30"
"14352","2024","COM","2022","827","13","840","2024-12-30"
"14353","2024","COM","2022","459","4","463","2024-12-30"
"14354","2024","COM","2022","1893","47","1940","2024-12-30"
"14355","2024","COM","2022","1211","18","1229","2024-12-30"
"14357","2024","COM","2022","891","14","905","2024-12-30"
"14358","2024","COM","2022","87","1","88","2024-12-30"
"14360","2024","COM","2022","209","3","212","2024-12-30"
"14362","2024","COM","2022","155","1","156","2024-12-30"
"14364","2024","COM","2022","451","11","462","2024-12-30"
"14365","2024","COM","2022","2510","42","2552","2024-12-30"
"14366","2024","COM","2022","19540","578","20118","2024-12-30"
"14367","2024","COM","2022","438","5","443","2024-12-30"
"14368","2024","COM","2022","259","11","270","2024-12-30"
"14369","2024","COM","2022","276","8","284","2024-12-30"
"14370","2024","COM","2022","3092","28","3120","2024-12-30"
"14371","2024","COM","2022","6183","112","6295","2024-12-30"
"14374","2024","COM","2022","141","2","143","2024-12-30"
"14375","2024","COM","2022","160","3","163","2024-12-30"
"14377","2024","COM","2022","587","8","595","2024-12-30"
"14378","2024","COM","2022","286","3","289","2024-12-30"
"14379","2024","COM","2022","356","4","360","2024-12-30"
"14380","2024","COM","2022","204","3","207","2024-12-30"
"14381","2024","COM","2022","59","1","60","2024-12-30"
"14383","2024","COM","2022","2627","36","2663","2024-12-30"
"14384","2024","COM","2022","3295","59","3354","2024-12-30"
"14385","2024","COM","2022","160","6","166","2024-12-30"
"14389","2024","COM","2022","251","11","262","2024-12-30"
"14390","2024","COM","2022","201","1","202","2024-12-30"
"14391","2024","COM","2022","430","13","443","2024-12-30"
"14393","2024","COM","2022","364","7","371","2024-12-30"
"14394","2024","COM","2022","428","14","442","2024-12-30"
"14396","2024","COM","2022","1044","28","1072","2024-12-30"
"14397","2024","COM","2022","309","8","317","2024-12-30"
"14398","2024","COM","2022","545","7","552","2024-12-30"
"14399","2024","COM","2022","262","10","272","2024-12-30"
"14400","2024","COM","2022","200","6","206","2024-12-30"
"14401","2024","COM","2022","136","6","142","2024-12-30"
"14402","2024","COM","2022","95","0","95","2024-12-30"
"14403","2024","COM","2022","737","21","758","2024-12-30"
"14404","2024","COM","2022","119","2","121","2024-12-30"
"14405","2024","COM","2022","322","7","329","2024-12-30"
"14406","2024","COM","2022","1124","25","1149","2024-12-30"
"14407","2024","COM","2022","2339","56","2395","2024-12-30"
"14408","2024","COM","2022","2017","20","2037","2024-12-30"
"14409","2024","COM","2022","2222","38","2260","2024-12-30"
"14410","2024","COM","2022","1082","13","1095","2024-12-30"
"14411","2024","COM","2022","344","5","349","2024-12-30"
"14412","2024","COM","2022","74","0","74","2024-12-30"
"14419","2024","COM","2022","250","8","258","2024-12-30"
"14421","2024","COM","2022","558","7","565","2024-12-30"
"14424","2024","COM","2022","184","3","187","2024-12-30"
"14425","2024","COM","2022","157","6","163","2024-12-30"
"14426","2024","COM","2022","164","7","171","2024-12-30"
"14427","2024","COM","2022","284","3","287","2024-12-30"
"14430","2024","COM","2022","137","3","140","2024-12-30"
"14431","2024","COM","2022","9678","102","9780","2024-12-30"
"14435","2024","COM","2022","211","4","215","2024-12-30"
"14436","2024","COM","2022","567","5","572","2024-12-30"
"14437","2024","COM","2022","10286","227","10513","2024-12-30"
"14438","2024","COM","2022","584","7","591","2024-12-30"
"14439","2024","COM","2022","96","0","96","2024-12-30"
"14445","2024","COM","2022","85","1","86","2024-12-30"
"14446","2024","COM","2022","90","2","92","2024-12-30"
"14448","2024","COM","2022","65","0","65","2024-12-30"
"14449","2024","COM","2022","417","5","422","2024-12-30"
"14452","2024","COM","2022","607","10","617","2024-12-30"
"14453","2024","COM","2022","348","7","355","2024-12-30"
"14454","2024","COM","2022","1779","27","1806","2024-12-30"
"14455","2024","COM","2022","274","2","276","2024-12-30"
"14456","2024","COM","2022","3404","49","3453","2024-12-30"
"14457","2024","COM","2022","129","1","130","2024-12-30"
"14458","2024","COM","2022","528","67","595","2024-12-30"
"14460","2024","COM","2022","1369","24","1393","2024-12-30"
"14461","2024","COM","2022","578","4","582","2024-12-30"
"14465","2024","COM","2022","516","11","527","2024-12-30"
"14466","2024","COM","2022","350","7","357","2024-12-30"
"14467","2024","COM","2022","317","7","324","2024-12-30"
"14468","2024","COM","2022","335","6","341","2024-12-30"
"14469","2024","COM","2022","95","1","96","2024-12-30"
"14473","2024","COM","2022","107","3","110","2024-12-30"
"14474","2024","COM","2022","198","3","201","2024-12-30"
"14475","2024","COM","2022","2455","46","2501","2024-12-30"
"14476","2024","COM","2022","186","4","190","2024-12-30"
"14478","2024","COM","2022","1963","38","2001","2024-12-30"
"14480","2024","COM","2022","510","12","522","2024-12-30"
"14482","2024","COM","2022","232","0","232","2024-12-30"
"14483","2024","COM","2022","197","2","199","2024-12-30"
"14484","2024","COM","2022","254","5","259","2024-12-30"
"14486","2024","COM","2022","561","10","571","2024-12-30"
"14487","2024","COM","2022","759","21","780","2024-12-30"
"14488","2024","COM","2022","9261","115","9376","2024-12-30"
"14491","2024","COM","2022","197","5","202","2024-12-30"
"14492","2024","COM","2022","317","7","324","2024-12-30"
"14494","2024","COM","2022","121","7","128","2024-12-30"
"14495","2024","COM","2022","581","10","591","2024-12-30"
"14496","2024","COM","2022","57","2","59","2024-12-30"
"14497","2024","COM","2022","341","7","348","2024-12-30"
"14498","2024","COM","2022","236","4","240","2024-12-30"
"14499","2024","COM","2022","559","7","566","2024-12-30"
"14500","2024","COM","2022","154","6","160","2024-12-30"
"14501","2024","COM","2022","237","4","241","2024-12-30"
"14502","2024","COM","2022","84","1","85","2024-12-30"
"14504","2024","COM","2022","806","22","828","2024-12-30"
"14506","2024","COM","2022","248","4","252","2024-12-30"
"14509","2024","COM","2022","203","1","204","2024-12-30"
"14510","2024","COM","2022","66","2","68","2024-12-30"
"14511","2024","COM","2022","64","0","64","2024-12-30"
"14512","2024","COM","2022","71","0","71","2024-12-30"
"14514","2024","COM","2022","5116","71","5187","2024-12-30"
"14515","2024","COM","2022","1888","15","1903","2024-12-30"
"14516","2024","COM","2022","2076","20","2096","2024-12-30"
"14519","2024","COM","2022","113","3","116","2024-12-30"
"14520","2024","COM","2022","849","20","869","2024-12-30"
"14522","2024","COM","2022","390","7","397","2024-12-30"
"14524","2024","COM","2022","311","9","320","2024-12-30"
"14527","2024","COM","2022","545","8","553","2024-12-30"
"14528","2024","COM","2022","398","6","404","2024-12-30"
"14529","2024","COM","2022","273","5","278","2024-12-30"
"14530","2024","COM","2022","2055","26","2081","2024-12-30"
"14531","2024","COM","2022","46","1","47","2024-12-30"
"14533","2024","COM","2022","101","4","105","2024-12-30"
"14534","2024","COM","2022","406","12","418","2024-12-30"
"14535","2024","COM","2022","601","11","612","2024-12-30"
"14536","2024","COM","2022","2535","45","2580","2024-12-30"
"14538","2024","COM","2022","1758","34","1792","2024-12-30"
"14540","2024","COM","2022","286","8","294","2024-12-30"
"14541","2024","COM","2022","105","1","106","2024-12-30"
"14542","2024","COM","2022","643","5","648","2024-12-30"
"14543","2024","COM","2022","2541","51","2592","2024-12-30"
"14546","2024","COM","2022","222","3","225","2024-12-30"
"14547","2024","COM","2022","151","3","154","2024-12-30"
"14550","2024","COM","2022","88","1","89","2024-12-30"
"14552","2024","COM","2022","491","13","504","2024-12-30"
"14554","2024","COM","2022","1829","23","1852","2024-12-30"
"14555","2024","COM","2022","450","4","454","2024-12-30"
"14556","2024","COM","2022","1727","22","1749","2024-12-30"
"14557","2024","COM","2022","1103","13","1116","2024-12-30"
"14558","2024","COM","2022","1119","20","1139","2024-12-30"
"14559","2024","COM","2022","221","2","223","2024-12-30"
"14562","2024","COM","2022","2125","38","2163","2024-12-30"
"14563","2024","COM","2022","467","10","477","2024-12-30"
"14565","2024","COM","2022","252","2","254","2024-12-30"
"14566","2024","COM","2022","2459","49","2508","2024-12-30"
"14569","2024","COM","2022","244","5","249","2024-12-30"
"14570","2024","COM","2022","2465","37","2502","2024-12-30"
"14571","2024","COM","2022","301","8","309","2024-12-30"
"14572","2024","COM","2022","760","7","767","2024-12-30"
"14574","2024","COM","2022","1772","86","1858","2024-12-30"
"14575","2024","COM","2022","381","10","391","2024-12-30"
"14576","2024","COM","2022","509","12","521","2024-12-30"
"14578","2024","COM","2022","1313","31","1344","2024-12-30"
"14579","2024","COM","2022","1309","23","1332","2024-12-30"
"14582","2024","COM","2022","698","22","720","2024-12-30"
"14586","2024","COM","2022","151","5","156","2024-12-30"
"14587","2024","COM","2022","2493","46","2539","2024-12-30"
"14588","2024","COM","2022","352","1","353","2024-12-30"
"14589","2024","COM","2022","960","9","969","2024-12-30"
"14590","2024","COM","2022","136","1","137","2024-12-30"
"14591","2024","COM","2022","697","11","708","2024-12-30"
"14592","2024","COM","2022","1333","19","1352","2024-12-30"
"14593","2024","COM","2022","668","20","688","2024-12-30"
"14595","2024","COM","2022","238","4","242","2024-12-30"
"14598","2024","COM","2022","280","9","289","2024-12-30"
"14601","2024","COM","2022","172","4","176","2024-12-30"
"14602","2024","COM","2022","265","3","268","2024-12-30"
"14603","2024","COM","2022","510","10","520","2024-12-30"
"14605","2024","COM","2022","262","5","267","2024-12-30"
"14606","2024","COM","2022","239","2","241","2024-12-30"
"14607","2024","COM","2022","135","1","136","2024-12-30"
"14609","2024","COM","2022","521","13","534","2024-12-30"
"14610","2024","COM","2022","2141","100","2241","2024-12-30"
"14613","2024","COM","2022","86","1","87","2024-12-30"
"14614","2024","COM","2022","755","10","765","2024-12-30"
"14619","2024","COM","2022","128","2","130","2024-12-30"
"14620","2024","COM","2022","427","14","441","2024-12-30"
"14621","2024","COM","2022","530","12","542","2024-12-30"
"14622","2024","COM","2022","120","0","120","2024-12-30"
"14623","2024","COM","2022","2511","44","2555","2024-12-30"
"14625","2024","COM","2022","767","15","782","2024-12-30"
"14626","2024","COM","2022","999","14","1013","2024-12-30"
"14627","2024","COM","2022","391","7","398","2024-12-30"
"14630","2024","COM","2022","760","22","782","2024-12-30"
"14635","2024","COM","2022","190","0","190","2024-12-30"
"14637","2024","COM","2022","227","3","230","2024-12-30"
"14639","2024","COM","2022","256","8","264","2024-12-30"
"14640","2024","COM","2022","245","1","246","2024-12-30"
"14643","2024","COM","2022","830","13","843","2024-12-30"
"14644","2024","COM","2022","650","11","661","2024-12-30"
"14645","2024","COM","2022","165","9","174","2024-12-30"
"14646","2024","COM","2022","461","9","470","2024-12-30"
"14648","2024","COM","2022","453","16","469","2024-12-30"
"14649","2024","COM","2022","442","6","448","2024-12-30"
"14650","2024","COM","2022","181","4","185","2024-12-30"
"14651","2024","COM","2022","291","2","293","2024-12-30"
"14652","2024","COM","2022","73","2","75","2024-12-30"
"14654","2024","COM","2022","7265","340","7605","2024-12-30"
"14656","2024","COM","2022","982","14","996","2024-12-30"
"14657","2024","COM","2022","313","4","317","2024-12-30"
"14658","2024","COM","2022","4236","83","4319","2024-12-30"
"14659","2024","COM","2022","1454","27","1481","2024-12-30"
"14660","2024","COM","2022","115","2","117","2024-12-30"
"14661","2024","COM","2022","159","0","159","2024-12-30"
"14663","2024","COM","2022","2533","52","2585","2024-12-30"
"14664","2024","COM","2022","320","5","325","2024-12-30"
"14665","2024","COM","2022","290","4","294","2024-12-30"
"14666","2024","COM","2022","1884","22","1906","2024-12-30"
"14667","2024","COM","2022","223","4","227","2024-12-30"
"14668","2024","COM","2022","328","9","337","2024-12-30"
"14669","2024","COM","2022","212","0","212","2024-12-30"
"14672","2024","COM","2022","895","13","908","2024-12-30"
"14674","2024","COM","2022","116","4","120","2024-12-30"
"14675","2024","COM","2022","2190","31","2221","2024-12-30"
"14676","2024","COM","2022","987","13","1000","2024-12-30"
"14677","2024","COM","2022","250","4","254","2024-12-30"
"14678","2024","COM","2022","635","9","644","2024-12-30"
"14679","2024","COM","2022","675","17","692","2024-12-30"
"14680","2024","COM","2022","167","5","172","2024-12-30"
"14681","2024","COM","2022","142","4","146","2024-12-30"
"14682","2024","COM","2022","474","12","486","2024-12-30"
"14684","2024","COM","2022","248","4","252","2024-12-30"
"14685","2024","COM","2022","1851","30","1881","2024-12-30"
"14687","2024","COM","2022","197","3","200","2024-12-30"
"14689","2024","COM","2022","3593","48","3641","2024-12-30"
"14692","2024","COM","2022","1813","24","1837","2024-12-30"
"14694","2024","COM","2022","529","20","549","2024-12-30"
"14698","2024","COM","2022","391","4","395","2024-12-30"
"14699","2024","COM","2022","3857","46","3903","2024-12-30"
"14700","2024","COM","2022","694","9","703","2024-12-30"
"14701","2024","COM","2022","846","16","862","2024-12-30"
"14705","2024","COM","2022","147","3","150","2024-12-30"
"14706","2024","COM","2022","258","6","264","2024-12-30"
"14707","2024","COM","2022","1140","16","1156","2024-12-30"
"14708","2024","COM","2022","305","2","307","2024-12-30"
"14709","2024","COM","2022","348","6","354","2024-12-30"
"14710","2024","COM","2022","109","1","110","2024-12-30"
"14711","2024","COM","2022","922","11","933","2024-12-30"
"14712","2024","COM","2022","3442","81","3523","2024-12-30"
"14713","2024","COM","2022","561","11","572","2024-12-30"
"14714","2024","COM","2022","762","14","776","2024-12-30"
"14715","2024","COM","2022","4624","55","4679","2024-12-30"
"14716","2024","COM","2022","212","3","215","2024-12-30"
"14719","2024","COM","2022","761","3","764","2024-12-30"
"14720","2024","COM","2022","845","27","872","2024-12-30"
"14721","2024","COM","2022","680","6","686","2024-12-30"
"14723","2024","COM","2022","264","4","268","2024-12-30"
"14724","2024","COM","2022","1028","14","1042","2024-12-30"
"14726","2024","COM","2022","5692","106","5798","2024-12-30"
"14728","2024","COM","2022","600","7","607","2024-12-30"
"14731","2024","COM","2022","199","0","199","2024-12-30"
"14732","2024","COM","2022","284","10","294","2024-12-30"
"14733","2024","COM","2022","322","9","331","2024-12-30"
"14734","2024","COM","2022","335","7","342","2024-12-30"
"14735","2024","COM","2022","802","16","818","2024-12-30"
"14737","2024","COM","2022","508","12","520","2024-12-30"
"14738","2024","COM","2022","3927","53","3980","2024-12-30"
"14739","2024","COM","2022","1622","25","1647","2024-12-30"
"14740","2024","COM","2022","1181","24","1205","2024-12-30"
"14741","2024","COM","2022","130","6","136","2024-12-30"
"14742","2024","COM","2022","69","0","69","2024-12-30"
"14743","2024","COM","2022","80","3","83","2024-12-30"
"14744","2024","COM","2022","266","4","270","2024-12-30"
"14745","2024","COM","2022","232","3","235","2024-12-30"
"14747","2024","COM","2022","710","11","721","2024-12-30"
"14748","2024","COM","2022","91","2","93","2024-12-30"
"14751","2024","COM","2022","285","8","293","2024-12-30"
"14752","2024","COM","2022","3113","37","3150","2024-12-30"
"14753","2024","COM","2022","725","23","748","2024-12-30"
"14754","2024","COM","2022","2437","47","2484","2024-12-30"
"14755","2024","COM","2022","606","12","618","2024-12-30"
"14756","2024","COM","2022","222","10","232","2024-12-30"
"14758","2024","COM","2022","834","18","852","2024-12-30"
"14759","2024","COM","2022","269","8","277","2024-12-30"
"14760","2024","COM","2022","709","6","715","2024-12-30"
"14761","2024","COM","2022","884","16","900","2024-12-30"
"14762","2024","COM","2022","17411","766","18177","2024-12-30"
"14764","2024","COM","2022","999","16","1015","2024-12-30"
"15001","2024","COM","2022","783","13","796","2024-12-30"
"15002","2024","COM","2022","225","2","227","2024-12-30"
"15003","2024","COM","2022","596","9","605","2024-12-30"
"15004","2024","COM","2022","474","11","485","2024-12-30"
"15005","2024","COM","2022","403","13","416","2024-12-30"
"15006","2024","COM","2022","724","25","749","2024-12-30"
"15007","2024","COM","2022","122","5","127","2024-12-30"
"15008","2024","COM","2022","282","6","288","2024-12-30"
"15009","2024","COM","2022","180","4","184","2024-12-30"
"15010","2024","COM","2022","203","3","206","2024-12-30"
"15011","2024","COM","2022","178","5","183","2024-12-30"
"15012","2024","COM","2022","6363","200","6563","2024-12-30"
"15013","2024","COM","2022","142","2","144","2024-12-30"
"15014","2024","COM","2022","26189","1291","27480","2024-12-30"
"15015","2024","COM","2022","161","3","164","2024-12-30"
"15016","2024","COM","2022","618","14","632","2024-12-30"
"15017","2024","COM","2022","130","7","137","2024-12-30"
"15018","2024","COM","2022","138","0","138","2024-12-30"
"15019","2024","COM","2022","222","10","232","2024-12-30"
"15020","2024","COM","2022","84","0","84","2024-12-30"
"15021","2024","COM","2022","665","22","687","2024-12-30"
"15022","2024","COM","2022","160","4","164","2024-12-30"
"15024","2024","COM","2022","77","0","77","2024-12-30"
"15025","2024","COM","2022","240","7","247","2024-12-30"
"15026","2024","COM","2022","179","0","179","2024-12-30"
"15027","2024","COM","2022","724","13","737","2024-12-30"
"15028","2024","COM","2022","390","6","396","2024-12-30"
"15029","2024","COM","2022","503","19","522","2024-12-30"
"15030","2024","COM","2022","297","10","307","2024-12-30"
"15032","2024","COM","2022","58","4","62","2024-12-30"
"15033","2024","COM","2022","217","5","222","2024-12-30"
"15034","2024","COM","2022","139","3","142","2024-12-30"
"15036","2024","COM","2022","457","11","468","2024-12-30"
"15037","2024","COM","2022","1023","20","1043","2024-12-30"
"15038","2024","COM","2022","1028","13","1041","2024-12-30"
"15040","2024","COM","2022","99","4","103","2024-12-30"
"15041","2024","COM","2022","258","5","263","2024-12-30"
"15042","2024","COM","2022","239","7","246","2024-12-30"
"15043","2024","COM","2022","72","0","72","2024-12-30"
"15045","2024","COM","2022","814","14","828","2024-12-30"
"15046","2024","COM","2022","223","3","226","2024-12-30"
"15048","2024","COM","2022","33","2","35","2024-12-30"
"15049","2024","COM","2022","224","8","232","2024-12-30"
"15050","2024","COM","2022","161","3","164","2024-12-30"
"15051","2024","COM","2022","193","2","195","2024-12-30"
"15052","2024","COM","2022","157","9","166","2024-12-30"
"15053","2024","COM","2022","428","11","439","2024-12-30"
"15054","2024","COM","2022","950","36","986","2024-12-30"
"15055","2024","COM","2022","445","12","457","2024-12-30"
"15056","2024","COM","2022","870","20","890","2024-12-30"
"15057","2024","COM","2022","192","2","194","2024-12-30"
"15058","2024","COM","2022","147","1","148","2024-12-30"
"15059","2024","COM","2022","120","6","126","2024-12-30"
"15060","2024","COM","2022","53","4","57","2024-12-30"
"15061","2024","COM","2022","238","5","243","2024-12-30"
"15063","2024","COM","2022","323","14","337","2024-12-30"
"15064","2024","COM","2022","83","1","84","2024-12-30"
"15065","2024","COM","2022","79","2","81","2024-12-30"
"15066","2024","COM","2022","116","3","119","2024-12-30"
"15067","2024","COM","2022","31","0","31","2024-12-30"
"15069","2024","COM","2022","238","6","244","2024-12-30"
"15070","2024","COM","2022","208","3","211","2024-12-30"
"15072","2024","COM","2022","216","8","224","2024-12-30"
"15073","2024","COM","2022","95","2","97","2024-12-30"
"15074","2024","COM","2022","736","21","757","2024-12-30"
"15075","2024","COM","2022","71","4","75","2024-12-30"
"15076","2024","COM","2022","174","4","178","2024-12-30"
"15077","2024","COM","2022","68","1","69","2024-12-30"
"15078","2024","COM","2022","155","4","159","2024-12-30"
"15079","2024","COM","2022","360","9","369","2024-12-30"
"15080","2024","COM","2022","155","6","161","2024-12-30"
"15081","2024","COM","2022","107","1","108","2024-12-30"
"15082","2024","COM","2022","288","5","293","2024-12-30"
"15083","2024","COM","2022","2040","68","2108","2024-12-30"
"15084","2024","COM","2022","297","5","302","2024-12-30"
"15085","2024","COM","2022","480","12","492","2024-12-30"
"15086","2024","COM","2022","59","1","60","2024-12-30"
"15087","2024","COM","2022","402","12","414","2024-12-30"
"15088","2024","COM","2022","520","15","535","2024-12-30"
"15089","2024","COM","2022","435","10","445","2024-12-30"
"15090","2024","COM","2022","591","15","606","2024-12-30"
"15091","2024","COM","2022","86","2","88","2024-12-30"
"15092","2024","COM","2022","1350","19","1369","2024-12-30"
"15093","2024","COM","2022","94","2","96","2024-12-30"
"15094","2024","COM","2022","791","17","808","2024-12-30"
"15095","2024","COM","2022","349","1","350","2024-12-30"
"15096","2024","COM","2022","266","7","273","2024-12-30"
"15097","2024","COM","2022","108","5","113","2024-12-30"
"15098","2024","COM","2022","84","0","84","2024-12-30"
"15100","2024","COM","2022","135","1","136","2024-12-30"
"15101","2024","COM","2022","526","14","540","2024-12-30"
"15102","2024","COM","2022","113","5","118","2024-12-30"
"15103","2024","COM","2022","244","6","250","2024-12-30"
"15104","2024","COM","2022","315","15","330","2024-12-30"
"15105","2024","COM","2022","36","1","37","2024-12-30"
"15106","2024","COM","2022","171","4","175","2024-12-30"
"15107","2024","COM","2022","163","3","166","2024-12-30"
"15108","2024","COM","2022","946","24","970","2024-12-30"
"15110","2024","COM","2022","119","5","124","2024-12-30"
"15111","2024","COM","2022","204","5","209","2024-12-30"
"15112","2024","COM","2022","89","0","89","2024-12-30"
"15113","2024","COM","2022","174","4","178","2024-12-30"
"15114","2024","COM","2022","510","9","519","2024-12-30"
"15116","2024","COM","2022","132","4","136","2024-12-30"
"15117","2024","COM","2022","593","73","666","2024-12-30"
"15118","2024","COM","2022","686","30","716","2024-12-30"
"15119","2024","COM","2022","1801","68","1869","2024-12-30"
"15120","2024","COM","2022","3503","204","3707","2024-12-30"
"15121","2024","COM","2022","104","4","108","2024-12-30"
"15122","2024","COM","2022","2131","61","2192","2024-12-30"
"15123","2024","COM","2022","154","1","155","2024-12-30"
"15124","2024","COM","2022","531","23","554","2024-12-30"
"15125","2024","COM","2022","124","1","125","2024-12-30"
"15126","2024","COM","2022","78","3","81","2024-12-30"
"15127","2024","COM","2022","272","5","277","2024-12-30"
"15128","2024","COM","2022","119","0","119","2024-12-30"
"15129","2024","COM","2022","163","5","168","2024-12-30"
"15130","2024","COM","2022","142","2","144","2024-12-30"
"15131","2024","COM","2022","269","8","277","2024-12-30"
"15132","2024","COM","2022","31","1","32","2024-12-30"
"15133","2024","COM","2022","134","2","136","2024-12-30"
"15134","2024","COM","2022","832","14","846","2024-12-30"
"15135","2024","COM","2022","113","7","120","2024-12-30"
"15137","2024","COM","2022","251","3","254","2024-12-30"
"15138","2024","COM","2022","1770","89","1859","2024-12-30"
"15139","2024","COM","2022","68","0","68","2024-12-30"
"15140","2024","COM","2022","2164","66","2230","2024-12-30"
"15141","2024","COM","2022","1577","32","1609","2024-12-30"
"15142","2024","COM","2022","1689","40","1729","2024-12-30"
"15143","2024","COM","2022","106","1","107","2024-12-30"
"15144","2024","COM","2022","318","10","328","2024-12-30"
"15146","2024","COM","2022","137","4","141","2024-12-30"
"15147","2024","COM","2022","470","10","480","2024-12-30"
"15148","2024","COM","2022","434","11","445","2024-12-30"
"15149","2024","COM","2022","258","1","259","2024-12-30"
"15151","2024","COM","2022","141","0","141","2024-12-30"
"15152","2024","COM","2022","891","16","907","2024-12-30"
"15153","2024","COM","2022","1464","29","1493","2024-12-30"
"15154","2024","COM","2022","1205","31","1236","2024-12-30"
"15155","2024","COM","2022","81","1","82","2024-12-30"
"15156","2024","COM","2022","686","15","701","2024-12-30"
"15157","2024","COM","2022","347","45","392","2024-12-30"
"15158","2024","COM","2022","99","1","100","2024-12-30"
"15159","2024","COM","2022","273","9","282","2024-12-30"
"15160","2024","COM","2022","1094","22","1116","2024-12-30"
"15161","2024","COM","2022","110","3","113","2024-12-30"
"15162","2024","COM","2022","2403","34","2437","2024-12-30"
"15163","2024","COM","2022","1104","32","1136","2024-12-30"
"15164","2024","COM","2022","562","19","581","2024-12-30"
"15165","2024","COM","2022","188","3","191","2024-12-30"
"15166","2024","COM","2022","329","11","340","2024-12-30"
"15167","2024","COM","2022","110","8","118","2024-12-30"
"15168","2024","COM","2022","715","16","731","2024-12-30"
"15169","2024","COM","2022","821","11","832","2024-12-30"
"15170","2024","COM","2022","227","4","231","2024-12-30"
"15172","2024","COM","2022","85","1","86","2024-12-30"
"15173","2024","COM","2022","113","4","117","2024-12-30"
"15174","2024","COM","2022","254","7","261","2024-12-30"
"15175","2024","COM","2022","1047","24","1071","2024-12-30"
"15176","2024","COM","2022","237","8","245","2024-12-30"
"15178","2024","COM","2022","139","5","144","2024-12-30"
"15179","2024","COM","2022","250","4","254","2024-12-30"
"15180","2024","COM","2022","78","4","82","2024-12-30"
"15181","2024","COM","2022","568","12","580","2024-12-30"
"15182","2024","COM","2022","124","2","126","2024-12-30"
"15183","2024","COM","2022","124","3","127","2024-12-30"
"15184","2024","COM","2022","787","19","806","2024-12-30"
"15185","2024","COM","2022","252","6","258","2024-12-30"
"15186","2024","COM","2022","231","2","233","2024-12-30"
"15187","2024","COM","2022","6390","492","6882","2024-12-30"
"15188","2024","COM","2022","1176","33","1209","2024-12-30"
"15189","2024","COM","2022","229","5","234","2024-12-30"
"15190","2024","COM","2022","98","3","101","2024-12-30"
"15191","2024","COM","2022","649","11","660","2024-12-30"
"15192","2024","COM","2022","292","4","296","2024-12-30"
"15194","2024","COM","2022","102","4","106","2024-12-30"
"15196","2024","COM","2022","1537","54","1591","2024-12-30"
"15198","2024","COM","2022","103","3","106","2024-12-30"
"15199","2024","COM","2022","71","1","72","2024-12-30"
"15200","2024","COM","2022","154","3","157","2024-12-30"
"15201","2024","COM","2022","219","4","223","2024-12-30"
"15202","2024","COM","2022","713","17","730","2024-12-30"
"15203","2024","COM","2022","186","4","190","2024-12-30"
"15204","2024","COM","2022","1538","38","1576","2024-12-30"
"15205","2024","COM","2022","105","3","108","2024-12-30"
"15206","2024","COM","2022","146","2","148","2024-12-30"
"15207","2024","COM","2022","337","4","341","2024-12-30"
"15208","2024","COM","2022","133","4","137","2024-12-30"
"15209","2024","COM","2022","121","5","126","2024-12-30"
"15211","2024","COM","2022","285","5","290","2024-12-30"
"15212","2024","COM","2022","365","10","375","2024-12-30"
"15213","2024","COM","2022","191","8","199","2024-12-30"
"15214","2024","COM","2022","178","3","181","2024-12-30"
"15215","2024","COM","2022","1142","42","1184","2024-12-30"
"15216","2024","COM","2022","449","16","465","2024-12-30"
"15217","2024","COM","2022","96","5","101","2024-12-30"
"15218","2024","COM","2022","70","2","72","2024-12-30"
"15219","2024","COM","2022","312","7","319","2024-12-30"
"15220","2024","COM","2022","144","3","147","2024-12-30"
"15221","2024","COM","2022","1388","46","1434","2024-12-30"
"15222","2024","COM","2022","201","4","205","2024-12-30"
"15223","2024","COM","2022","217","3","220","2024-12-30"
"15224","2024","COM","2022","123","3","126","2024-12-30"
"15225","2024","COM","2022","215","4","219","2024-12-30"
"15226","2024","COM","2022","209","3","212","2024-12-30"
"15228","2024","COM","2022","461","6","467","2024-12-30"
"15229","2024","COM","2022","83","0","83","2024-12-30"
"15230","2024","COM","2022","196","4","200","2024-12-30"
"15231","2024","COM","2022","596","28","624","2024-12-30"
"15232","2024","COM","2022","220","5","225","2024-12-30"
"15233","2024","COM","2022","322","5","327","2024-12-30"
"15234","2024","COM","2022","339","6","345","2024-12-30"
"15235","2024","COM","2022","567","18","585","2024-12-30"
"15236","2024","COM","2022","596","12","608","2024-12-30"
"15237","2024","COM","2022","164","10","174","2024-12-30"
"15238","2024","COM","2022","122","3","125","2024-12-30"
"15240","2024","COM","2022","169","5","174","2024-12-30"
"15241","2024","COM","2022","51","5","56","2024-12-30"
"15242","2024","COM","2022","98","4","102","2024-12-30"
"15243","2024","COM","2022","449","14","463","2024-12-30"
"15244","2024","COM","2022","458","11","469","2024-12-30"
"15245","2024","COM","2022","251","3","254","2024-12-30"
"15246","2024","COM","2022","237","3","240","2024-12-30"
"15247","2024","COM","2022","24","1","25","2024-12-30"
"15248","2024","COM","2022","578","12","590","2024-12-30"
"15249","2024","COM","2022","61","2","63","2024-12-30"
"15250","2024","COM","2022","514","17","531","2024-12-30"
"15251","2024","COM","2022","120","5","125","2024-12-30"
"15252","2024","COM","2022","402","17","419","2024-12-30"
"15253","2024","COM","2022","59","2","61","2024-12-30"
"15254","2024","COM","2022","120","4","124","2024-12-30"
"15255","2024","COM","2022","1314","36","1350","2024-12-30"
"15256","2024","COM","2022","64","0","64","2024-12-30"
"15257","2024","COM","2022","131","3","134","2024-12-30"
"15258","2024","COM","2022","1908","38","1946","2024-12-30"
"15259","2024","COM","2022","261","8","269","2024-12-30"
"15260","2024","COM","2022","104","3","107","2024-12-30"
"15261","2024","COM","2022","800","19","819","2024-12-30"
"15262","2024","COM","2022","544","20","564","2024-12-30"
"15263","2024","COM","2022","117","2","119","2024-12-30"
"15264","2024","COM","2022","269","8","277","2024-12-30"
"15265","2024","COM","2022","1633","18","1651","2024-12-30"
"15266","2024","COM","2022","595","11","606","2024-12-30"
"15267","2024","COM","2022","4316","109","4425","2024-12-30"
"15268","2024","COM","2022","1288","16","1304","2024-12-30"
"15269","2024","COM","2022","131","3","134","2024-12-30"
"16001","2024","COM","2022","513","1","514","2024-12-30"
"16002","2024","COM","2022","532","15","547","2024-12-30"
"16003","2024","COM","2022","875","10","885","2024-12-30"
"16005","2024","COM","2022","1600","25","1625","2024-12-30"
"16007","2024","COM","2022","481","10","491","2024-12-30"
"16008","2024","COM","2022","312","10","322","2024-12-30"
"16009","2024","COM","2022","377","6","383","2024-12-30"
"16011","2024","COM","2022","566","19","585","2024-12-30"
"16012","2024","COM","2022","496","9","505","2024-12-30"
"16013","2024","COM","2022","296","3","299","2024-12-30"
"16014","2024","COM","2022","143","1","144","2024-12-30"
"16015","2024","COM","2022","41423","1560","42983","2024-12-30"
"16016","2024","COM","2022","816","20","836","2024-12-30"
"16018","2024","COM","2022","689","14","703","2024-12-30"
"16019","2024","COM","2022","1278","17","1295","2024-12-30"
"16020","2024","COM","2022","318","4","322","2024-12-30"
"16023","2024","COM","2022","558","15","573","2024-12-30"
"16024","2024","COM","2022","549","9","558","2024-12-30"
"16025","2024","COM","2022","1241","24","1265","2024-12-30"
"16026","2024","COM","2022","1401","27","1428","2024-12-30"
"16027","2024","COM","2022","137","2","139","2024-12-30"
"16028","2024","COM","2022","4738","173","4911","2024-12-30"
"16029","2024","COM","2022","217","6","223","2024-12-30"
"16030","2024","COM","2022","1092","24","1116","2024-12-30"
"16031","2024","COM","2022","410","11","421","2024-12-30"
"16032","2024","COM","2022","522","10","532","2024-12-30"
"16034","2024","COM","2022","147","2","149","2024-12-30"
"16035","2024","COM","2022","222","6","228","2024-12-30"
"16036","2024","COM","2022","292","9","301","2024-12-30"
"16037","2024","COM","2022","136","5","141","2024-12-30"
"16038","2024","COM","2022","307","4","311","2024-12-30"
"16039","2024","COM","2022","463","14","477","2024-12-30"
"16040","2024","COM","2022","321","6","327","2024-12-30"
"16041","2024","COM","2022","119","0","119","2024-12-30"
"16042","2024","COM","2022","113","0","113","2024-12-30"
"16044","2024","COM","2022","208","6","214","2024-12-30"
"16045","2024","COM","2022","368","5","373","2024-12-30"
"16046","2024","COM","2022","1000","16","1016","2024-12-30"
"16047","2024","COM","2022","273","7","280","2024-12-30"
"16048","2024","COM","2022","128","0","128","2024-12-30"
"16049","2024","COM","2022","360","6","366","2024-12-30"
"16050","2024","COM","2022","248","8","256","2024-12-30"
"16052","2024","COM","2022","227","3","230","2024-12-30"
"16053","2024","COM","2022","118","1","119","2024-12-30"
"16054","2024","COM","2022","177","2","179","2024-12-30"
"16055","2024","COM","2022","845","10","855","2024-12-30"
"16056","2024","COM","2022","885","18","903","2024-12-30"
"16057","2024","COM","2022","330","6","336","2024-12-30"
"16058","2024","COM","2022","1393","26","1419","2024-12-30"
"16059","2024","COM","2022","163","5","168","2024-12-30"
"16060","2024","COM","2022","440","10","450","2024-12-30"
"16061","2024","COM","2022","4157","68","4225","2024-12-30"
"16062","2024","COM","2022","111","2","113","2024-12-30"
"16063","2024","COM","2022","158","0","158","2024-12-30"
"16064","2024","COM","2022","1101","16","1117","2024-12-30"
"16065","2024","COM","2022","607","7","614","2024-12-30"
"16066","2024","COM","2022","453","9","462","2024-12-30"
"16067","2024","COM","2022","453","7","460","2024-12-30"
"16068","2024","COM","2022","579","6","585","2024-12-30"
"16069","2024","COM","2022","388","3","391","2024-12-30"
"16070","2024","COM","2022","1564","26","1590","2024-12-30"
"16071","2024","COM","2022","614","14","628","2024-12-30"
"16072","2024","COM","2022","509","11","520","2024-12-30"
"16073","2024","COM","2022","1799","30","1829","2024-12-30"
"16074","2024","COM","2022","340","8","348","2024-12-30"
"16075","2024","COM","2022","235","4","239","2024-12-30"
"16076","2024","COM","2022","877","9","886","2024-12-30"
"16077","2024","COM","2022","525","6","531","2024-12-30"
"16078","2024","COM","2022","5237","73","5310","2024-12-30"
"16079","2024","COM","2022","372","3","375","2024-12-30"
"16081","2024","COM","2022","191","4","195","2024-12-30"
"16082","2024","COM","2022","661","10","671","2024-12-30"
"16083","2024","COM","2022","340","5","345","2024-12-30"
"16084","2024","COM","2022","346","4","350","2024-12-30"
"16085","2024","COM","2022","3103","279","3382","2024-12-30"
"16086","2024","COM","2022","843","17","860","2024-12-30"
"16087","2024","COM","2022","148","3","151","2024-12-30"
"16088","2024","COM","2022","1103","19","1122","2024-12-30"
"16089","2024","COM","2022","3793","70","3863","2024-12-30"
"16090","2024","COM","2022","3562","58","3620","2024-12-30"
"16091","2024","COM","2022","166","0","166","2024-12-30"
"16093","2024","COM","2022","1550","26","1576","2024-12-30"
"16095","2024","COM","2022","125","3","128","2024-12-30"
"16096","2024","COM","2022","416","9","425","2024-12-30"
"16097","2024","COM","2022","3455","109","3564","2024-12-30"
"16098","2024","COM","2022","137","2","139","2024-12-30"
"16099","2024","COM","2022","225","3","228","2024-12-30"
"16100","2024","COM","2022","779","13","792","2024-12-30"
"16101","2024","COM","2022","1058","17","1075","2024-12-30"
"16102","2024","COM","2022","18466","443","18909","2024-12-30"
"16103","2024","COM","2022","126","0","126","2024-12-30"
"16104","2024","COM","2022","460","12","472","2024-12-30"
"16105","2024","COM","2022","609","16","625","2024-12-30"
"16106","2024","COM","2022","2726","131","2857","2024-12-30"
"16107","2024","COM","2022","557","7","564","2024-12-30"
"16108","2024","COM","2022","121","2","123","2024-12-30"
"16109","2024","COM","2022","729","12","741","2024-12-30"
"16110","2024","COM","2022","801","12","813","2024-12-30"
"16111","2024","COM","2022","170","2","172","2024-12-30"
"16112","2024","COM","2022","58","2","60","2024-12-30"
"16113","2024","COM","2022","7759","251","8010","2024-12-30"
"16114","2024","COM","2022","173","2","175","2024-12-30"
"16116","2024","COM","2022","403","10","413","2024-12-30"
"16117","2024","COM","2022","116","3","119","2024-12-30"
"16118","2024","COM","2022","134","3","137","2024-12-30"
"16119","2024","COM","2022","1373","16","1389","2024-12-30"
"16120","2024","COM","2022","1509","21","1530","2024-12-30"
"16121","2024","COM","2022","432","13","445","2024-12-30"
"16122","2024","COM","2022","139","3","142","2024-12-30"
"16123","2024","COM","2022","481","11","492","2024-12-30"
"16124","2024","COM","2022","542","11","553","2024-12-30"
"16125","2024","COM","2022","272","3","275","2024-12-30"
"16127","2024","COM","2022","96","0","96","2024-12-30"
"16128","2024","COM","2022","191","1","192","2024-12-30"
"16130","2024","COM","2022","178","7","185","2024-12-30"
"16131","2024","COM","2022","509","7","516","2024-12-30"
"16132","2024","COM","2022","987","19","1006","2024-12-30"
"16133","2024","COM","2022","200","3","203","2024-12-30"
"16134","2024","COM","2022","1028","12","1040","2024-12-30"
"16135","2024","COM","2022","325","3","328","2024-12-30"
"16136","2024","COM","2022","595","11","606","2024-12-30"
"16137","2024","COM","2022","284","2","286","2024-12-30"
"16138","2024","COM","2022","3856","104","3960","2024-12-30"
"16139","2024","COM","2022","220","3","223","2024-12-30"
"16141","2024","COM","2022","343","9","352","2024-12-30"
"16142","2024","COM","2022","209","4","213","2024-12-30"
"16143","2024","COM","2022","717","12","729","2024-12-30"
"16144","2024","COM","2022","431","8","439","2024-12-30"
"16145","2024","COM","2022","656","7","663","2024-12-30"
"16146","2024","COM","2022","2111","44","2155","2024-12-30"
"16147","2024","COM","2022","256","4","260","2024-12-30"
"16148","2024","COM","2022","973","21","994","2024-12-30"
"16150","2024","COM","2022","1614","44","1658","2024-12-30"
"16151","2024","COM","2022","929","20","949","2024-12-30"
"16152","2024","COM","2022","727","12","739","2024-12-30"
"16153","2024","COM","2022","1184","21","1205","2024-12-30"
"16154","2024","COM","2022","5884","95","5979","2024-12-30"
"16155","2024","COM","2022","93","4","97","2024-12-30"
"16157","2024","COM","2022","154","3","157","2024-12-30"
"16158","2024","COM","2022","303","5","308","2024-12-30"
"16160","2024","COM","2022","495","6","501","2024-12-30"
"16161","2024","COM","2022","165","4","169","2024-12-30"
"16162","2024","COM","2022","184","0","184","2024-12-30"
"16163","2024","COM","2022","1150","25","1175","2024-12-30"
"16164","2024","COM","2022","238","3","241","2024-12-30"
"16165","2024","COM","2022","395","6","401","2024-12-30"
"16166","2024","COM","2022","5691","110","5801","2024-12-30"
"16167","2024","COM","2022","4478","105","4583","2024-12-30"
"16168","2024","COM","2022","832","21","853","2024-12-30"
"16169","2024","COM","2022","581","12","593","2024-12-30"
"16170","2024","COM","2022","392","2","394","2024-12-30"
"16171","2024","COM","2022","655","15","670","2024-12-30"
"16173","2024","COM","2022","176","0","176","2024-12-30"
"16174","2024","COM","2022","540","12","552","2024-12-30"
"16175","2024","COM","2022","1358","32","1390","2024-12-30"
"16176","2024","COM","2022","306","4","310","2024-12-30"
"16177","2024","COM","2022","129","1","130","2024-12-30"
"16178","2024","COM","2022","187","4","191","2024-12-30"
"16180","2024","COM","2022","249","5","254","2024-12-30"
"16181","2024","COM","2022","534","6","540","2024-12-30"
"16182","2024","COM","2022","440","12","452","2024-12-30"
"16183","2024","COM","2022","169","4","173","2024-12-30"
"16184","2024","COM","2022","95","1","96","2024-12-30"
"16185","2024","COM","2022","146","4","150","2024-12-30"
"16186","2024","COM","2022","704","22","726","2024-12-30"
"16187","2024","COM","2022","2105","37","2142","2024-12-30"
"16188","2024","COM","2022","339","3","342","2024-12-30"
"16189","2024","COM","2022","246","6","252","2024-12-30"
"16190","2024","COM","2022","191","7","198","2024-12-30"
"16191","2024","COM","2022","188","1","189","2024-12-30"
"16192","2024","COM","2022","3790","119","3909","2024-12-30"
"16193","2024","COM","2022","964","23","987","2024-12-30"
"16194","2024","COM","2022","111","2","113","2024-12-30"
"16195","2024","COM","2022","293","4","297","2024-12-30"
"16196","2024","COM","2022","732","12","744","2024-12-30"
"16197","2024","COM","2022","117","3","120","2024-12-30"
"16198","2024","COM","2022","487","4","491","2024-12-30"
"16199","2024","COM","2022","3252","64","3316","2024-12-30"
"16200","2024","COM","2022","476","6","482","2024-12-30"
"16203","2024","COM","2022","123","1","124","2024-12-30"
"16204","2024","COM","2022","1274","33","1307","2024-12-30"
"16205","2024","COM","2022","548","9","557","2024-12-30"
"16206","2024","COM","2022","2092","31","2123","2024-12-30"
"16207","2024","COM","2022","509","9","518","2024-12-30"
"16208","2024","COM","2022","393","5","398","2024-12-30"
"16209","2024","COM","2022","823","19","842","2024-12-30"
"16210","2024","COM","2022","766","14","780","2024-12-30"
"16211","2024","COM","2022","547","6","553","2024-12-30"
"16212","2024","COM","2022","368","8","376","2024-12-30"
"16213","2024","COM","2022","305","3","308","2024-12-30"
"16215","2024","COM","2022","151","1","152","2024-12-30"
"16216","2024","COM","2022","812","14","826","2024-12-30"
"16217","2024","COM","2022","1082","25","1107","2024-12-30"
"16218","2024","COM","2022","408","10","418","2024-12-30"
"16220","2024","COM","2022","714","17","731","2024-12-30"
"16221","2024","COM","2022","235","3","238","2024-12-30"
"16222","2024","COM","2022","329","7","336","2024-12-30"
"16223","2024","COM","2022","1995","32","2027","2024-12-30"
"16224","2024","COM","2022","725","12","737","2024-12-30"
"16225","2024","COM","2022","659","32","691","2024-12-30"
"16226","2024","COM","2022","699","10","709","2024-12-30"
"16227","2024","COM","2022","134","0","134","2024-12-30"
"16229","2024","COM","2022","251","4","255","2024-12-30"
"16230","2024","COM","2022","2419","84","2503","2024-12-30"
"16231","2024","COM","2022","332","2","334","2024-12-30"
"16232","2024","COM","2022","2115","46","2161","2024-12-30"
"16233","2024","COM","2022","967","25","992","2024-12-30"
"16234","2024","COM","2022","664","11","675","2024-12-30"
"16236","2024","COM","2022","2358","70","2428","2024-12-30"
"16237","2024","COM","2022","223","2","225","2024-12-30"
"16238","2024","COM","2022","104","2","106","2024-12-30"
"16239","2024","COM","2022","140","1","141","2024-12-30"
"16240","2024","COM","2022","99","3","102","2024-12-30"
"16241","2024","COM","2022","210","5","215","2024-12-30"
"16242","2024","COM","2022","1357","18","1375","2024-12-30"
"16243","2024","COM","2022","1036","21","1057","2024-12-30"
"16244","2024","COM","2022","2258","53","2311","2024-12-30"
"16245","2024","COM","2022","889","13","902","2024-12-30"
"16246","2024","COM","2022","258","4","262","2024-12-30"
"16248","2024","COM","2022","155","4","159","2024-12-30"
"16249","2024","COM","2022","341","2","343","2024-12-30"
"16250","2024","COM","2022","208","3","211","2024-12-30"
"16251","2024","COM","2022","245","5","250","2024-12-30"
"16252","2024","COM","2022","150","1","151","2024-12-30"
"16253","2024","COM","2022","351","4","355","2024-12-30"
"16254","2024","COM","2022","214","8","222","2024-12-30"
"16255","2024","COM","2022","141","1","142","2024-12-30"
"16256","2024","COM","2022","251","4","255","2024-12-30"
"16258","2024","COM","2022","496","8","504","2024-12-30"
"16260","2024","COM","2022","253","8","261","2024-12-30"
"16261","2024","COM","2022","501","14","515","2024-12-30"
"16263","2024","COM","2022","379","9","388","2024-12-30"
"16264","2024","COM","2022","314","6","320","2024-12-30"
"16267","2024","COM","2022","105","1","106","2024-12-30"
"16268","2024","COM","2022","195","6","201","2024-12-30"
"16269","2024","COM","2022","885","19","904","2024-12-30"
"16270","2024","COM","2022","379","8","387","2024-12-30"
"16271","2024","COM","2022","2394","132","2526","2024-12-30"
"16272","2024","COM","2022","571","9","580","2024-12-30"
"16273","2024","COM","2022","116","6","122","2024-12-30"
"16275","2024","COM","2022","164","5","169","2024-12-30"
"16276","2024","COM","2022","715","9","724","2024-12-30"
"16277","2024","COM","2022","617","13","630","2024-12-30"
"16279","2024","COM","2022","221","3","224","2024-12-30"
"16280","2024","COM","2022","2023","30","2053","2024-12-30"
"16281","2024","COM","2022","4020","106","4126","2024-12-30"
"16282","2024","COM","2022","525","11","536","2024-12-30"
"16283","2024","COM","2022","571","8","579","2024-12-30"
"16284","2024","COM","2022","119","3","122","2024-12-30"
"16285","2024","COM","2022","398","4","402","2024-12-30"
"16286","2024","COM","2022","2909","41","2950","2024-12-30"
"16287","2024","COM","2022","4334","64","4398","2024-12-30"
"16289","2024","COM","2022","298","4","302","2024-12-30"
"16290","2024","COM","2022","232","2","234","2024-12-30"
"16291","2024","COM","2022","7396","196","7592","2024-12-30"
"16292","2024","COM","2022","3394","153","3547","2024-12-30"
"16293","2024","COM","2022","493","7","500","2024-12-30"
"16295","2024","COM","2022","1327","20","1347","2024-12-30"
"16297","2024","COM","2022","328","7","335","2024-12-30"
"16298","2024","COM","2022","350","5","355","2024-12-30"
"16300","2024","COM","2022","1339","15","1354","2024-12-30"
"16301","2024","COM","2022","218","4","222","2024-12-30"
"16302","2024","COM","2022","219","2","221","2024-12-30"
"16303","2024","COM","2022","407","12","419","2024-12-30"
"16304","2024","COM","2022","969","19","988","2024-12-30"
"16306","2024","COM","2022","323","3","326","2024-12-30"
"16307","2024","COM","2022","313","10","323","2024-12-30"
"16308","2024","COM","2022","1033","21","1054","2024-12-30"
"16310","2024","COM","2022","212","6","218","2024-12-30"
"16312","2024","COM","2022","796","6","802","2024-12-30"
"16315","2024","COM","2022","102","0","102","2024-12-30"
"16316","2024","COM","2022","380","6","386","2024-12-30"
"16317","2024","COM","2022","429","2","431","2024-12-30"
"16318","2024","COM","2022","358","2","360","2024-12-30"
"16320","2024","COM","2022","915","11","926","2024-12-30"
"16321","2024","COM","2022","44","0","44","2024-12-30"
"16323","2024","COM","2022","488","6","494","2024-12-30"
"16325","2024","COM","2022","131","3","134","2024-12-30"
"16326","2024","COM","2022","130","0","130","2024-12-30"
"16329","2024","COM","2022","726","9","735","2024-12-30"
"16330","2024","COM","2022","832","25","857","2024-12-30"
"16331","2024","COM","2022","94","2","96","2024-12-30"
"16334","2024","COM","2022","121","3","124","2024-12-30"
"16335","2024","COM","2022","124","3","127","2024-12-30"
"16336","2024","COM","2022","350","6","356","2024-12-30"
"16337","2024","COM","2022","896","26","922","2024-12-30"
"16338","2024","COM","2022","306","4","310","2024-12-30"
"16339","2024","COM","2022","795","13","808","2024-12-30"
"16340","2024","COM","2022","1029","25","1054","2024-12-30"
"16341","2024","COM","2022","3220","38","3258","2024-12-30"
"16342","2024","COM","2022","305","7","312","2024-12-30"
"16343","2024","COM","2022","302","4","306","2024-12-30"
"16345","2024","COM","2022","202","5","207","2024-12-30"
"16346","2024","COM","2022","243","6","249","2024-12-30"
"16347","2024","COM","2022","513","6","519","2024-12-30"
"16348","2024","COM","2022","1273","34","1307","2024-12-30"
"16349","2024","COM","2022","509","8","517","2024-12-30"
"16350","2024","COM","2022","793","9","802","2024-12-30"
"16352","2024","COM","2022","229","7","236","2024-12-30"
"16353","2024","COM","2022","832","11","843","2024-12-30"
"16354","2024","COM","2022","116","4","120","2024-12-30"
"16356","2024","COM","2022","41","0","41","2024-12-30"
"16357","2024","COM","2022","138","4","142","2024-12-30"
"16358","2024","COM","2022","7556","242","7798","2024-12-30"
"16359","2024","COM","2022","1007","22","1029","2024-12-30"
"16360","2024","COM","2022","400","85","485","2024-12-30"
"16361","2024","COM","2022","313","10","323","2024-12-30"
"16362","2024","COM","2022","311","11","322","2024-12-30"
"16363","2024","COM","2022","531","7","538","2024-12-30"
"16364","2024","COM","2022","68","2","70","2024-12-30"
"16365","2024","COM","2022","98","2","100","2024-12-30"
"16366","2024","COM","2022","2093","79","2172","2024-12-30"
"16368","2024","COM","2022","903","20","923","2024-12-30"
"16369","2024","COM","2022","965","22","987","2024-12-30"
"16370","2024","COM","2022","1166","43","1209","2024-12-30"
"16372","2024","COM","2022","149","1","150","2024-12-30"
"16373","2024","COM","2022","182","6","188","2024-12-30"
"16374","2024","COM","2022","10057","315","10372","2024-12-30"
"16375","2024","COM","2022","380","10","390","2024-12-30"
"16377","2024","COM","2022","106","2","108","2024-12-30"
"16378","2024","COM","2022","585","14","599","2024-12-30"
"16379","2024","COM","2022","1530","25","1555","2024-12-30"
"16380","2024","COM","2022","427","3","430","2024-12-30"
"16381","2024","COM","2022","163","2","165","2024-12-30"
"16382","2024","COM","2022","724","17","741","2024-12-30"
"16383","2024","COM","2022","787","21","808","2024-12-30"
"16384","2024","COM","2022","572","6","578","2024-12-30"
"16385","2024","COM","2022","1146","21","1167","2024-12-30"
"16387","2024","COM","2022","462","58","520","2024-12-30"
"16388","2024","COM","2022","940","23","963","2024-12-30"
"16389","2024","COM","2022","81","4","85","2024-12-30"
"16390","2024","COM","2022","240","7","247","2024-12-30"
"16392","2024","COM","2022","190","5","195","2024-12-30"
"16393","2024","COM","2022","2163","32","2195","2024-12-30"
"16394","2024","COM","2022","79","2","81","2024-12-30"
"16395","2024","COM","2022","295","5","300","2024-12-30"
"16396","2024","COM","2022","121","1","122","2024-12-30"
"16397","2024","COM","2022","383","7","390","2024-12-30"
"16398","2024","COM","2022","94","1","95","2024-12-30"
"16399","2024","COM","2022","321","2","323","2024-12-30"
"16400","2024","COM","2022","588","15","603","2024-12-30"
"16401","2024","COM","2022","147","2","149","2024-12-30"
"16402","2024","COM","2022","294","6","300","2024-12-30"
"16403","2024","COM","2022","131","0","131","2024-12-30"
"16404","2024","COM","2022","108","2","110","2024-12-30"
"16405","2024","COM","2022","161","10","171","2024-12-30"
"16406","2024","COM","2022","804","12","816","2024-12-30"
"16408","2024","COM","2022","718","18","736","2024-12-30"
"16409","2024","COM","2022","981","14","995","2024-12-30"
"16412","2024","COM","2022","367","3","370","2024-12-30"
"16413","2024","COM","2022","159","1","160","2024-12-30"
"16414","2024","COM","2022","332","2","334","2024-12-30"
"16415","2024","COM","2022","1044","24","1068","2024-12-30"
"16416","2024","COM","2022","494","9","503","2024-12-30"
"16418","2024","COM","2022","1594","29","1623","2024-12-30"
"16419","2024","COM","2022","312","2","314","2024-12-30"
"16420","2024","COM","2022","242","4","246","2024-12-30"
"16421","2024","COM","2022","408","4","412","2024-12-30"
"16422","2024","COM","2022","822","13","835","2024-12-30"
"16423","2024","COM","2022","235","2","237","2024-12-30"
"16424","2024","COM","2022","536","8","544","2024-12-30"
"16425","2024","COM","2022","562","9","571","2024-12-30"
"17002","2024","COM","2022","133","1","134","2024-12-30"
"17003","2024","COM","2022","4578","74","4652","2024-12-30"
"17004","2024","COM","2022","196","2","198","2024-12-30"
"17005","2024","COM","2022","197","1","198","2024-12-30"
"17006","2024","COM","2022","266","3","269","2024-12-30"
"17007","2024","COM","2022","318","6","324","2024-12-30"
"17008","2024","COM","2022","2314","38","2352","2024-12-30"
"17009","2024","COM","2022","1366","14","1380","2024-12-30"
"17010","2024","COM","2022","4147","102","4249","2024-12-30"
"17011","2024","COM","2022","395","4","399","2024-12-30"
"17012","2024","COM","2022","163","2","165","2024-12-30"
"17013","2024","COM","2022","366","4","370","2024-12-30"
"17015","2024","COM","2022","715","11","726","2024-12-30"
"17016","2024","COM","2022","762","11","773","2024-12-30"
"17017","2024","COM","2022","764","4","768","2024-12-30"
"17018","2024","COM","2022","877","13","890","2024-12-30"
"17019","2024","COM","2022","1306","15","1321","2024-12-30"
"17020","2024","COM","2022","339","6","345","2024-12-30"
"17021","2024","COM","2022","3875","70","3945","2024-12-30"
"17022","2024","COM","2022","980","23","1003","2024-12-30"
"17023","2024","COM","2022","373","6","379","2024-12-30"
"17024","2024","COM","2022","1359","17","1376","2024-12-30"
"17025","2024","COM","2022","699","29","728","2024-12-30"
"17026","2024","COM","2022","398","6","404","2024-12-30"
"17027","2024","COM","2022","491","9","500","2024-12-30"
"17028","2024","COM","2022","9759","139","9898","2024-12-30"
"17029","2024","COM","2022","179","3","182","2024-12-30"
"17030","2024","COM","2022","614","12","626","2024-12-30"
"17031","2024","COM","2022","203","3","206","2024-12-30"
"17032","2024","COM","2022","823","17","840","2024-12-30"
"17033","2024","COM","2022","496","5","501","2024-12-30"
"17034","2024","COM","2022","470","3","473","2024-12-30"
"17035","2024","COM","2022","104","4","108","2024-12-30"
"17036","2024","COM","2022","785","13","798","2024-12-30"
"17037","2024","COM","2022","654","9","663","2024-12-30"
"17038","2024","COM","2022","689","6","695","2024-12-30"
"17039","2024","COM","2022","216","1","217","2024-12-30"
"17041","2024","COM","2022","1811","17","1828","2024-12-30"
"17042","2024","COM","2022","447","10","457","2024-12-30"
"17043","2024","COM","2022","761","12","773","2024-12-30"
"17044","2024","COM","2022","1163","22","1185","2024-12-30"
"17045","2024","COM","2022","1003","10","1013","2024-12-30"
"17046","2024","COM","2022","363","6","369","2024-12-30"
"17047","2024","COM","2022","240","1","241","2024-12-30"
"17048","2024","COM","2022","330","5","335","2024-12-30"
"17049","2024","COM","2022","77","2","79","2024-12-30"
"17050","2024","COM","2022","519","145","664","2024-12-30"
"17051","2024","COM","2022","2177","35","2212","2024-12-30"
"17052","2024","COM","2022","713","5","718","2024-12-30"
"17053","2024","COM","2022","1313","24","1337","2024-12-30"
"17054","2024","COM","2022","203","9","212","2024-12-30"
"17055","2024","COM","2022","336","4","340","2024-12-30"
"17056","2024","COM","2022","632","9","641","2024-12-30"
"17057","2024","COM","2022","910","17","927","2024-12-30"
"17058","2024","COM","2022","3515","137","3652","2024-12-30"
"17059","2024","COM","2022","1441","29","1470","2024-12-30"
"17060","2024","COM","2022","230","4","234","2024-12-30"
"17061","2024","COM","2022","140","2","142","2024-12-30"
"17062","2024","COM","2022","228","1","229","2024-12-30"
"17063","2024","COM","2022","473","11","484","2024-12-30"
"17064","2024","COM","2022","3060","55","3115","2024-12-30"
"17065","2024","COM","2022","1891","55","1946","2024-12-30"
"17066","2024","COM","2022","225","3","228","2024-12-30"
"17067","2024","COM","2022","170","4","174","2024-12-30"
"17068","2024","COM","2022","238","0","238","2024-12-30"
"17069","2024","COM","2022","219","4","223","2024-12-30"
"17070","2024","COM","2022","978","16","994","2024-12-30"
"17071","2024","COM","2022","516","7","523","2024-12-30"
"17072","2024","COM","2022","1337","11","1348","2024-12-30"
"17073","2024","COM","2022","1313","41","1354","2024-12-30"
"17074","2024","COM","2022","1079","8","1087","2024-12-30"
"17075","2024","COM","2022","1470","24","1494","2024-12-30"
"17076","2024","COM","2022","326","8","334","2024-12-30"
"17077","2024","COM","2022","1289","19","1308","2024-12-30"
"17078","2024","COM","2022","526","7","533","2024-12-30"
"17079","2024","COM","2022","1652","35","1687","2024-12-30"
"17080","2024","COM","2022","985","10","995","2024-12-30"
"17081","2024","COM","2022","369","7","376","2024-12-30"
"17082","2024","COM","2022","493","16","509","2024-12-30"
"17083","2024","COM","2022","637","17","654","2024-12-30"
"17084","2024","COM","2022","687","14","701","2024-12-30"
"17085","2024","COM","2022","419","7","426","2024-12-30"
"17086","2024","COM","2022","3634","83","3717","2024-12-30"
"17087","2024","COM","2022","214","1","215","2024-12-30"
"17089","2024","COM","2022","1007","27","1034","2024-12-30"
"17091","2024","COM","2022","2014","26","2040","2024-12-30"
"17092","2024","COM","2022","164","4","168","2024-12-30"
"17093","2024","COM","2022","4359","83","4442","2024-12-30"
"17094","2024","COM","2022","6440","98","6538","2024-12-30"
"17095","2024","COM","2022","217","6","223","2024-12-30"
"17096","2024","COM","2022","70","0","70","2024-12-30"
"17097","2024","COM","2022","836","29","865","2024-12-30"
"17098","2024","COM","2022","595","11","606","2024-12-30"
"17099","2024","COM","2022","694","9","703","2024-12-30"
"17100","2024","COM","2022","1135","13","1148","2024-12-30"
"17101","2024","COM","2022","340","6","346","2024-12-30"
"17102","2024","COM","2022","1274","36","1310","2024-12-30"
"17104","2024","COM","2022","1087","99","1186","2024-12-30"
"17105","2024","COM","2022","309","2","311","2024-12-30"
"17106","2024","COM","2022","321","2","323","2024-12-30"
"17107","2024","COM","2022","1560","21","1581","2024-12-30"
"17108","2024","COM","2022","405","17","422","2024-12-30"
"17109","2024","COM","2022","1423","19","1442","2024-12-30"
"17110","2024","COM","2022","1026","8","1034","2024-12-30"
"17111","2024","COM","2022","847","11","858","2024-12-30"
"17112","2024","COM","2022","744","12","756","2024-12-30"
"17113","2024","COM","2022","708","9","717","2024-12-30"
"17114","2024","COM","2022","196","2","198","2024-12-30"
"17115","2024","COM","2022","301","8","309","2024-12-30"
"17116","2024","COM","2022","235","5","240","2024-12-30"
"17117","2024","COM","2022","136","1","137","2024-12-30"
"17118","2024","COM","2022","328","3","331","2024-12-30"
"17119","2024","COM","2022","1278","22","1300","2024-12-30"
"17120","2024","COM","2022","1969","28","1997","2024-12-30"
"17121","2024","COM","2022","1112","17","1129","2024-12-30"
"17122","2024","COM","2022","227","1","228","2024-12-30"
"17124","2024","COM","2022","442","5","447","2024-12-30"
"17125","2024","COM","2022","454","11","465","2024-12-30"
"17126","2024","COM","2022","311","4","315","2024-12-30"
"17127","2024","COM","2022","2081","27","2108","2024-12-30"
"17128","2024","COM","2022","717","13","730","2024-12-30"
"17129","2024","COM","2022","413","6","419","2024-12-30"
"17130","2024","COM","2022","484","14","498","2024-12-30"
"17131","2024","COM","2022","2223","32","2255","2024-12-30"
"17132","2024","COM","2022","648","16","664","2024-12-30"
"17133","2024","COM","2022","859","57","916","2024-12-30"
"17134","2024","COM","2022","442","8","450","2024-12-30"
"17135","2024","COM","2022","225","2","227","2024-12-30"
"17136","2024","COM","2022","1377","16","1393","2024-12-30"
"17137","2024","COM","2022","223","3","226","2024-12-30"
"17138","2024","COM","2022","271","7","278","2024-12-30"
"17139","2024","COM","2022","373","4","377","2024-12-30"
"17140","2024","COM","2022","3187","65","3252","2024-12-30"
"17141","2024","COM","2022","483","9","492","2024-12-30"
"17142","2024","COM","2022","6084","156","6240","2024-12-30"
"17143","2024","COM","2022","705","17","722","2024-12-30"
"17145","2024","COM","2022","482","9","491","2024-12-30"
"17146","2024","COM","2022","3701","70","3771","2024-12-30"
"17147","2024","COM","2022","1380","28","1408","2024-12-30"
"17148","2024","COM","2022","445","10","455","2024-12-30"
"17149","2024","COM","2022","58","1","59","2024-12-30"
"17150","2024","COM","2022","533","7","540","2024-12-30"
"17151","2024","COM","2022","909","14","923","2024-12-30"
"17152","2024","COM","2022","925","10","935","2024-12-30"
"17153","2024","COM","2022","2132","34","2166","2024-12-30"
"17154","2024","COM","2022","733","11","744","2024-12-30"
"17155","2024","COM","2022","2763","44","2807","2024-12-30"
"17156","2024","COM","2022","120","2","122","2024-12-30"
"17157","2024","COM","2022","168","2","170","2024-12-30"
"17158","2024","COM","2022","1459","16","1475","2024-12-30"
"17159","2024","COM","2022","361","2","363","2024-12-30"
"17160","2024","COM","2022","427","13","440","2024-12-30"
"17161","2024","COM","2022","3131","52","3183","2024-12-30"
"17162","2024","COM","2022","224","2","226","2024-12-30"
"17163","2024","COM","2022","511","9","520","2024-12-30"
"17164","2024","COM","2022","2313","55","2368","2024-12-30"
"17165","2024","COM","2022","392","5","397","2024-12-30"
"17166","2024","COM","2022","1323","19","1342","2024-12-30"
"17167","2024","COM","2022","760","11","771","2024-12-30"
"17168","2024","COM","2022","4124","77","4201","2024-12-30"
"17171","2024","COM","2022","783","12","795","2024-12-30"
"17172","2024","COM","2022","3033","35","3068","2024-12-30"
"17173","2024","COM","2022","220","4","224","2024-12-30"
"17174","2024","COM","2022","889","12","901","2024-12-30"
"17175","2024","COM","2022","647","8","655","2024-12-30"
"17176","2024","COM","2022","103","4","107","2024-12-30"
"17177","2024","COM","2022","119","0","119","2024-12-30"
"17178","2024","COM","2022","77","2","79","2024-12-30"
"17179","2024","COM","2022","1759","103","1862","2024-12-30"
"17180","2024","COM","2022","107","3","110","2024-12-30"
"17181","2024","COM","2022","310","3","313","2024-12-30"
"17182","2024","COM","2022","568","5","573","2024-12-30"
"17183","2024","COM","2022","951","13","964","2024-12-30"
"17184","2024","COM","2022","598","12","610","2024-12-30"
"17185","2024","COM","2022","2115","36","2151","2024-12-30"
"17186","2024","COM","2022","1040","9","1049","2024-12-30"
"17187","2024","COM","2022","479","18","497","2024-12-30"
"17188","2024","COM","2022","452","10","462","2024-12-30"
"17190","2024","COM","2022","2953","47","3000","2024-12-30"
"17191","2024","COM","2022","427","9","436","2024-12-30"
"17192","2024","COM","2022","876","21","897","2024-12-30"
"17193","2024","COM","2022","2591","57","2648","2024-12-30"
"17194","2024","COM","2022","3447","76","3523","2024-12-30"
"17195","2024","COM","2022","272","3","275","2024-12-30"
"17196","2024","COM","2022","548","14","562","2024-12-30"
"17197","2024","COM","2022","3576","188","3764","2024-12-30"
"17198","2024","COM","2022","314","6","320","2024-12-30"
"17199","2024","COM","2022","153","0","153","2024-12-30"
"17200","2024","COM","2022","7594","147","7741","2024-12-30"
"17201","2024","COM","2022","494","5","499","2024-12-30"
"17202","2024","COM","2022","575","13","588","2024-12-30"
"17203","2024","COM","2022","798","12","810","2024-12-30"
"17204","2024","COM","2022","301","6","307","2024-12-30"
"17205","2024","COM","2022","382","7","389","2024-12-30"
"17206","2024","COM","2022","284","3","287","2024-12-30"
"17207","2024","COM","2022","742","11","753","2024-12-30"
"17208","2024","COM","2022","1061","13","1074","2024-12-30"
"17209","2024","COM","2022","268","5","273","2024-12-30"
"17210","2024","COM","2022","511","5","516","2024-12-30"
"17211","2024","COM","2022","761","11","772","2024-12-30"
"17212","2024","COM","2022","172","2","174","2024-12-30"
"17213","2024","COM","2022","155","0","155","2024-12-30"
"17214","2024","COM","2022","513","11","524","2024-12-30"
"17215","2024","COM","2022","43","1","44","2024-12-30"
"17216","2024","COM","2022","1013","14","1027","2024-12-30"
"17217","2024","COM","2022","296","9","305","2024-12-30"
"17218","2024","COM","2022","4487","69","4556","2024-12-30"
"17219","2024","COM","2022","6148","103","6251","2024-12-30"
"17220","2024","COM","2022","412","11","423","2024-12-30"
"17221","2024","COM","2022","956","20","976","2024-12-30"
"17222","2024","COM","2022","3185","81","3266","2024-12-30"
"17223","2024","COM","2022","183","4","187","2024-12-30"
"17224","2024","COM","2022","2202","76","2278","2024-12-30"
"17225","2024","COM","2022","2184","30","2214","2024-12-30"
"17226","2024","COM","2022","990","15","1005","2024-12-30"
"17227","2024","COM","2022","236","4","240","2024-12-30"
"17228","2024","COM","2022","3041","72","3113","2024-12-30"
"17229","2024","COM","2022","235","3","238","2024-12-30"
"17230","2024","COM","2022","3165","73","3238","2024-12-30"
"17231","2024","COM","2022","104","1","105","2024-12-30"
"17232","2024","COM","2022","1544","23","1567","2024-12-30"
"17233","2024","COM","2022","329","5","334","2024-12-30"
"17234","2024","COM","2022","354","8","362","2024-12-30"
"17235","2024","COM","2022","699","12","711","2024-12-30"
"17236","2024","COM","2022","1532","16","1548","2024-12-30"
"17237","2024","COM","2022","592","4","596","2024-12-30"
"17239","2024","COM","2022","446","6","452","2024-12-30"
"17240","2024","COM","2022","3226","53","3279","2024-12-30"
"17241","2024","COM","2022","1636","21","1657","2024-12-30"
"17242","2024","COM","2022","871","14","885","2024-12-30"
"17243","2024","COM","2022","1263","16","1279","2024-12-30"
"17244","2024","COM","2022","686","9","695","2024-12-30"
"17245","2024","COM","2022","940","13","953","2024-12-30"
"17246","2024","COM","2022","538","6","544","2024-12-30"
"17247","2024","COM","2022","867","13","880","2024-12-30"
"17248","2024","COM","2022","911","18","929","2024-12-30"
"17249","2024","COM","2022","170","2","172","2024-12-30"
"17250","2024","COM","2022","489","12","501","2024-12-30"
"17252","2024","COM","2022","313","6","319","2024-12-30"
"17253","2024","COM","2022","1357","18","1375","2024-12-30"
"17254","2024","COM","2022","204","2","206","2024-12-30"
"17255","2024","COM","2022","795","14","809","2024-12-30"
"17256","2024","COM","2022","326","9","335","2024-12-30"
"17257","2024","COM","2022","667","5","672","2024-12-30"
"17258","2024","COM","2022","316","5","321","2024-12-30"
"17259","2024","COM","2022","160","2","162","2024-12-30"
"17260","2024","COM","2022","408","14","422","2024-12-30"
"17261","2024","COM","2022","346","10","356","2024-12-30"
"17262","2024","COM","2022","1213","20","1233","2024-12-30"
"17263","2024","COM","2022","577","12","589","2024-12-30"
"17264","2024","COM","2022","5805","74","5879","2024-12-30"
"17265","2024","COM","2022","1224","16","1240","2024-12-30"
"17266","2024","COM","2022","724","6","730","2024-12-30"
"17267","2024","COM","2022","1259","19","1278","2024-12-30"
"17268","2024","COM","2022","187","1","188","2024-12-30"
"17269","2024","COM","2022","715","6","721","2024-12-30"
"17270","2024","COM","2022","611","13","624","2024-12-30"
"17271","2024","COM","2022","327","7","334","2024-12-30"
"17273","2024","COM","2022","959","16","975","2024-12-30"
"17274","2024","COM","2022","8802","178","8980","2024-12-30"
"17275","2024","COM","2022","799","27","826","2024-12-30"
"17276","2024","COM","2022","71","1","72","2024-12-30"
"17277","2024","COM","2022","1029","80","1109","2024-12-30"
"17278","2024","COM","2022","775","13","788","2024-12-30"
"17279","2024","COM","2022","666","14","680","2024-12-30"
"17280","2024","COM","2022","817","13","830","2024-12-30"
"17281","2024","COM","2022","161","3","164","2024-12-30"
"17282","2024","COM","2022","212","2","214","2024-12-30"
"17283","2024","COM","2022","4308","256","4564","2024-12-30"
"17284","2024","COM","2022","1793","287","2080","2024-12-30"
"17285","2024","COM","2022","1170","29","1199","2024-12-30"
"17286","2024","COM","2022","582","6","588","2024-12-30"
"17287","2024","COM","2022","288","2","290","2024-12-30"
"17288","2024","COM","2022","312","6","318","2024-12-30"
"17289","2024","COM","2022","438","13","451","2024-12-30"
"17290","2024","COM","2022","286","7","293","2024-12-30"
"17291","2024","COM","2022","6668","123","6791","2024-12-30"
"17292","2024","COM","2022","521","5","526","2024-12-30"
"17293","2024","COM","2022","723","13","736","2024-12-30"
"17294","2024","COM","2022","184","3","187","2024-12-30"
"17295","2024","COM","2022","773","18","791","2024-12-30"
"17296","2024","COM","2022","1057","16","1073","2024-12-30"
"17297","2024","COM","2022","2428","53","2481","2024-12-30"
"17298","2024","COM","2022","977","22","999","2024-12-30"
"17299","2024","COM","2022","23188","630","23818","2024-12-30"
"17300","2024","COM","2022","79961","2025","81986","2024-12-30"
"17301","2024","COM","2022","83","1","84","2024-12-30"
"17302","2024","COM","2022","623","10","633","2024-12-30"
"17303","2024","COM","2022","1005","12","1017","2024-12-30"
"17304","2024","COM","2022","503","4","507","2024-12-30"
"17305","2024","COM","2022","427","5","432","2024-12-30"
"17306","2024","COM","2022","19322","530","19852","2024-12-30"
"17307","2024","COM","2022","1413","31","1444","2024-12-30"
"17308","2024","COM","2022","2774","66","2840","2024-12-30"
"17309","2024","COM","2022","1884","41","1925","2024-12-30"
"17310","2024","COM","2022","1220","17","1237","2024-12-30"
"17311","2024","COM","2022","1503","22","1525","2024-12-30"
"17312","2024","COM","2022","840","8","848","2024-12-30"
"17313","2024","COM","2022","388","14","402","2024-12-30"
"17314","2024","COM","2022","894","18","912","2024-12-30"
"17315","2024","COM","2022","1405","23","1428","2024-12-30"
"17316","2024","COM","2022","388","9","397","2024-12-30"
"17317","2024","COM","2022","575","5","580","2024-12-30"
"17318","2024","COM","2022","712","13","725","2024-12-30"
"17319","2024","COM","2022","110","1","111","2024-12-30"
"17320","2024","COM","2022","416","6","422","2024-12-30"
"17321","2024","COM","2022","346","8","354","2024-12-30"
"17322","2024","COM","2022","683","6","689","2024-12-30"
"17323","2024","COM","2022","1346","27","1373","2024-12-30"
"17324","2024","COM","2022","113","0","113","2024-12-30"
"17325","2024","COM","2022","501","8","509","2024-12-30"
"17326","2024","COM","2022","285","3","288","2024-12-30"
"17327","2024","COM","2022","322","2","324","2024-12-30"
"17328","2024","COM","2022","907","12","919","2024-12-30"
"17329","2024","COM","2022","390","2","392","2024-12-30"
"17330","2024","COM","2022","1364","17","1381","2024-12-30"
"17331","2024","COM","2022","1252","70","1322","2024-12-30"
"17332","2024","COM","2022","407","3","410","2024-12-30"
"17333","2024","COM","2022","5093","99","5192","2024-12-30"
"17334","2024","COM","2022","235","3","238","2024-12-30"
"17335","2024","COM","2022","281","4","285","2024-12-30"
"17336","2024","COM","2022","2840","72","2912","2024-12-30"
"17337","2024","COM","2022","4052","57","4109","2024-12-30"
"17338","2024","COM","2022","1869","21","1890","2024-12-30"
"17339","2024","COM","2022","1298","125","1423","2024-12-30"
"17340","2024","COM","2022","1498","93","1591","2024-12-30"
"17341","2024","COM","2022","186","3","189","2024-12-30"
"17342","2024","COM","2022","406","10","416","2024-12-30"
"17343","2024","COM","2022","144","3","147","2024-12-30"
"17344","2024","COM","2022","1350","24","1374","2024-12-30"
"17345","2024","COM","2022","298","13","311","2024-12-30"
"17346","2024","COM","2022","1485","24","1509","2024-12-30"
"17347","2024","COM","2022","6679","423","7102","2024-12-30"
"17348","2024","COM","2022","698","9","707","2024-12-30"
"17349","2024","COM","2022","3050","46","3096","2024-12-30"
"17350","2024","COM","2022","857","17","874","2024-12-30"
"17351","2024","COM","2022","2100","29","2129","2024-12-30"
"17353","2024","COM","2022","2285","60","2345","2024-12-30"
"17354","2024","COM","2022","672","15","687","2024-12-30"
"17355","2024","COM","2022","527","8","535","2024-12-30"
"17356","2024","COM","2022","312","4","316","2024-12-30"
"17357","2024","COM","2022","533","9","542","2024-12-30"
"17358","2024","COM","2022","298","5","303","2024-12-30"
"17359","2024","COM","2022","1244","29","1273","2024-12-30"
"17360","2024","COM","2022","3392","86","3478","2024-12-30"
"17361","2024","COM","2022","110","5","115","2024-12-30"
"17362","2024","COM","2022","301","7","308","2024-12-30"
"17363","2024","COM","2022","549","8","557","2024-12-30"
"17364","2024","COM","2022","428","13","441","2024-12-30"
"17365","2024","COM","2022","471","8","479","2024-12-30"
"17366","2024","COM","2022","459","5","464","2024-12-30"
"17367","2024","COM","2022","152","4","156","2024-12-30"
"17369","2024","COM","2022","2309","23","2332","2024-12-30"
"17372","2024","COM","2022","90","0","90","2024-12-30"
"17373","2024","COM","2022","2367","44","2411","2024-12-30"
"17374","2024","COM","2022","225","6","231","2024-12-30"
"17375","2024","COM","2022","1214","18","1232","2024-12-30"
"17376","2024","COM","2022","2133","32","2165","2024-12-30"
"17377","2024","COM","2022","137","5","142","2024-12-30"
"17378","2024","COM","2022","417","4","421","2024-12-30"
"17379","2024","COM","2022","214","4","218","2024-12-30"
"17380","2024","COM","2022","3879","68","3947","2024-12-30"
"17381","2024","COM","2022","214","3","217","2024-12-30"
"17382","2024","COM","2022","564","11","575","2024-12-30"
"17383","2024","COM","2022","347","4","351","2024-12-30"
"17384","2024","COM","2022","268","2","270","2024-12-30"
"17385","2024","COM","2022","6665","99","6764","2024-12-30"
"17386","2024","COM","2022","335","10","345","2024-12-30"
"17387","2024","COM","2022","1988","29","2017","2024-12-30"
"17388","2024","COM","2022","263","1","264","2024-12-30"
"17389","2024","COM","2022","578","8","586","2024-12-30"
"17390","2024","COM","2022","114","1","115","2024-12-30"
"17391","2024","COM","2022","2394","51","2445","2024-12-30"
"17393","2024","COM","2022","1777","23","1800","2024-12-30"
"17394","2024","COM","2022","910","15","925","2024-12-30"
"17395","2024","COM","2022","514","9","523","2024-12-30"
"17396","2024","COM","2022","1885","28","1913","2024-12-30"
"17397","2024","COM","2022","2458","100","2558","2024-12-30"
"17398","2024","COM","2022","166","3","169","2024-12-30"
"17400","2024","COM","2022","648","14","662","2024-12-30"
"17401","2024","COM","2022","93","3","96","2024-12-30"
"17402","2024","COM","2022","162","2","164","2024-12-30"
"17403","2024","COM","2022","767","14","781","2024-12-30"
"17404","2024","COM","2022","684","20","704","2024-12-30"
"17405","2024","COM","2022","205","1","206","2024-12-30"
"17406","2024","COM","2022","420","4","424","2024-12-30"
"17407","2024","COM","2022","5016","101","5117","2024-12-30"
"17408","2024","COM","2022","919","15","934","2024-12-30"
"17409","2024","COM","2022","3417","62","3479","2024-12-30"
"17410","2024","COM","2022","574","9","583","2024-12-30"
"17411","2024","COM","2022","1118","20","1138","2024-12-30"
"17412","2024","COM","2022","628","15","643","2024-12-30"
"17413","2024","COM","2022","1411","24","1435","2024-12-30"
"17414","2024","COM","2022","5531","128","5659","2024-12-30"
"17415","2024","COM","2022","25312","1403","26715","2024-12-30"
"17416","2024","COM","2022","57","2","59","2024-12-30"
"17417","2024","COM","2022","164","3","167","2024-12-30"
"17418","2024","COM","2022","609","17","626","2024-12-30"
"17420","2024","COM","2022","2427","65","2492","2024-12-30"
"17421","2024","COM","2022","7314","112","7426","2024-12-30"
"17422","2024","COM","2022","91","1","92","2024-12-30"
"17423","2024","COM","2022","68","1","69","2024-12-30"
"17424","2024","COM","2022","389","3","392","2024-12-30"
"17425","2024","COM","2022","2532","44","2576","2024-12-30"
"17426","2024","COM","2022","275","3","278","2024-12-30"
"17427","2024","COM","2022","213","4","217","2024-12-30"
"17428","2024","COM","2022","503","11","514","2024-12-30"
"17429","2024","COM","2022","3935","48","3983","2024-12-30"
"17430","2024","COM","2022","419","9","428","2024-12-30"
"17431","2024","COM","2022","742","18","760","2024-12-30"
"17432","2024","COM","2022","374","12","386","2024-12-30"
"17433","2024","COM","2022","214","4","218","2024-12-30"
"17434","2024","COM","2022","6861","168","7029","2024-12-30"
"17435","2024","COM","2022","191","3","194","2024-12-30"
"17436","2024","COM","2022","782","26","808","2024-12-30"
"17437","2024","COM","2022","83","1","84","2024-12-30"
"17438","2024","COM","2022","296","7","303","2024-12-30"
"17439","2024","COM","2022","772","15","787","2024-12-30"
"17440","2024","COM","2022","381","11","392","2024-12-30"
"17441","2024","COM","2022","1144","22","1166","2024-12-30"
"17442","2024","COM","2022","387","7","394","2024-12-30"
"17443","2024","COM","2022","1874","48","1922","2024-12-30"
"17444","2024","COM","2022","1702","261","1963","2024-12-30"
"17445","2024","COM","2022","332","9","341","2024-12-30"
"17446","2024","COM","2022","470","6","476","2024-12-30"
"17447","2024","COM","2022","2085","29","2114","2024-12-30"
"17448","2024","COM","2022","1190","14","1204","2024-12-30"
"17449","2024","COM","2022","8248","112","8360","2024-12-30"
"17450","2024","COM","2022","252","2","254","2024-12-30"
"17451","2024","COM","2022","544","10","554","2024-12-30"
"17452","2024","COM","2022","4543","54","4597","2024-12-30"
"17453","2024","COM","2022","1505","30","1535","2024-12-30"
"17454","2024","COM","2022","383","6","389","2024-12-30"
"17455","2024","COM","2022","683","13","696","2024-12-30"
"17457","2024","COM","2022","1196","17","1213","2024-12-30"
"17458","2024","COM","2022","191","0","191","2024-12-30"
"17459","2024","COM","2022","545","11","556","2024-12-30"
"17460","2024","COM","2022","847","20","867","2024-12-30"
"17461","2024","COM","2022","4030","74","4104","2024-12-30"
"17462","2024","COM","2022","771","15","786","2024-12-30"
"17463","2024","COM","2022","1285","31","1316","2024-12-30"
"17464","2024","COM","2022","168","6","174","2024-12-30"
"17465","2024","COM","2022","610","9","619","2024-12-30"
"17466","2024","COM","2022","2375","35","2410","2024-12-30"
"17467","2024","COM","2022","244","2","246","2024-12-30"
"17468","2024","COM","2022","159","2","161","2024-12-30"
"17469","2024","COM","2022","578","13","591","2024-12-30"
"17470","2024","COM","2022","240","3","243","2024-12-30"
"17471","2024","COM","2022","203","2","205","2024-12-30"
"17472","2024","COM","2022","2241","30","2271","2024-12-30"
"17473","2024","COM","2022","125","1","126","2024-12-30"
"17474","2024","COM","2022","745","12","757","2024-12-30"
"17476","2024","COM","2022","270","4","274","2024-12-30"
"17477","2024","COM","2022","108","1","109","2024-12-30"
"17478","2024","COM","2022","67","0","67","2024-12-30"
"17479","2024","COM","2022","298","1","299","2024-12-30"
"17480","2024","COM","2022","738","16","754","2024-12-30"
"17481","2024","COM","2022","172","3","175","2024-12-30"
"17482","2024","COM","2022","657","16","673","2024-12-30"
"17483","2024","COM","2022","1508","25","1533","2024-12-30"
"17484","2024","COM","2022","1754","15","1769","2024-12-30"
"17485","2024","COM","2022","1096","14","1110","2024-12-30"
"17486","2024","COM","2022","695","7","702","2024-12-30"
"18001","2024","COM","2022","332","6","338","2024-12-30"
"18002","2024","COM","2022","191","3","194","2024-12-30"
"18003","2024","COM","2022","1871","29","1900","2024-12-30"
"18004","2024","COM","2022","1130","16","1146","2024-12-30"
"18005","2024","COM","2022","1052","19","1071","2024-12-30"
"18006","2024","COM","2022","251","3","254","2024-12-30"
"18007","2024","COM","2022","67","2","69","2024-12-30"
"18008","2024","COM","2022","488","10","498","2024-12-30"
"18009","2024","COM","2022","269","9","278","2024-12-30"
"18010","2024","COM","2022","203","4","207","2024-12-30"
"18011","2024","COM","2022","2040","27","2067","2024-12-30"
"18012","2024","COM","2022","439","4","443","2024-12-30"
"18013","2024","COM","2022","301","6","307","2024-12-30"
"18014","2024","COM","2022","152","4","156","2024-12-30"
"18015","2024","COM","2022","5464","90","5554","2024-12-30"
"18016","2024","COM","2022","402","10","412","2024-12-30"
"18017","2024","COM","2022","284","2","286","2024-12-30"
"18018","2024","COM","2022","2908","41","2949","2024-12-30"
"18019","2024","COM","2022","453","8","461","2024-12-30"
"18020","2024","COM","2022","841","13","854","2024-12-30"
"18021","2024","COM","2022","246","2","248","2024-12-30"
"18022","2024","COM","2022","336","7","343","2024-12-30"
"18023","2024","COM","2022","1610","55","1665","2024-12-30"
"18024","2024","COM","2022","105","1","106","2024-12-30"
"18025","2024","COM","2022","598","11","609","2024-12-30"
"18026","2024","COM","2022","990","26","1016","2024-12-30"
"18027","2024","COM","2022","636","69","705","2024-12-30"
"18028","2024","COM","2022","1171","16","1187","2024-12-30"
"18029","2024","COM","2022","293","4","297","2024-12-30"
"18030","2024","COM","2022","1002","17","1019","2024-12-30"
"18031","2024","COM","2022","565","4","569","2024-12-30"
"18032","2024","COM","2022","1389","35","1424","2024-12-30"
"18033","2024","COM","2022","64238","2039","66277","2024-12-30"
"18034","2024","COM","2022","285","10","295","2024-12-30"
"18035","2024","COM","2022","969","21","990","2024-12-30"
"18036","2024","COM","2022","507","11","518","2024-12-30"
"18037","2024","COM","2022","972","16","988","2024-12-30"
"18038","2024","COM","2022","569","5","574","2024-12-30"
"18039","2024","COM","2022","305","7","312","2024-12-30"
"18040","2024","COM","2022","357","3","360","2024-12-30"
"18041","2024","COM","2022","204","2","206","2024-12-30"
"18042","2024","COM","2022","329","5","334","2024-12-30"
"18043","2024","COM","2022","191","1","192","2024-12-30"
"18044","2024","COM","2022","398","4","402","2024-12-30"
"18045","2024","COM","2022","380","10","390","2024-12-30"
"18046","2024","COM","2022","154","4","158","2024-12-30"
"18047","2024","COM","2022","610","9","619","2024-12-30"
"18048","2024","COM","2022","385","6","391","2024-12-30"
"18049","2024","COM","2022","490","11","501","2024-12-30"
"18050","2024","COM","2022","3687","78","3765","2024-12-30"
"18051","2024","COM","2022","130","2","132","2024-12-30"
"18052","2024","COM","2022","999","13","1012","2024-12-30"
"18053","2024","COM","2022","287","7","294","2024-12-30"
"18054","2024","COM","2022","235","2","237","2024-12-30"
"18055","2024","COM","2022","899","22","921","2024-12-30"
"18056","2024","COM","2022","234","5","239","2024-12-30"
"18057","2024","COM","2022","1666","17","1683","2024-12-30"
"18058","2024","COM","2022","1362","11","1373","2024-12-30"
"18059","2024","COM","2022","920","10","930","2024-12-30"
"18060","2024","COM","2022","46","2","48","2024-12-30"
"18061","2024","COM","2022","84","2","86","2024-12-30"
"18062","2024","COM","2022","264","1","265","2024-12-30"
"18063","2024","COM","2022","153","3","156","2024-12-30"
"18064","2024","COM","2022","225","0","225","2024-12-30"
"18065","2024","COM","2022","762","10","772","2024-12-30"
"18066","2024","COM","2022","918","21","939","2024-12-30"
"18067","2024","COM","2022","709","9","718","2024-12-30"
"18068","2024","COM","2022","32","1","33","2024-12-30"
"18069","2024","COM","2022","410","9","419","2024-12-30"
"18070","2024","COM","2022","196","3","199","2024-12-30"
"18071","2024","COM","2022","34","0","34","2024-12-30"
"18072","2024","COM","2022","227","1","228","2024-12-30"
"18073","2024","COM","2022","199","6","205","2024-12-30"
"18074","2024","COM","2022","197","4","201","2024-12-30"
"18075","2024","COM","2022","1030","29","1059","2024-12-30"
"18076","2024","COM","2022","430","2","432","2024-12-30"
"18077","2024","COM","2022","376","9","385","2024-12-30"
"18078","2024","COM","2022","62","2","64","2024-12-30"
"18079","2024","COM","2022","425","6","431","2024-12-30"
"18080","2024","COM","2022","144","2","146","2024-12-30"
"18081","2024","COM","2022","385","3","388","2024-12-30"
"18082","2024","COM","2022","1018","28","1046","2024-12-30"
"18083","2024","COM","2022","777","5","782","2024-12-30"
"18084","2024","COM","2022","203","3","206","2024-12-30"
"18085","2024","COM","2022","248","5","253","2024-12-30"
"18086","2024","COM","2022","551","19","570","2024-12-30"
"18087","2024","COM","2022","3566","72","3638","2024-12-30"
"18088","2024","COM","2022","206","4","210","2024-12-30"
"18089","2024","COM","2022","447","7","454","2024-12-30"
"18090","2024","COM","2022","410","10","420","2024-12-30"
"18091","2024","COM","2022","255","6","261","2024-12-30"
"18092","2024","COM","2022","1014","11","1025","2024-12-30"
"18093","2024","COM","2022","134","0","134","2024-12-30"
"18094","2024","COM","2022","323","6","329","2024-12-30"
"18095","2024","COM","2022","156","6","162","2024-12-30"
"18096","2024","COM","2022","2052","35","2087","2024-12-30"
"18097","2024","COM","2022","1914","34","1948","2024-12-30"
"18098","2024","COM","2022","126","3","129","2024-12-30"
"18099","2024","COM","2022","220","9","229","2024-12-30"
"18100","2024","COM","2022","666","8","674","2024-12-30"
"18101","2024","COM","2022","292","10","302","2024-12-30"
"18102","2024","COM","2022","302","3","305","2024-12-30"
"18103","2024","COM","2022","1245","13","1258","2024-12-30"
"18104","2024","COM","2022","131","5","136","2024-12-30"
"18105","2024","COM","2022","469","17","486","2024-12-30"
"18106","2024","COM","2022","264","2","266","2024-12-30"
"18107","2024","COM","2022","119","2","121","2024-12-30"
"18108","2024","COM","2022","3187","34","3221","2024-12-30"
"18109","2024","COM","2022","1713","27","1740","2024-12-30"
"18110","2024","COM","2022","959","20","979","2024-12-30"
"18111","2024","COM","2022","182","1","183","2024-12-30"
"18112","2024","COM","2022","287","5","292","2024-12-30"
"18113","2024","COM","2022","174","5","179","2024-12-30"
"18114","2024","COM","2022","216","4","220","2024-12-30"
"18115","2024","COM","2022","775","8","783","2024-12-30"
"18116","2024","COM","2022","269","3","272","2024-12-30"
"18117","2024","COM","2022","491","6","497","2024-12-30"
"18118","2024","COM","2022","1306","30","1336","2024-12-30"
"18119","2024","COM","2022","206","5","211","2024-12-30"
"18120","2024","COM","2022","578","13","591","2024-12-30"
"18121","2024","COM","2022","95","4","99","2024-12-30"
"18122","2024","COM","2022","226","0","226","2024-12-30"
"18124","2024","COM","2022","282","3","285","2024-12-30"
"18125","2024","COM","2022","1095","29","1124","2024-12-30"
"18126","2024","COM","2022","1367","45","1412","2024-12-30"
"18127","2024","COM","2022","1325","20","1345","2024-12-30"
"18128","2024","COM","2022","171","0","171","2024-12-30"
"18129","2024","COM","2022","226","5","231","2024-12-30"
"18130","2024","COM","2022","301","5","306","2024-12-30"
"18132","2024","COM","2022","140","2","142","2024-12-30"
"18133","2024","COM","2022","1522","14","1536","2024-12-30"
"18134","2024","COM","2022","662","16","678","2024-12-30"
"18135","2024","COM","2022","228","6","234","2024-12-30"
"18136","2024","COM","2022","305","5","310","2024-12-30"
"18137","2024","COM","2022","476","11","487","2024-12-30"
"18138","2024","COM","2022","1934","30","1964","2024-12-30"
"18139","2024","COM","2022","647","12","659","2024-12-30"
"18140","2024","COM","2022","1347","24","1371","2024-12-30"
"18141","2024","COM","2022","6394","87","6481","2024-12-30"
"18142","2024","COM","2022","648","16","664","2024-12-30"
"18143","2024","COM","2022","357","5","362","2024-12-30"
"18144","2024","COM","2022","463","10","473","2024-12-30"
"18145","2024","COM","2022","1618","39","1657","2024-12-30"
"18146","2024","COM","2022","296","12","308","2024-12-30"
"18147","2024","COM","2022","196","3","199","2024-12-30"
"18148","2024","COM","2022","2649","65","2714","2024-12-30"
"18149","2024","COM","2022","538","8","546","2024-12-30"
"18150","2024","COM","2022","710","14","724","2024-12-30"
"18151","2024","COM","2022","323","10","333","2024-12-30"
"18152","2024","COM","2022","110","2","112","2024-12-30"
"18153","2024","COM","2022","274","3","277","2024-12-30"
"18154","2024","COM","2022","168","4","172","2024-12-30"
"18155","2024","COM","2022","417","3","420","2024-12-30"
"18156","2024","COM","2022","423","4","427","2024-12-30"
"18157","2024","COM","2022","815","25","840","2024-12-30"
"18158","2024","COM","2022","851","21","872","2024-12-30"
"18159","2024","COM","2022","768","20","788","2024-12-30"
"18160","2024","COM","2022","1412","20","1432","2024-12-30"
"18161","2024","COM","2022","225","4","229","2024-12-30"
"18162","2024","COM","2022","246","1","247","2024-12-30"
"18163","2024","COM","2022","257","3","260","2024-12-30"
"18164","2024","COM","2022","147","2","149","2024-12-30"
"18165","2024","COM","2022","1114","29","1143","2024-12-30"
"18166","2024","COM","2022","551","10","561","2024-12-30"
"18167","2024","COM","2022","292","4","296","2024-12-30"
"18168","2024","COM","2022","236","2","238","2024-12-30"
"18169","2024","COM","2022","234","3","237","2024-12-30"
"18170","2024","COM","2022","667","6","673","2024-12-30"
"18171","2024","COM","2022","242","6","248","2024-12-30"
"18172","2024","COM","2022","1637","27","1664","2024-12-30"
"18173","2024","COM","2022","273","3","276","2024-12-30"
"18174","2024","COM","2022","271","31","302","2024-12-30"
"18175","2024","COM","2022","605","9","614","2024-12-30"
"18176","2024","COM","2022","406","6","412","2024-12-30"
"18177","2024","COM","2022","50","0","50","2024-12-30"
"18178","2024","COM","2022","192","4","196","2024-12-30"
"18179","2024","COM","2022","968","16","984","2024-12-30"
"18180","2024","COM","2022","2104","50","2154","2024-12-30"
"18181","2024","COM","2022","533","15","548","2024-12-30"
"18182","2024","COM","2022","217","4","221","2024-12-30"
"18183","2024","COM","2022","154","2","156","2024-12-30"
"18184","2024","COM","2022","354","2","356","2024-12-30"
"18185","2024","COM","2022","221","5","226","2024-12-30"
"18186","2024","COM","2022","473","7","480","2024-12-30"
"18187","2024","COM","2022","522","13","535","2024-12-30"
"18188","2024","COM","2022","193","2","195","2024-12-30"
"18189","2024","COM","2022","481","5","486","2024-12-30"
"18190","2024","COM","2022","821","19","840","2024-12-30"
"18191","2024","COM","2022","175","4","179","2024-12-30"
"18192","2024","COM","2022","228","3","231","2024-12-30"
"18193","2024","COM","2022","203","2","205","2024-12-30"
"18194","2024","COM","2022","962","14","976","2024-12-30"
"18195","2024","COM","2022","188","1","189","2024-12-30"
"18196","2024","COM","2022","74","2","76","2024-12-30"
"18197","2024","COM","2022","9690","307","9997","2024-12-30"
"18198","2024","COM","2022","375","12","387","2024-12-30"
"18199","2024","COM","2022","251","1","252","2024-12-30"
"18200","2024","COM","2022","258","7","265","2024-12-30"
"18201","2024","COM","2022","757","14","771","2024-12-30"
"18202","2024","COM","2022","13","0","13","2024-12-30"
"18203","2024","COM","2022","94","1","95","2024-12-30"
"18204","2024","COM","2022","278","3","281","2024-12-30"
"18205","2024","COM","2022","9650","227","9877","2024-12-30"
"18206","2024","COM","2022","1569","35","1604","2024-12-30"
"18207","2024","COM","2022","6416","94","6510","2024-12-30"
"18208","2024","COM","2022","403","7","410","2024-12-30"
"18209","2024","COM","2022","435","18","453","2024-12-30"
"18210","2024","COM","2022","595","14","609","2024-12-30"
"18211","2024","COM","2022","722","18","740","2024-12-30"
"18212","2024","COM","2022","614","8","622","2024-12-30"
"18213","2024","COM","2022","4852","69","4921","2024-12-30"
"18214","2024","COM","2022","595","3","598","2024-12-30"
"18215","2024","COM","2022","136","1","137","2024-12-30"
"18216","2024","COM","2022","496","7","503","2024-12-30"
"18217","2024","COM","2022","166","4","170","2024-12-30"
"18218","2024","COM","2022","646","13","659","2024-12-30"
"18219","2024","COM","2022","511","8","519","2024-12-30"
"18220","2024","COM","2022","354","5","359","2024-12-30"
"18221","2024","COM","2022","285","5","290","2024-12-30"
"18223","2024","COM","2022","2525","38","2563","2024-12-30"
"18224","2024","COM","2022","303","1","304","2024-12-30"
"18225","2024","COM","2022","258","8","266","2024-12-30"
"18226","2024","COM","2022","466","16","482","2024-12-30"
"18227","2024","COM","2022","167","4","171","2024-12-30"
"18228","2024","COM","2022","215","4","219","2024-12-30"
"18229","2024","COM","2022","617","19","636","2024-12-30"
"18230","2024","COM","2022","272","4","276","2024-12-30"
"18231","2024","COM","2022","744","19","763","2024-12-30"
"18232","2024","COM","2022","249","2","251","2024-12-30"
"18233","2024","COM","2022","1410","30","1440","2024-12-30"
"18234","2024","COM","2022","440","2","442","2024-12-30"
"18235","2024","COM","2022","1114","18","1132","2024-12-30"
"18236","2024","COM","2022","133","2","135","2024-12-30"
"18237","2024","COM","2022","473","10","483","2024-12-30"
"18238","2024","COM","2022","121","4","125","2024-12-30"
"18240","2024","COM","2022","626","11","637","2024-12-30"
"18241","2024","COM","2022","1328","34","1362","2024-12-30"
"18242","2024","COM","2022","2941","37","2978","2024-12-30"
"18243","2024","COM","2022","438","2","440","2024-12-30"
"18244","2024","COM","2022","78","0","78","2024-12-30"
"18245","2024","COM","2022","476","12","488","2024-12-30"
"18246","2024","COM","2022","1111","22","1133","2024-12-30"
"18247","2024","COM","2022","710","10","720","2024-12-30"
"18248","2024","COM","2022","451","4","455","2024-12-30"
"18249","2024","COM","2022","403","14","417","2024-12-30"
"18250","2024","COM","2022","67","2","69","2024-12-30"
"18251","2024","COM","2022","62","2","64","2024-12-30"
"18252","2024","COM","2022","295","7","302","2024-12-30"
"18253","2024","COM","2022","457","11","468","2024-12-30"
"18254","2024","COM","2022","582","15","597","2024-12-30"
"18255","2024","COM","2022","968","215","1183","2024-12-30"
"18256","2024","COM","2022","337","4","341","2024-12-30"
"18257","2024","COM","2022","656","14","670","2024-12-30"
"18258","2024","COM","2022","685","11","696","2024-12-30"
"18259","2024","COM","2022","300","7","307","2024-12-30"
"18260","2024","COM","2022","88","2","90","2024-12-30"
"18261","2024","COM","2022","392","5","397","2024-12-30"
"18262","2024","COM","2022","319","14","333","2024-12-30"
"18263","2024","COM","2022","666","3","669","2024-12-30"
"18264","2024","COM","2022","78","0","78","2024-12-30"
"18265","2024","COM","2022","789","13","802","2024-12-30"
"18266","2024","COM","2022","224","7","231","2024-12-30"
"18267","2024","COM","2022","4034","90","4124","2024-12-30"
"18268","2024","COM","2022","410","10","420","2024-12-30"
"18269","2024","COM","2022","649","15","664","2024-12-30"
"18270","2024","COM","2022","694","22","716","2024-12-30"
"18271","2024","COM","2022","1569","34","1603","2024-12-30"
"18272","2024","COM","2022","605","15","620","2024-12-30"
"18273","2024","COM","2022","788","18","806","2024-12-30"
"18274","2024","COM","2022","318","9","327","2024-12-30"
"18275","2024","COM","2022","137","6","143","2024-12-30"
"18276","2024","COM","2022","184","2","186","2024-12-30"
"18277","2024","COM","2022","35","0","35","2024-12-30"
"18278","2024","COM","2022","544","10","554","2024-12-30"
"18279","2024","COM","2022","25254","453","25707","2024-12-30"
"18280","2024","COM","2022","707","20","727","2024-12-30"
"18281","2024","COM","2022","2061","27","2088","2024-12-30"
"18282","2024","COM","2022","563","14","577","2024-12-30"
"18283","2024","COM","2022","78","0","78","2024-12-30"
"18284","2024","COM","2022","215","3","218","2024-12-30"
"18285","2024","COM","2022","403","5","408","2024-12-30"
"18286","2024","COM","2022","445","9","454","2024-12-30"
"18287","2024","COM","2022","297","7","304","2024-12-30"
"18288","2024","COM","2022","248","7","255","2024-12-30"
"18289","2024","COM","2022","586","16","602","2024-12-30"
"18290","2024","COM","2022","582","15","597","2024-12-30"
"19001","2024","COM","2022","376","16","392","2024-12-30"
"19002","2024","COM","2022","367","10","377","2024-12-30"
"19003","2024","COM","2022","235","8","243","2024-12-30"
"19004","2024","COM","2022","730","17","747","2024-12-30"
"19005","2024","COM","2022","4050","97","4147","2024-12-30"
"19006","2024","COM","2022","103","2","105","2024-12-30"
"19007","2024","COM","2022","827","22","849","2024-12-30"
"19008","2024","COM","2022","209","3","212","2024-12-30"
"19009","2024","COM","2022","126","3","129","2024-12-30"
"19010","2024","COM","2022","2857","115","2972","2024-12-30"
"19011","2024","COM","2022","1206","13","1219","2024-12-30"
"19012","2024","COM","2022","207","4","211","2024-12-30"
"19013","2024","COM","2022","860","19","879","2024-12-30"
"19014","2024","COM","2022","219","3","222","2024-12-30"
"19015","2024","COM","2022","712","7","719","2024-12-30"
"19016","2024","COM","2022","307","4","311","2024-12-30"
"19017","2024","COM","2022","82","1","83","2024-12-30"
"19018","2024","COM","2022","152","4","156","2024-12-30"
"19019","2024","COM","2022","1310","18","1328","2024-12-30"
"19020","2024","COM","2022","115","8","123","2024-12-30"
"19021","2024","COM","2022","100","2","102","2024-12-30"
"19022","2024","COM","2022","222","2","224","2024-12-30"
"19023","2024","COM","2022","1281","25","1306","2024-12-30"
"19024","2024","COM","2022","487","23","510","2024-12-30"
"19025","2024","COM","2022","356","4","360","2024-12-30"
"19026","2024","COM","2022","246","4","250","2024-12-30"
"19027","2024","COM","2022","114","0","114","2024-12-30"
"19028","2024","COM","2022","2487","67","2554","2024-12-30"
"19029","2024","COM","2022","276","6","282","2024-12-30"
"19030","2024","COM","2022","967","17","984","2024-12-30"
"19031","2024","COM","2022","46769","1179","47948","2024-12-30"
"19033","2024","COM","2022","741","10","751","2024-12-30"
"19034","2024","COM","2022","208","11","219","2024-12-30"
"19035","2024","COM","2022","528","19","547","2024-12-30"
"19036","2024","COM","2022","1422","16","1438","2024-12-30"
"19037","2024","COM","2022","1158","27","1185","2024-12-30"
"19038","2024","COM","2022","1492","42","1534","2024-12-30"
"19039","2024","COM","2022","230","7","237","2024-12-30"
"19040","2024","COM","2022","150","4","154","2024-12-30"
"19041","2024","COM","2022","421","15","436","2024-12-30"
"19042","2024","COM","2022","615","18","633","2024-12-30"
"19043","2024","COM","2022","460","10","470","2024-12-30"
"19044","2024","COM","2022","260","3","263","2024-12-30"
"19045","2024","COM","2022","196","5","201","2024-12-30"
"19046","2024","COM","2022","113","1","114","2024-12-30"
"19047","2024","COM","2022","377","7","384","2024-12-30"
"19048","2024","COM","2022","348","10","358","2024-12-30"
"19049","2024","COM","2022","747","21","768","2024-12-30"
"19050","2024","COM","2022","413","8","421","2024-12-30"
"19051","2024","COM","2022","166","5","171","2024-12-30"
"19052","2024","COM","2022","49","1","50","2024-12-30"
"19053","2024","COM","2022","272","5","277","2024-12-30"
"19054","2024","COM","2022","214","5","219","2024-12-30"
"19055","2024","COM","2022","277","7","284","2024-12-30"
"19056","2024","COM","2022","411","10","421","2024-12-30"
"19057","2024","COM","2022","478","15","493","2024-12-30"
"19058","2024","COM","2022","385","11","396","2024-12-30"
"19059","2024","COM","2022","384","8","392","2024-12-30"
"19060","2024","COM","2022","648","14","662","2024-12-30"
"19061","2024","COM","2022","1283","20","1303","2024-12-30"
"19062","2024","COM","2022","1173","34","1207","2024-12-30"
"19063","2024","COM","2022","3042","97","3139","2024-12-30"
"19064","2024","COM","2022","71","2","73","2024-12-30"
"19065","2024","COM","2022","64","1","65","2024-12-30"
"19066","2024","COM","2022","1730","38","1768","2024-12-30"
"19067","2024","COM","2022","215","6","221","2024-12-30"
"19068","2024","COM","2022","707","18","725","2024-12-30"
"19069","2024","COM","2022","144","2","146","2024-12-30"
"19070","2024","COM","2022","309","10","319","2024-12-30"
"19071","2024","COM","2022","233","6","239","2024-12-30"
"19072","2024","COM","2022","2714","71","2785","2024-12-30"
"19073","2024","COM","2022","4336","734","5070","2024-12-30"
"19074","2024","COM","2022","51","1","52","2024-12-30"
"19075","2024","COM","2022","381","13","394","2024-12-30"
"19076","2024","COM","2022","409","10","419","2024-12-30"
"19077","2024","COM","2022","136","6","142","2024-12-30"
"19078","2024","COM","2022","408","8","416","2024-12-30"
"19079","2024","COM","2022","488","11","499","2024-12-30"
"19080","2024","COM","2022","684","11","695","2024-12-30"
"19081","2024","COM","2022","510","15","525","2024-12-30"
"19082","2024","COM","2022","1121","28","1149","2024-12-30"
"19083","2024","COM","2022","112","1","113","2024-12-30"
"19084","2024","COM","2022","258","9","267","2024-12-30"
"19085","2024","COM","2022","765","15","780","2024-12-30"
"19086","2024","COM","2022","327","5","332","2024-12-30"
"19087","2024","COM","2022","85","1","86","2024-12-30"
"19088","2024","COM","2022","48","1","49","2024-12-30"
"19089","2024","COM","2022","184","3","187","2024-12-30"
"19090","2024","COM","2022","99","2","101","2024-12-30"
"19091","2024","COM","2022","316","12","328","2024-12-30"
"19093","2024","COM","2022","951","34","985","2024-12-30"
"19094","2024","COM","2022","1147","25","1172","2024-12-30"
"19095","2024","COM","2022","136","5","141","2024-12-30"
"19096","2024","COM","2022","405","12","417","2024-12-30"
"19097","2024","COM","2022","135","1","136","2024-12-30"
"19098","2024","COM","2022","935","21","956","2024-12-30"
"19099","2024","COM","2022","224","4","228","2024-12-30"
"19100","2024","COM","2022","1189","26","1215","2024-12-30"
"19101","2024","COM","2022","1565","27","1592","2024-12-30"
"19102","2024","COM","2022","281","5","286","2024-12-30"
"19103","2024","COM","2022","66","4","70","2024-12-30"
"19104","2024","COM","2022","124","2","126","2024-12-30"
"19105","2024","COM","2022","504","15","519","2024-12-30"
"19106","2024","COM","2022","386","3","389","2024-12-30"
"19107","2024","COM","2022","1654","40","1694","2024-12-30"
"19108","2024","COM","2022","79","0","79","2024-12-30"
"19109","2024","COM","2022","226","3","229","2024-12-30"
"19110","2024","COM","2022","114","1","115","2024-12-30"
"19111","2024","COM","2022","102","2","104","2024-12-30"
"19112","2024","COM","2022","115","0","115","2024-12-30"
"19113","2024","COM","2022","657","34","691","2024-12-30"
"19114","2024","COM","2022","162","9","171","2024-12-30"
"19115","2024","COM","2022","293","7","300","2024-12-30"
"19116","2024","COM","2022","266","8","274","2024-12-30"
"19117","2024","COM","2022","688","24","712","2024-12-30"
"19118","2024","COM","2022","819","10","829","2024-12-30"
"19119","2024","COM","2022","152","1","153","2024-12-30"
"19120","2024","COM","2022","244","6","250","2024-12-30"
"19121","2024","COM","2022","2253","52","2305","2024-12-30"
"19122","2024","COM","2022","168","7","175","2024-12-30"
"19123","2024","COM","2022","7995","157","8152","2024-12-30"
"19124","2024","COM","2022","1542","20","1562","2024-12-30"
"19125","2024","COM","2022","853","14","867","2024-12-30"
"19126","2024","COM","2022","176","0","176","2024-12-30"
"19128","2024","COM","2022","284","7","291","2024-12-30"
"19129","2024","COM","2022","670","10","680","2024-12-30"
"19130","2024","COM","2022","446","6","452","2024-12-30"
"19131","2024","COM","2022","538","15","553","2024-12-30"
"19132","2024","COM","2022","136","1","137","2024-12-30"
"19133","2024","COM","2022","232","5","237","2024-12-30"
"19134","2024","COM","2022","726","15","741","2024-12-30"
"19135","2024","COM","2022","340","6","346","2024-12-30"
"19136","2024","COM","2022","2326","199","2525","2024-12-30"
"19137","2024","COM","2022","63","0","63","2024-12-30"
"19138","2024","COM","2022","1290","48","1338","2024-12-30"
"19139","2024","COM","2022","77","0","77","2024-12-30"
"19140","2024","COM","2022","630","18","648","2024-12-30"
"19141","2024","COM","2022","292","3","295","2024-12-30"
"19142","2024","COM","2022","133","1","134","2024-12-30"
"19143","2024","COM","2022","634","11","645","2024-12-30"
"19144","2024","COM","2022","251","5","256","2024-12-30"
"19145","2024","COM","2022","430","77","507","2024-12-30"
"19146","2024","COM","2022","2318","195","2513","2024-12-30"
"19147","2024","COM","2022","641","12","653","2024-12-30"
"19148","2024","COM","2022","1597","251","1848","2024-12-30"
"19149","2024","COM","2022","203","4","207","2024-12-30"
"19150","2024","COM","2022","351","16","367","2024-12-30"
"19151","2024","COM","2022","945","19","964","2024-12-30"
"19152","2024","COM","2022","478","8","486","2024-12-30"
"19153","2024","COM","2022","3737","82","3819","2024-12-30"
"19154","2024","COM","2022","321","9","330","2024-12-30"
"19155","2024","COM","2022","256","5","261","2024-12-30"
"19156","2024","COM","2022","167","2","169","2024-12-30"
"19157","2024","COM","2022","220","1","221","2024-12-30"
"19158","2024","COM","2022","167","1","168","2024-12-30"
"19159","2024","COM","2022","84","1","85","2024-12-30"
"19160","2024","COM","2022","199","2","201","2024-12-30"
"19161","2024","COM","2022","431","8","439","2024-12-30"
"19162","2024","COM","2022","1254","25","1279","2024-12-30"
"19163","2024","COM","2022","358","4","362","2024-12-30"
"19164","2024","COM","2022","831","12","843","2024-12-30"
"19165","2024","COM","2022","127","5","132","2024-12-30"
"19166","2024","COM","2022","93","1","94","2024-12-30"
"19167","2024","COM","2022","41","0","41","2024-12-30"
"19168","2024","COM","2022","86","1","87","2024-12-30"
"19169","2024","COM","2022","293","3","296","2024-12-30"
"19170","2024","COM","2022","235","10","245","2024-12-30"
"19171","2024","COM","2022","181","3","184","2024-12-30"
"19172","2024","COM","2022","116","1","117","2024-12-30"
"19173","2024","COM","2022","306","9","315","2024-12-30"
"19174","2024","COM","2022","127","1","128","2024-12-30"
"19175","2024","COM","2022","98","1","99","2024-12-30"
"19176","2024","COM","2022","1087","27","1114","2024-12-30"
"19177","2024","COM","2022","175","3","178","2024-12-30"
"19178","2024","COM","2022","1000","22","1022","2024-12-30"
"19179","2024","COM","2022","210","4","214","2024-12-30"
"19180","2024","COM","2022","705","18","723","2024-12-30"
"19181","2024","COM","2022","417","7","424","2024-12-30"
"19182","2024","COM","2022","769","17","786","2024-12-30"
"19184","2024","COM","2022","137","1","138","2024-12-30"
"19186","2024","COM","2022","226","4","230","2024-12-30"
"19187","2024","COM","2022","404","4","408","2024-12-30"
"19188","2024","COM","2022","413","13","426","2024-12-30"
"19189","2024","COM","2022","40","0","40","2024-12-30"
"19190","2024","COM","2022","188","4","192","2024-12-30"
"19191","2024","COM","2022","678","20","698","2024-12-30"
"19192","2024","COM","2022","480","11","491","2024-12-30"
"19193","2024","COM","2022","179","5","184","2024-12-30"
"19194","2024","COM","2022","1383","43","1426","2024-12-30"
"19195","2024","COM","2022","393","6","399","2024-12-30"
"19196","2024","COM","2022","458","20","478","2024-12-30"
"19198","2024","COM","2022","111","1","112","2024-12-30"
"19199","2024","COM","2022","245","4","249","2024-12-30"
"19200","2024","COM","2022","87","8","95","2024-12-30"
"19201","2024","COM","2022","592","10","602","2024-12-30"
"19202","2024","COM","2022","2060","49","2109","2024-12-30"
"19203","2024","COM","2022","1793","60","1853","2024-12-30"
"19204","2024","COM","2022","263","3","266","2024-12-30"
"19205","2024","COM","2022","91","2","93","2024-12-30"
"19206","2024","COM","2022","101","2","103","2024-12-30"
"19207","2024","COM","2022","1149","31","1180","2024-12-30"
"19208","2024","COM","2022","191","2","193","2024-12-30"
"19209","2024","COM","2022","173","4","177","2024-12-30"
"19210","2024","COM","2022","65","0","65","2024-12-30"
"19211","2024","COM","2022","997","14","1011","2024-12-30"
"19212","2024","COM","2022","95","6","101","2024-12-30"
"19213","2024","COM","2022","599","13","612","2024-12-30"
"19214","2024","COM","2022","435","6","441","2024-12-30"
"19215","2024","COM","2022","116","2","118","2024-12-30"
"19216","2024","COM","2022","239","5","244","2024-12-30"
"19217","2024","COM","2022","173","2","175","2024-12-30"
"19219","2024","COM","2022","60","3","63","2024-12-30"
"19220","2024","COM","2022","485","8","493","2024-12-30"
"19221","2024","COM","2022","105","2","107","2024-12-30"
"19222","2024","COM","2022","345","11","356","2024-12-30"
"19223","2024","COM","2022","267","4","271","2024-12-30"
"19225","2024","COM","2022","193","4","197","2024-12-30"
"19226","2024","COM","2022","109","0","109","2024-12-30"
"19227","2024","COM","2022","1331","34","1365","2024-12-30"
"19228","2024","COM","2022","64","0","64","2024-12-30"
"19229","2024","COM","2022","5006","122","5128","2024-12-30"
"19230","2024","COM","2022","383","7","390","2024-12-30"
"19231","2024","COM","2022","175","7","182","2024-12-30"
"19232","2024","COM","2022","81","1","82","2024-12-30"
"19233","2024","COM","2022","293","13","306","2024-12-30"
"19234","2024","COM","2022","486","9","495","2024-12-30"
"19235","2024","COM","2022","237","6","243","2024-12-30"
"19236","2024","COM","2022","479","10","489","2024-12-30"
"19237","2024","COM","2022","1038","20","1058","2024-12-30"
"19238","2024","COM","2022","236","5","241","2024-12-30"
"19239","2024","COM","2022","294","8","302","2024-12-30"
"19240","2024","COM","2022","317","11","328","2024-12-30"
"19241","2024","COM","2022","266","3","269","2024-12-30"
"19242","2024","COM","2022","451","15","466","2024-12-30"
"19243","2024","COM","2022","846","15","861","2024-12-30"
"19244","2024","COM","2022","78","1","79","2024-12-30"
"19245","2024","COM","2022","132","5","137","2024-12-30"
"19246","2024","COM","2022","1888","39","1927","2024-12-30"
"19247","2024","COM","2022","194","8","202","2024-12-30"
"19248","2024","COM","2022","717","7","724","2024-12-30"
"19249","2024","COM","2022","329","4","333","2024-12-30"
"19250","2024","COM","2022","679","14","693","2024-12-30"
"19251","2024","COM","2022","274","6","280","2024-12-30"
"19252","2024","COM","2022","867","15","882","2024-12-30"
"19253","2024","COM","2022","201","5","206","2024-12-30"
"19254","2024","COM","2022","202","1","203","2024-12-30"
"19255","2024","COM","2022","1814","38","1852","2024-12-30"
"19256","2024","COM","2022","344","6","350","2024-12-30"
"19257","2024","COM","2022","273","3","276","2024-12-30"
"19258","2024","COM","2022","568","10","578","2024-12-30"
"19259","2024","COM","2022","229","4","233","2024-12-30"
"19260","2024","COM","2022","237","9","246","2024-12-30"
"19261","2024","COM","2022","773","7","780","2024-12-30"
"19262","2024","COM","2022","143","14","157","2024-12-30"
"19263","2024","COM","2022","297","6","303","2024-12-30"
"19264","2024","COM","2022","520","8","528","2024-12-30"
"19265","2024","COM","2022","338","3","341","2024-12-30"
"19266","2024","COM","2022","104","4","108","2024-12-30"
"19268","2024","COM","2022","35","0","35","2024-12-30"
"19269","2024","COM","2022","1258","82","1340","2024-12-30"
"19270","2024","COM","2022","541","7","548","2024-12-30"
"19271","2024","COM","2022","266","5","271","2024-12-30"
"19272","2024","COM","2022","13602","641","14243","2024-12-30"
"19273","2024","COM","2022","803","18","821","2024-12-30"
"19274","2024","COM","2022","4271","120","4391","2024-12-30"
"19275","2024","COM","2022","9174","365","9539","2024-12-30"
"19276","2024","COM","2022","2806","57","2863","2024-12-30"
"19277","2024","COM","2022","151","5","156","2024-12-30"
"19278","2024","COM","2022","2436","48","2484","2024-12-30"
"19279","2024","COM","2022","409","9","418","2024-12-30"
"19280","2024","COM","2022","174","3","177","2024-12-30"
"19281","2024","COM","2022","74","6","80","2024-12-30"
"19283","2024","COM","2022","82","0","82","2024-12-30"
"19284","2024","COM","2022","85","2","87","2024-12-30"
"19285","2024","COM","2022","1295","34","1329","2024-12-30"
"19286","2024","COM","2022","529","9","538","2024-12-30"
"19287","2024","COM","2022","239","5","244","2024-12-30"
"19288","2024","COM","2022","1243","166","1409","2024-12-30"
"19289","2024","COM","2022","696","22","718","2024-12-30"
"21001","2024","COM","2022","428","41","469","2024-12-30"
"21002","2024","COM","2022","259","6","265","2024-12-30"
"21003","2024","COM","2022","1695","31","1726","2024-12-30"
"21004","2024","COM","2022","263","6","269","2024-12-30"
"21005","2024","COM","2022","1489","20","1509","2024-12-30"
"21006","2024","COM","2022","166","5","171","2024-12-30"
"21007","2024","COM","2022","203","7","210","2024-12-30"
"21008","2024","COM","2022","568","7","575","2024-12-30"
"21009","2024","COM","2022","175","1","176","2024-12-30"
"21010","2024","COM","2022","135","6","141","2024-12-30"
"21011","2024","COM","2022","81","0","81","2024-12-30"
"21012","2024","COM","2022","329","10","339","2024-12-30"
"21013","2024","COM","2022","451","8","459","2024-12-30"
"21014","2024","COM","2022","62","0","62","2024-12-30"
"21015","2024","COM","2022","87","2","89","2024-12-30"
"21016","2024","COM","2022","990","18","1008","2024-12-30"
"21017","2024","COM","2022","510","9","519","2024-12-30"
"21018","2024","COM","2022","52","1","53","2024-12-30"
"21020","2024","COM","2022","218","8","226","2024-12-30"
"21021","2024","COM","2022","2590","46","2636","2024-12-30"
"21022","2024","COM","2022","540","12","552","2024-12-30"
"21023","2024","COM","2022","1355","15","1370","2024-12-30"
"21024","2024","COM","2022","112","0","112","2024-12-30"
"21025","2024","COM","2022","63","2","65","2024-12-30"
"21026","2024","COM","2022","170","5","175","2024-12-30"
"21027","2024","COM","2022","1320","22","1342","2024-12-30"
"21028","2024","COM","2022","794","10","804","2024-12-30"
"21029","2024","COM","2022","80","2","82","2024-12-30"
"21030","2024","COM","2022","89","1","90","2024-12-30"
"21031","2024","COM","2022","544","5","549","2024-12-30"
"21032","2024","COM","2022","170","4","174","2024-12-30"
"21033","2024","COM","2022","170","2","172","2024-12-30"
"21034","2024","COM","2022","136","1","137","2024-12-30"
"21035","2024","COM","2022","339","7","346","2024-12-30"
"21036","2024","COM","2022","83","3","86","2024-12-30"
"21037","2024","COM","2022","297","12","309","2024-12-30"
"21038","2024","COM","2022","7592","89","7681","2024-12-30"
"21039","2024","COM","2022","35","0","35","2024-12-30"
"21040","2024","COM","2022","88","1","89","2024-12-30"
"21041","2024","COM","2022","189","3","192","2024-12-30"
"21042","2024","COM","2022","156","2","158","2024-12-30"
"21043","2024","COM","2022","203","9","212","2024-12-30"
"21044","2024","COM","2022","93","3","96","2024-12-30"
"21045","2024","COM","2022","242","5","247","2024-12-30"
"21046","2024","COM","2022","75","0","75","2024-12-30"
"21047","2024","COM","2022","72","1","73","2024-12-30"
"21048","2024","COM","2022","656","9","665","2024-12-30"
"21049","2024","COM","2022","34","1","35","2024-12-30"
"21050","2024","COM","2022","208","6","214","2024-12-30"
"21051","2024","COM","2022","92","3","95","2024-12-30"
"21052","2024","COM","2022","27","0","27","2024-12-30"
"21053","2024","COM","2022","198","2","200","2024-12-30"
"21054","2024","COM","2022","20233","615","20848","2024-12-30"
"21055","2024","COM","2022","15","0","15","2024-12-30"
"21056","2024","COM","2022","907","15","922","2024-12-30"
"21057","2024","COM","2022","343","6","349","2024-12-30"
"21058","2024","COM","2022","228","4","232","2024-12-30"
"21059","2024","COM","2022","918","25","943","2024-12-30"
"21060","2024","COM","2022","1575","28","1603","2024-12-30"
"21061","2024","COM","2022","68","3","71","2024-12-30"
"21062","2024","COM","2022","230","10","240","2024-12-30"
"21063","2024","COM","2022","92","1","93","2024-12-30"
"21064","2024","COM","2022","96","3","99","2024-12-30"
"21065","2024","COM","2022","119","4","123","2024-12-30"
"21066","2024","COM","2022","54","3","57","2024-12-30"
"21067","2024","COM","2022","685","9","694","2024-12-30"
"21068","2024","COM","2022","120","3","123","2024-12-30"
"21069","2024","COM","2022","112","3","115","2024-12-30"
"21070","2024","COM","2022","135","4","139","2024-12-30"
"21071","2024","COM","2022","730","20","750","2024-12-30"
"21072","2024","COM","2022","202","5","207","2024-12-30"
"21074","2024","COM","2022","248","4","252","2024-12-30"
"21075","2024","COM","2022","68","1","69","2024-12-30"
"21076","2024","COM","2022","865","9","874","2024-12-30"
"21077","2024","COM","2022","132","3","135","2024-12-30"
"21078","2024","COM","2022","68","6","74","2024-12-30"
"21079","2024","COM","2022","125","2","127","2024-12-30"
"21080","2024","COM","2022","664","15","679","2024-12-30"
"21081","2024","COM","2022","125","2","127","2024-12-30"
"21082","2024","COM","2022","55","2","57","2024-12-30"
"21083","2024","COM","2022","120","2","122","2024-12-30"
"21084","2024","COM","2022","60","1","61","2024-12-30"
"21085","2024","COM","2022","145","6","151","2024-12-30"
"21086","2024","COM","2022","1273","26","1299","2024-12-30"
"21087","2024","COM","2022","815","12","827","2024-12-30"
"21088","2024","COM","2022","272","11","283","2024-12-30"
"21089","2024","COM","2022","441","7","448","2024-12-30"
"21090","2024","COM","2022","60","2","62","2024-12-30"
"21091","2024","COM","2022","50","0","50","2024-12-30"
"21092","2024","COM","2022","242","5","247","2024-12-30"
"21093","2024","COM","2022","151","3","154","2024-12-30"
"21094","2024","COM","2022","388","4","392","2024-12-30"
"21095","2024","COM","2022","52","1","53","2024-12-30"
"21096","2024","COM","2022","106","1","107","2024-12-30"
"21097","2024","COM","2022","34","0","34","2024-12-30"
"21098","2024","COM","2022","125","3","128","2024-12-30"
"21099","2024","COM","2022","306","6","312","2024-12-30"
"21100","2024","COM","2022","35","0","35","2024-12-30"
"21101","2024","COM","2022","175","4","179","2024-12-30"
"21102","2024","COM","2022","150","2","152","2024-12-30"
"21103","2024","COM","2022","2425","28","2453","2024-12-30"
"21104","2024","COM","2022","44","0","44","2024-12-30"
"21105","2024","COM","2022","1110","14","1124","2024-12-30"
"21106","2024","COM","2022","935","12","947","2024-12-30"
"21107","2024","COM","2022","903","25","928","2024-12-30"
"21108","2024","COM","2022","105","1","106","2024-12-30"
"21109","2024","COM","2022","216","6","222","2024-12-30"
"21110","2024","COM","2022","662","133","795","2024-12-30"
"21111","2024","COM","2022","318","4","322","2024-12-30"
"21112","2024","COM","2022","410","8","418","2024-12-30"
"21113","2024","COM","2022","197","1","198","2024-12-30"
"21114","2024","COM","2022","154","1","155","2024-12-30"
"21115","2024","COM","2022","358","4","362","2024-12-30"
"21116","2024","COM","2022","135","3","138","2024-12-30"
"21117","2024","COM","2022","52","3","55","2024-12-30"
"21118","2024","COM","2022","33","0","33","2024-12-30"
"21119","2024","COM","2022","44","0","44","2024-12-30"
"21120","2024","COM","2022","185","5","190","2024-12-30"
"21121","2024","COM","2022","75","1","76","2024-12-30"
"21122","2024","COM","2022","306","8","314","2024-12-30"
"21123","2024","COM","2022","34","3","37","2024-12-30"
"21124","2024","COM","2022","180","6","186","2024-12-30"
"21125","2024","COM","2022","214","8","222","2024-12-30"
"21126","2024","COM","2022","625","9","634","2024-12-30"
"21127","2024","COM","2022","500","7","507","2024-12-30"
"21128","2024","COM","2022","276","7","283","2024-12-30"
"21129","2024","COM","2022","28","0","28","2024-12-30"
"21130","2024","COM","2022","413","2","415","2024-12-30"
"21131","2024","COM","2022","464","44","508","2024-12-30"
"21132","2024","COM","2022","384","9","393","2024-12-30"
"21133","2024","COM","2022","268","2","270","2024-12-30"
"21134","2024","COM","2022","241","5","246","2024-12-30"
"21135","2024","COM","2022","313","8","321","2024-12-30"
"21136","2024","COM","2022","27","0","27","2024-12-30"
"21137","2024","COM","2022","110","2","112","2024-12-30"
"21138","2024","COM","2022","603","8","611","2024-12-30"
"21139","2024","COM","2022","223","3","226","2024-12-30"
"21140","2024","COM","2022","79","1","80","2024-12-30"
"21141","2024","COM","2022","37","1","38","2024-12-30"
"21142","2024","COM","2022","206","2","208","2024-12-30"
"21143","2024","COM","2022","59","1","60","2024-12-30"
"21144","2024","COM","2022","37","1","38","2024-12-30"
"21145","2024","COM","2022","36","1","37","2024-12-30"
"21146","2024","COM","2022","119","2","121","2024-12-30"
"21147","2024","COM","2022","34","1","35","2024-12-30"
"21148","2024","COM","2022","333","4","337","2024-12-30"
"21149","2024","COM","2022","137","3","140","2024-12-30"
"21150","2024","COM","2022","263","3","266","2024-12-30"
"21151","2024","COM","2022","92","5","97","2024-12-30"
"21152","2024","COM","2022","81","1","82","2024-12-30"
"21153","2024","COM","2022","163","5","168","2024-12-30"
"21154","2024","COM","2022","5404","332","5736","2024-12-30"
"21155","2024","COM","2022","38","0","38","2024-12-30"
"21156","2024","COM","2022","48","0","48","2024-12-30"
"21157","2024","COM","2022","24","2","26","2024-12-30"
"21158","2024","COM","2022","183","5","188","2024-12-30"
"21159","2024","COM","2022","97","3","100","2024-12-30"
"21160","2024","COM","2022","105","1","106","2024-12-30"
"21161","2024","COM","2022","79","3","82","2024-12-30"
"21162","2024","COM","2022","484","7","491","2024-12-30"
"21163","2024","COM","2022","187","5","192","2024-12-30"
"21164","2024","COM","2022","148","6","154","2024-12-30"
"21165","2024","COM","2022","63","1","64","2024-12-30"
"21166","2024","COM","2022","14299","162","14461","2024-12-30"
"21167","2024","COM","2022","119","5","124","2024-12-30"
"21168","2024","COM","2022","35","1","36","2024-12-30"
"21169","2024","COM","2022","169","3","172","2024-12-30"
"21170","2024","COM","2022","409","5","414","2024-12-30"
"21171","2024","COM","2022","10895","200","11095","2024-12-30"
"21172","2024","COM","2022","275","4","279","2024-12-30"
"21173","2024","COM","2022","596","22","618","2024-12-30"
"21175","2024","COM","2022","180","1","181","2024-12-30"
"21176","2024","COM","2022","129","2","131","2024-12-30"
"21177","2024","COM","2022","181","4","185","2024-12-30"
"21178","2024","COM","2022","322","9","331","2024-12-30"
"21179","2024","COM","2022","904","24","928","2024-12-30"
"21180","2024","COM","2022","160","2","162","2024-12-30"
"21181","2024","COM","2022","121","2","123","2024-12-30"
"21182","2024","COM","2022","99","1","100","2024-12-30"
"21183","2024","COM","2022","1067","11","1078","2024-12-30"
"21184","2024","COM","2022","66","1","67","2024-12-30"
"21185","2024","COM","2022","539","21","560","2024-12-30"
"21186","2024","COM","2022","604","14","618","2024-12-30"
"21187","2024","COM","2022","121","5","126","2024-12-30"
"21189","2024","COM","2022","429","9","438","2024-12-30"
"21190","2024","COM","2022","435","20","455","2024-12-30"
"21191","2024","COM","2022","831","28","859","2024-12-30"
"21192","2024","COM","2022","654","8","662","2024-12-30"
"21193","2024","COM","2022","381","4","385","2024-12-30"
"21194","2024","COM","2022","968","13","981","2024-12-30"
"21195","2024","COM","2022","210","4","214","2024-12-30"
"21196","2024","COM","2022","962","16","978","2024-12-30"
"21197","2024","COM","2022","37","0","37","2024-12-30"
"21198","2024","COM","2022","242","10","252","2024-12-30"
"21199","2024","COM","2022","131","2","133","2024-12-30"
"21200","2024","COM","2022","1108","21","1129","2024-12-30"
"21201","2024","COM","2022","240","2","242","2024-12-30"
"21202","2024","COM","2022","140","2","142","2024-12-30"
"21203","2024","COM","2022","148","1","149","2024-12-30"
"21204","2024","COM","2022","87","0","87","2024-12-30"
"21205","2024","COM","2022","228","4","232","2024-12-30"
"21207","2024","COM","2022","76","1","77","2024-12-30"
"21208","2024","COM","2022","162","4","166","2024-12-30"
"21209","2024","COM","2022","1903","30","1933","2024-12-30"
"21210","2024","COM","2022","520","15","535","2024-12-30"
"21211","2024","COM","2022","125","2","127","2024-12-30"
"21212","2024","COM","2022","317","5","322","2024-12-30"
"21214","2024","COM","2022","167","1","168","2024-12-30"
"21215","2024","COM","2022","174","5","179","2024-12-30"
"21216","2024","COM","2022","101","2","103","2024-12-30"
"21217","2024","COM","2022","139","4","143","2024-12-30"
"21218","2024","COM","2022","113","0","113","2024-12-30"
"21219","2024","COM","2022","156","8","164","2024-12-30"
"21220","2024","COM","2022","147","2","149","2024-12-30"
"21221","2024","COM","2022","44","4","48","2024-12-30"
"21222","2024","COM","2022","120","2","122","2024-12-30"
"21223","2024","COM","2022","1520","35","1555","2024-12-30"
"21224","2024","COM","2022","61","4","65","2024-12-30"
"21225","2024","COM","2022","136","2","138","2024-12-30"
"21226","2024","COM","2022","332","11","343","2024-12-30"
"21227","2024","COM","2022","490","8","498","2024-12-30"
"21228","2024","COM","2022","142","0","142","2024-12-30"
"21229","2024","COM","2022","98","2","100","2024-12-30"
"21230","2024","COM","2022","383","8","391","2024-12-30"
"21231","2024","COM","2022","159941","3228","163169","2024-12-30"
"21232","2024","COM","2022","200","5","205","2024-12-30"
"21233","2024","COM","2022","186","2","188","2024-12-30"
"21234","2024","COM","2022","66","0","66","2024-12-30"
"21235","2024","COM","2022","46","3","49","2024-12-30"
"21236","2024","COM","2022","255","6","261","2024-12-30"
"21237","2024","COM","2022","97","3","100","2024-12-30"
"21238","2024","COM","2022","135","2","137","2024-12-30"
"21239","2024","COM","2022","766","7","773","2024-12-30"
"21240","2024","COM","2022","295","3","298","2024-12-30"
"21241","2024","COM","2022","309","10","319","2024-12-30"
"21242","2024","COM","2022","307","4","311","2024-12-30"
"21243","2024","COM","2022","79","2","81","2024-12-30"
"21244","2024","COM","2022","70","0","70","2024-12-30"
"21245","2024","COM","2022","325","5","330","2024-12-30"
"21246","2024","COM","2022","156","5","161","2024-12-30"
"21247","2024","COM","2022","724","8","732","2024-12-30"
"21248","2024","COM","2022","57","4","61","2024-12-30"
"21249","2024","COM","2022","681","13","694","2024-12-30"
"21250","2024","COM","2022","84","1","85","2024-12-30"
"21251","2024","COM","2022","308","28","336","2024-12-30"
"21252","2024","COM","2022","76","4","80","2024-12-30"
"21253","2024","COM","2022","128","3","131","2024-12-30"
"21254","2024","COM","2022","203","10","213","2024-12-30"
"21255","2024","COM","2022","349","9","358","2024-12-30"
"21256","2024","COM","2022","316","7","323","2024-12-30"
"21257","2024","COM","2022","66","2","68","2024-12-30"
"21258","2024","COM","2022","207","4","211","2024-12-30"
"21259","2024","COM","2022","273","11","284","2024-12-30"
"21260","2024","COM","2022","152","4","156","2024-12-30"
"21261","2024","COM","2022","620","10","630","2024-12-30"
"21262","2024","COM","2022","29","0","29","2024-12-30"
"21263","2024","COM","2022","1724","41","1765","2024-12-30"
"21264","2024","COM","2022","45","0","45","2024-12-30"
"21265","2024","COM","2022","717","12","729","2024-12-30"
"21266","2024","COM","2022","210","2","212","2024-12-30"
"21267","2024","COM","2022","494","13","507","2024-12-30"
"21268","2024","COM","2022","206","1","207","2024-12-30"
"21269","2024","COM","2022","453","8","461","2024-12-30"
"21270","2024","COM","2022","231","4","235","2024-12-30"
"21271","2024","COM","2022","274","2","276","2024-12-30"
"21272","2024","COM","2022","272","4","276","2024-12-30"
"21273","2024","COM","2022","1498","19","1517","2024-12-30"
"21274","2024","COM","2022","169","3","172","2024-12-30"
"21275","2024","COM","2022","128","1","129","2024-12-30"
"21276","2024","COM","2022","117","2","119","2024-12-30"
"21277","2024","COM","2022","888","18","906","2024-12-30"
"21278","2024","COM","2022","9032","209","9241","2024-12-30"
"21279","2024","COM","2022","26","2","28","2024-12-30"
"21280","2024","COM","2022","157","2","159","2024-12-30"
"21281","2024","COM","2022","169","1","170","2024-12-30"
"21282","2024","COM","2022","112","2","114","2024-12-30"
"21283","2024","COM","2022","72","0","72","2024-12-30"
"21284","2024","COM","2022","258","8","266","2024-12-30"
"21285","2024","COM","2022","509","6","515","2024-12-30"
"21286","2024","COM","2022","93","1","94","2024-12-30"
"21287","2024","COM","2022","154","8","162","2024-12-30"
"21288","2024","COM","2022","164","3","167","2024-12-30"
"21289","2024","COM","2022","122","4","126","2024-12-30"
"21290","2024","COM","2022","968","18","986","2024-12-30"
"21291","2024","COM","2022","382","11","393","2024-12-30"
"21292","2024","COM","2022","5125","45","5170","2024-12-30"
"21293","2024","COM","2022","127","2","129","2024-12-30"
"21294","2024","COM","2022","441","10","451","2024-12-30"
"21295","2024","COM","2022","2983","37","3020","2024-12-30"
"21296","2024","COM","2022","167","4","171","2024-12-30"
"21297","2024","COM","2022","729","10","739","2024-12-30"
"21298","2024","COM","2022","104","3","107","2024-12-30"
"21299","2024","COM","2022","93","2","95","2024-12-30"
"21300","2024","COM","2022","357","10","367","2024-12-30"
"21301","2024","COM","2022","275","3","278","2024-12-30"
"21302","2024","COM","2022","116","3","119","2024-12-30"
"21303","2024","COM","2022","17","0","17","2024-12-30"
"21304","2024","COM","2022","262","5","267","2024-12-30"
"21305","2024","COM","2022","179","5","184","2024-12-30"
"21306","2024","COM","2022","216","4","220","2024-12-30"
"21307","2024","COM","2022","147","4","151","2024-12-30"
"21308","2024","COM","2022","191","4","195","2024-12-30"
"21309","2024","COM","2022","92","3","95","2024-12-30"
"21310","2024","COM","2022","111","0","111","2024-12-30"
"21311","2024","COM","2022","69","2","71","2024-12-30"
"21312","2024","COM","2022","26","5","31","2024-12-30"
"21313","2024","COM","2022","45","1","46","2024-12-30"
"21314","2024","COM","2022","77","0","77","2024-12-30"
"21315","2024","COM","2022","1206","22","1228","2024-12-30"
"21316","2024","COM","2022","334","4","338","2024-12-30"
"21317","2024","COM","2022","4308","71","4379","2024-12-30"
"21319","2024","COM","2022","907","9","916","2024-12-30"
"21320","2024","COM","2022","788","13","801","2024-12-30"
"21321","2024","COM","2022","76","0","76","2024-12-30"
"21322","2024","COM","2022","309","6","315","2024-12-30"
"21323","2024","COM","2022","153","2","155","2024-12-30"
"21324","2024","COM","2022","53","1","54","2024-12-30"
"21325","2024","COM","2022","190","2","192","2024-12-30"
"21326","2024","COM","2022","91","1","92","2024-12-30"
"21327","2024","COM","2022","250","3","253","2024-12-30"
"21328","2024","COM","2022","52","0","52","2024-12-30"
"21329","2024","COM","2022","41","2","43","2024-12-30"
"21330","2024","COM","2022","379","1","380","2024-12-30"
"21331","2024","COM","2022","344","3","347","2024-12-30"
"21332","2024","COM","2022","1012","12","1024","2024-12-30"
"21333","2024","COM","2022","232","8","240","2024-12-30"
"21334","2024","COM","2022","477","14","491","2024-12-30"
"21335","2024","COM","2022","108","4","112","2024-12-30"
"21336","2024","COM","2022","669","10","679","2024-12-30"
"21337","2024","COM","2022","1375","14","1389","2024-12-30"
"21338","2024","COM","2022","145","7","152","2024-12-30"
"21339","2024","COM","2022","501","19","520","2024-12-30"
"21340","2024","COM","2022","255","4","259","2024-12-30"
"21341","2024","COM","2022","99","3","102","2024-12-30"
"21342","2024","COM","2022","429","8","437","2024-12-30"
"21343","2024","COM","2022","96","2","98","2024-12-30"
"21344","2024","COM","2022","233","5","238","2024-12-30"
"21345","2024","COM","2022","203","1","204","2024-12-30"
"21346","2024","COM","2022","294","3","297","2024-12-30"
"21347","2024","COM","2022","364","17","381","2024-12-30"
"21348","2024","COM","2022","100","1","101","2024-12-30"
"21349","2024","COM","2022","485","3","488","2024-12-30"
"21350","2024","COM","2022","57","1","58","2024-12-30"
"21351","2024","COM","2022","1168","118","1286","2024-12-30"
"21352","2024","COM","2022","1154","23","1177","2024-12-30"
"21353","2024","COM","2022","1185","24","1209","2024-12-30"
"21354","2024","COM","2022","55","2","57","2024-12-30"
"21355","2024","COM","2022","8787","140","8927","2024-12-30"
"21356","2024","COM","2022","1712","19","1731","2024-12-30"
"21357","2024","COM","2022","113","2","115","2024-12-30"
"21358","2024","COM","2022","197","3","200","2024-12-30"
"21359","2024","COM","2022","56","3","59","2024-12-30"
"21360","2024","COM","2022","116","3","119","2024-12-30"
"21361","2024","COM","2022","512","5","517","2024-12-30"
"21362","2024","COM","2022","134","3","137","2024-12-30"
"21363","2024","COM","2022","318","6","324","2024-12-30"
"21364","2024","COM","2022","85","3","88","2024-12-30"
"21365","2024","COM","2022","74","3","77","2024-12-30"
"21366","2024","COM","2022","220","6","226","2024-12-30"
"21367","2024","COM","2022","261","5","266","2024-12-30"
"21368","2024","COM","2022","233","8","241","2024-12-30"
"21369","2024","COM","2022","339","4","343","2024-12-30"
"21370","2024","COM","2022","872","17","889","2024-12-30"
"21371","2024","COM","2022","797","11","808","2024-12-30"
"21372","2024","COM","2022","75","0","75","2024-12-30"
"21373","2024","COM","2022","782","12","794","2024-12-30"
"21374","2024","COM","2022","175","6","181","2024-12-30"
"21375","2024","COM","2022","199","5","204","2024-12-30"
"21376","2024","COM","2022","97","1","98","2024-12-30"
"21377","2024","COM","2022","45","0","45","2024-12-30"
"21378","2024","COM","2022","98","0","98","2024-12-30"
"21379","2024","COM","2022","151","1","152","2024-12-30"
"21380","2024","COM","2022","55","1","56","2024-12-30"
"21381","2024","COM","2022","86","1","87","2024-12-30"
"21382","2024","COM","2022","192","3","195","2024-12-30"
"21383","2024","COM","2022","1734","28","1762","2024-12-30"
"21384","2024","COM","2022","84","1","85","2024-12-30"
"21385","2024","COM","2022","330","5","335","2024-12-30"
"21386","2024","COM","2022","312","9","321","2024-12-30"
"21387","2024","COM","2022","214","5","219","2024-12-30"
"21388","2024","COM","2022","614","12","626","2024-12-30"
"21389","2024","COM","2022","197","1","198","2024-12-30"
"21390","2024","COM","2022","5440","73","5513","2024-12-30"
"21391","2024","COM","2022","842","16","858","2024-12-30"
"21392","2024","COM","2022","61","2","63","2024-12-30"
"21393","2024","COM","2022","172","4","176","2024-12-30"
"21394","2024","COM","2022","152","6","158","2024-12-30"
"21395","2024","COM","2022","92","1","93","2024-12-30"
"21396","2024","COM","2022","65","1","66","2024-12-30"
"21397","2024","COM","2022","173","3","176","2024-12-30"
"21398","2024","COM","2022","367","7","374","2024-12-30"
"21399","2024","COM","2022","231","6","237","2024-12-30"
"21400","2024","COM","2022","43","0","43","2024-12-30"
"21401","2024","COM","2022","321","10","331","2024-12-30"
"21402","2024","COM","2022","16","0","16","2024-12-30"
"21403","2024","COM","2022","79","1","80","2024-12-30"
"21404","2024","COM","2022","393","9","402","2024-12-30"
"21405","2024","COM","2022","814","21","835","2024-12-30"
"21406","2024","COM","2022","253","4","257","2024-12-30"
"21407","2024","COM","2022","248","10","258","2024-12-30"
"21408","2024","COM","2022","1694","29","1723","2024-12-30"
"21409","2024","COM","2022","420","5","425","2024-12-30"
"21410","2024","COM","2022","28","2","30","2024-12-30"
"21411","2024","COM","2022","591","19","610","2024-12-30"
"21412","2024","COM","2022","1376","37","1413","2024-12-30"
"21413","2024","COM","2022","417","16","433","2024-12-30"
"21414","2024","COM","2022","326","9","335","2024-12-30"
"21415","2024","COM","2022","188","6","194","2024-12-30"
"21416","2024","COM","2022","1937","35","1972","2024-12-30"
"21417","2024","COM","2022","105","1","106","2024-12-30"
"21418","2024","COM","2022","55","3","58","2024-12-30"
"21419","2024","COM","2022","274","6","280","2024-12-30"
"21420","2024","COM","2022","166","3","169","2024-12-30"
"21421","2024","COM","2022","235","0","235","2024-12-30"
"21422","2024","COM","2022","130","4","134","2024-12-30"
"21423","2024","COM","2022","772","19","791","2024-12-30"
"21424","2024","COM","2022","115","2","117","2024-12-30"
"21425","2024","COM","2022","4751","124","4875","2024-12-30"
"21426","2024","COM","2022","217","3","220","2024-12-30"
"21427","2024","COM","2022","179","7","186","2024-12-30"
"21428","2024","COM","2022","146","3","149","2024-12-30"
"21429","2024","COM","2022","277","8","285","2024-12-30"
"21430","2024","COM","2022","82","5","87","2024-12-30"
"21431","2024","COM","2022","157","4","161","2024-12-30"
"21432","2024","COM","2022","255","3","258","2024-12-30"
"21433","2024","COM","2022","384","7","391","2024-12-30"
"21434","2024","COM","2022","195","2","197","2024-12-30"
"21435","2024","COM","2022","292","7","299","2024-12-30"
"21436","2024","COM","2022","139","1","140","2024-12-30"
"21437","2024","COM","2022","242","4","246","2024-12-30"
"21438","2024","COM","2022","72","1","73","2024-12-30"
"21439","2024","COM","2022","94","1","95","2024-12-30"
"21440","2024","COM","2022","205","5","210","2024-12-30"
"21441","2024","COM","2022","257","9","266","2024-12-30"
"21442","2024","COM","2022","621","11","632","2024-12-30"
"21444","2024","COM","2022","68","1","69","2024-12-30"
"21445","2024","COM","2022","150","2","152","2024-12-30"
"21446","2024","COM","2022","255","4","259","2024-12-30"
"21447","2024","COM","2022","91","0","91","2024-12-30"
"21448","2024","COM","2022","95","2","97","2024-12-30"
"21449","2024","COM","2022","169","7","176","2024-12-30"
"21450","2024","COM","2022","168","4","172","2024-12-30"
"21451","2024","COM","2022","79","1","80","2024-12-30"
"21452","2024","COM","2022","3430","33","3463","2024-12-30"
"21454","2024","COM","2022","108","1","109","2024-12-30"
"21455","2024","COM","2022","206","4","210","2024-12-30"
"21456","2024","COM","2022","153","8","161","2024-12-30"
"21457","2024","COM","2022","87","1","88","2024-12-30"
"21458","2024","COM","2022","1143","29","1172","2024-12-30"
"21459","2024","COM","2022","228","5","233","2024-12-30"
"21460","2024","COM","2022","59","1","60","2024-12-30"
"21461","2024","COM","2022","1419","23","1442","2024-12-30"
"21462","2024","COM","2022","946","18","964","2024-12-30"
"21463","2024","COM","2022","64","1","65","2024-12-30"
"21464","2024","COM","2022","5263","87","5350","2024-12-30"
"21465","2024","COM","2022","80","1","81","2024-12-30"
"21466","2024","COM","2022","40","3","43","2024-12-30"
"21467","2024","COM","2022","125","1","126","2024-12-30"
"21468","2024","COM","2022","89","0","89","2024-12-30"
"21469","2024","COM","2022","459","8","467","2024-12-30"
"21470","2024","COM","2022","53","3","56","2024-12-30"
"21471","2024","COM","2022","12","0","12","2024-12-30"
"21472","2024","COM","2022","177","1","178","2024-12-30"
"21473","2024","COM","2022","1505","13","1518","2024-12-30"
"21474","2024","COM","2022","413","11","424","2024-12-30"
"21475","2024","COM","2022","485","10","495","2024-12-30"
"21476","2024","COM","2022","169","5","174","2024-12-30"
"21477","2024","COM","2022","80","2","82","2024-12-30"
"21478","2024","COM","2022","287","6","293","2024-12-30"
"21479","2024","COM","2022","81","2","83","2024-12-30"
"21480","2024","COM","2022","240","9","249","2024-12-30"
"21481","2024","COM","2022","2321","22","2343","2024-12-30"
"21482","2024","COM","2022","645","13","658","2024-12-30"
"21483","2024","COM","2022","293","5","298","2024-12-30"
"21484","2024","COM","2022","62","1","63","2024-12-30"
"21485","2024","COM","2022","2508","60","2568","2024-12-30"
"21487","2024","COM","2022","431","6","437","2024-12-30"
"21488","2024","COM","2022","193","6","199","2024-12-30"
"21489","2024","COM","2022","68","0","68","2024-12-30"
"21490","2024","COM","2022","155","6","161","2024-12-30"
"21491","2024","COM","2022","75","1","76","2024-12-30"
"21492","2024","COM","2022","444","13","457","2024-12-30"
"21493","2024","COM","2022","574","6","580","2024-12-30"
"21494","2024","COM","2022","82","3","85","2024-12-30"
"21495","2024","COM","2022","158","1","159","2024-12-30"
"21496","2024","COM","2022","1285","18","1303","2024-12-30"
"21497","2024","COM","2022","182","4","186","2024-12-30"
"21498","2024","COM","2022","50","3","53","2024-12-30"
"21499","2024","COM","2022","193","2","195","2024-12-30"
"21500","2024","COM","2022","589","7","596","2024-12-30"
"21501","2024","COM","2022","1554","120","1674","2024-12-30"
"21502","2024","COM","2022","616","8","624","2024-12-30"
"21503","2024","COM","2022","136","4","140","2024-12-30"
"21504","2024","COM","2022","97","3","100","2024-12-30"
"21505","2024","COM","2022","716","15","731","2024-12-30"
"21506","2024","COM","2022","372","5","377","2024-12-30"
"21508","2024","COM","2022","462","4","466","2024-12-30"
"21510","2024","COM","2022","160","4","164","2024-12-30"
"21511","2024","COM","2022","136","5","141","2024-12-30"
"21512","2024","COM","2022","353","10","363","2024-12-30"
"21514","2024","COM","2022","95","3","98","2024-12-30"
"21515","2024","COM","2022","8897","347","9244","2024-12-30"
"21516","2024","COM","2022","78","2","80","2024-12-30"
"21517","2024","COM","2022","499","18","517","2024-12-30"
"21518","2024","COM","2022","207","3","210","2024-12-30"
"21519","2024","COM","2022","338","5","343","2024-12-30"
"21520","2024","COM","2022","154","0","154","2024-12-30"
"21521","2024","COM","2022","979","13","992","2024-12-30"
"21522","2024","COM","2022","482","9","491","2024-12-30"
"21523","2024","COM","2022","163","2","165","2024-12-30"
"21524","2024","COM","2022","93","0","93","2024-12-30"
"21525","2024","COM","2022","909","14","923","2024-12-30"
"21526","2024","COM","2022","42","0","42","2024-12-30"
"21527","2024","COM","2022","281","8","289","2024-12-30"
"21528","2024","COM","2022","137","2","139","2024-12-30"
"21529","2024","COM","2022","52","2","54","2024-12-30"
"21530","2024","COM","2022","144","2","146","2024-12-30"
"21531","2024","COM","2022","503","4","507","2024-12-30"
"21532","2024","COM","2022","1254","24","1278","2024-12-30"
"21533","2024","COM","2022","85","3","88","2024-12-30"
"21534","2024","COM","2022","742","47","789","2024-12-30"
"21535","2024","COM","2022","1404","14","1418","2024-12-30"
"21536","2024","COM","2022","287","11","298","2024-12-30"
"21537","2024","COM","2022","120","4","124","2024-12-30"
"21538","2024","COM","2022","118","3","121","2024-12-30"
"21539","2024","COM","2022","63","0","63","2024-12-30"
"21540","2024","COM","2022","7517","117","7634","2024-12-30"
"21541","2024","COM","2022","195","7","202","2024-12-30"
"21542","2024","COM","2022","460","6","466","2024-12-30"
"21543","2024","COM","2022","184","3","187","2024-12-30"
"21544","2024","COM","2022","52","1","53","2024-12-30"
"21545","2024","COM","2022","919","15","934","2024-12-30"
"21546","2024","COM","2022","199","4","203","2024-12-30"
"21547","2024","COM","2022","223","4","227","2024-12-30"
"21548","2024","COM","2022","174","3","177","2024-12-30"
"21549","2024","COM","2022","83","4","87","2024-12-30"
"21550","2024","COM","2022","113","5","118","2024-12-30"
"21552","2024","COM","2022","36","2","38","2024-12-30"
"21553","2024","COM","2022","103","4","107","2024-12-30"
"21554","2024","COM","2022","1001","9","1010","2024-12-30"
"21555","2024","COM","2022","1749","20","1769","2024-12-30"
"21556","2024","COM","2022","250","4","254","2024-12-30"
"21557","2024","COM","2022","111","3","114","2024-12-30"
"21558","2024","COM","2022","917","27","944","2024-12-30"
"21559","2024","COM","2022","701","13","714","2024-12-30"
"21560","2024","COM","2022","279","6","285","2024-12-30"
"21561","2024","COM","2022","464","1","465","2024-12-30"
"21562","2024","COM","2022","198","6","204","2024-12-30"
"21563","2024","COM","2022","111","2","113","2024-12-30"
"21564","2024","COM","2022","390","9","399","2024-12-30"
"21565","2024","COM","2022","542","8","550","2024-12-30"
"21566","2024","COM","2022","139","3","142","2024-12-30"
"21567","2024","COM","2022","203","8","211","2024-12-30"
"21568","2024","COM","2022","678","12","690","2024-12-30"
"21569","2024","COM","2022","200","11","211","2024-12-30"
"21570","2024","COM","2022","172","8","180","2024-12-30"
"21571","2024","COM","2022","228","3","231","2024-12-30"
"21572","2024","COM","2022","407","4","411","2024-12-30"
"21573","2024","COM","2022","361","5","366","2024-12-30"
"21574","2024","COM","2022","376","9","385","2024-12-30"
"21575","2024","COM","2022","322","4","326","2024-12-30"
"21576","2024","COM","2022","155","5","160","2024-12-30"
"21577","2024","COM","2022","1330","25","1355","2024-12-30"
"21578","2024","COM","2022","307","3","310","2024-12-30"
"21579","2024","COM","2022","196","3","199","2024-12-30"
"21580","2024","COM","2022","128","4","132","2024-12-30"
"21581","2024","COM","2022","134","4","138","2024-12-30"
"21582","2024","COM","2022","852","20","872","2024-12-30"
"21583","2024","COM","2022","60","1","61","2024-12-30"
"21584","2024","COM","2022","2269","83","2352","2024-12-30"
"21585","2024","COM","2022","1030","20","1050","2024-12-30"
"21586","2024","COM","2022","707","18","725","2024-12-30"
"21587","2024","COM","2022","248","4","252","2024-12-30"
"21588","2024","COM","2022","72","1","73","2024-12-30"
"21589","2024","COM","2022","100","1","101","2024-12-30"
"21590","2024","COM","2022","1300","43","1343","2024-12-30"
"21591","2024","COM","2022","883","23","906","2024-12-30"
"21592","2024","COM","2022","233","9","242","2024-12-30"
"21593","2024","COM","2022","79","0","79","2024-12-30"
"21594","2024","COM","2022","195","3","198","2024-12-30"
"21595","2024","COM","2022","146","2","148","2024-12-30"
"21596","2024","COM","2022","377","10","387","2024-12-30"
"21597","2024","COM","2022","57","1","58","2024-12-30"
"21598","2024","COM","2022","153","1","154","2024-12-30"
"21599","2024","COM","2022","2394","34","2428","2024-12-30"
"21600","2024","COM","2022","130","3","133","2024-12-30"
"21601","2024","COM","2022","92","5","97","2024-12-30"
"21602","2024","COM","2022","31","0","31","2024-12-30"
"21603","2024","COM","2022","4027","283","4310","2024-12-30"
"21604","2024","COM","2022","132","3","135","2024-12-30"
"21605","2024","COM","2022","2125","59","2184","2024-12-30"
"21606","2024","COM","2022","1783","48","1831","2024-12-30"
"21607","2024","COM","2022","2336","26","2362","2024-12-30"
"21608","2024","COM","2022","103","1","104","2024-12-30"
"21609","2024","COM","2022","498","7","505","2024-12-30"
"21610","2024","COM","2022","357","4","361","2024-12-30"
"21611","2024","COM","2022","990","14","1004","2024-12-30"
"21612","2024","COM","2022","83","0","83","2024-12-30"
"21613","2024","COM","2022","158","10","168","2024-12-30"
"21614","2024","COM","2022","391","9","400","2024-12-30"
"21615","2024","COM","2022","244","2","246","2024-12-30"
"21616","2024","COM","2022","200","7","207","2024-12-30"
"21617","2024","COM","2022","11986","195","12181","2024-12-30"
"21618","2024","COM","2022","533","9","542","2024-12-30"
"21619","2024","COM","2022","221","5","226","2024-12-30"
"21620","2024","COM","2022","160","5","165","2024-12-30"
"21622","2024","COM","2022","243","5","248","2024-12-30"
"21623","2024","COM","2022","1533","31","1564","2024-12-30"
"21624","2024","COM","2022","142","3","145","2024-12-30"
"21625","2024","COM","2022","82","1","83","2024-12-30"
"21626","2024","COM","2022","65","2","67","2024-12-30"
"21627","2024","COM","2022","91","1","92","2024-12-30"
"21628","2024","COM","2022","58","1","59","2024-12-30"
"21629","2024","COM","2022","305","4","309","2024-12-30"
"21630","2024","COM","2022","215","8","223","2024-12-30"
"21631","2024","COM","2022","56","1","57","2024-12-30"
"21632","2024","COM","2022","1134","21","1155","2024-12-30"
"21633","2024","COM","2022","193","3","196","2024-12-30"
"21634","2024","COM","2022","141","0","141","2024-12-30"
"21635","2024","COM","2022","101","6","107","2024-12-30"
"21636","2024","COM","2022","260","11","271","2024-12-30"
"21637","2024","COM","2022","212","5","217","2024-12-30"
"21638","2024","COM","2022","1136","19","1155","2024-12-30"
"21639","2024","COM","2022","744","13","757","2024-12-30"
"21640","2024","COM","2022","207","5","212","2024-12-30"
"21641","2024","COM","2022","461","6","467","2024-12-30"
"21642","2024","COM","2022","408","7","415","2024-12-30"
"21643","2024","COM","2022","425","8","433","2024-12-30"
"21644","2024","COM","2022","167","2","169","2024-12-30"
"21645","2024","COM","2022","610","8","618","2024-12-30"
"21646","2024","COM","2022","130","3","133","2024-12-30"
"21647","2024","COM","2022","121","4","125","2024-12-30"
"21648","2024","COM","2022","181","3","184","2024-12-30"
"21649","2024","COM","2022","49","0","49","2024-12-30"
"21650","2024","COM","2022","145","4","149","2024-12-30"
"21651","2024","COM","2022","204","4","208","2024-12-30"
"21652","2024","COM","2022","294","8","302","2024-12-30"
"21653","2024","COM","2022","49","1","50","2024-12-30"
"21655","2024","COM","2022","239","9","248","2024-12-30"
"21656","2024","COM","2022","688","13","701","2024-12-30"
"21657","2024","COM","2022","2068","33","2101","2024-12-30"
"21659","2024","COM","2022","168","13","181","2024-12-30"
"21660","2024","COM","2022","56","1","57","2024-12-30"
"21661","2024","COM","2022","1829","30","1859","2024-12-30"
"21662","2024","COM","2022","33","1","34","2024-12-30"
"21663","2024","COM","2022","2758","43","2801","2024-12-30"
"21664","2024","COM","2022","69","2","71","2024-12-30"
"21665","2024","COM","2022","156","2","158","2024-12-30"
"21666","2024","COM","2022","96","3","99","2024-12-30"
"21667","2024","COM","2022","402","9","411","2024-12-30"
"21669","2024","COM","2022","96","0","96","2024-12-30"
"21670","2024","COM","2022","302","4","306","2024-12-30"
"21671","2024","COM","2022","50","1","51","2024-12-30"
"21672","2024","COM","2022","29","1","30","2024-12-30"
"21673","2024","COM","2022","215","3","218","2024-12-30"
"21674","2024","COM","2022","210","4","214","2024-12-30"
"21675","2024","COM","2022","36","1","37","2024-12-30"
"21676","2024","COM","2022","209","6","215","2024-12-30"
"21677","2024","COM","2022","110","2","112","2024-12-30"
"21678","2024","COM","2022","186","4","190","2024-12-30"
"21679","2024","COM","2022","143","2","145","2024-12-30"
"21680","2024","COM","2022","499","8","507","2024-12-30"
"21681","2024","COM","2022","100","2","102","2024-12-30"
"21682","2024","COM","2022","252","3","255","2024-12-30"
"21683","2024","COM","2022","360","7","367","2024-12-30"
"21684","2024","COM","2022","919","46","965","2024-12-30"
"21685","2024","COM","2022","252","6","258","2024-12-30"
"21686","2024","COM","2022","143","2","145","2024-12-30"
"21687","2024","COM","2022","144","2","146","2024-12-30"
"21688","2024","COM","2022","115","4","119","2024-12-30"
"21689","2024","COM","2022","168","7","175","2024-12-30"
"21690","2024","COM","2022","99","2","101","2024-12-30"
"21691","2024","COM","2022","403","14","417","2024-12-30"
"21692","2024","COM","2022","245","8","253","2024-12-30"
"21693","2024","COM","2022","70","1","71","2024-12-30"
"21694","2024","COM","2022","23","0","23","2024-12-30"
"21695","2024","COM","2022","60","0","60","2024-12-30"
"21696","2024","COM","2022","87","1","88","2024-12-30"
"21698","2024","COM","2022","400","8","408","2024-12-30"
"21699","2024","COM","2022","1206","13","1219","2024-12-30"
"21700","2024","COM","2022","86","1","87","2024-12-30"
"21701","2024","COM","2022","124","4","128","2024-12-30"
"21702","2024","COM","2022","261","5","266","2024-12-30"
"21703","2024","COM","2022","46","0","46","2024-12-30"
"21704","2024","COM","2022","111","0","111","2024-12-30"
"21705","2024","COM","2022","67","0","67","2024-12-30"
"21706","2024","COM","2022","106","2","108","2024-12-30"
"21707","2024","COM","2022","227","2","229","2024-12-30"
"21708","2024","COM","2022","330","11","341","2024-12-30"
"21709","2024","COM","2022","180","4","184","2024-12-30"
"21710","2024","COM","2022","1056","14","1070","2024-12-30"
"21711","2024","COM","2022","96","4","100","2024-12-30"
"21712","2024","COM","2022","225","15","240","2024-12-30"
"21713","2024","COM","2022","360","4","364","2024-12-30"
"21714","2024","COM","2022","341","9","350","2024-12-30"
"21715","2024","COM","2022","193","3","196","2024-12-30"
"21716","2024","COM","2022","153","6","159","2024-12-30"
"21717","2024","COM","2022","270","9","279","2024-12-30"
"22001","2024","COM","2022","592","20","612","2024-12-30"
"22002","2024","COM","2022","1170","38","1208","2024-12-30"
"22003","2024","COM","2022","953","79","1032","2024-12-30"
"22004","2024","COM","2022","4862","91","4953","2024-12-30"
"22005","2024","COM","2022","1031","20","1051","2024-12-30"
"22006","2024","COM","2022","272","8","280","2024-12-30"
"22008","2024","COM","2022","1143","43","1186","2024-12-30"
"22009","2024","COM","2022","178","1","179","2024-12-30"
"22011","2024","COM","2022","1054","26","1080","2024-12-30"
"22012","2024","COM","2022","845","15","860","2024-12-30"
"22013","2024","COM","2022","2126","42","2168","2024-12-30"
"22014","2024","COM","2022","1247","23","1270","2024-12-30"
"22015","2024","COM","2022","1695","35","1730","2024-12-30"
"22016","2024","COM","2022","427","11","438","2024-12-30"
"22018","2024","COM","2022","316","4","320","2024-12-30"
"22019","2024","COM","2022","510","11","521","2024-12-30"
"22020","2024","COM","2022","2931","74","3005","2024-12-30"
"22021","2024","COM","2022","1155","28","1183","2024-12-30"
"22023","2024","COM","2022","409","2","411","2024-12-30"
"22024","2024","COM","2022","236","6","242","2024-12-30"
"22025","2024","COM","2022","2274","26","2300","2024-12-30"
"22026","2024","COM","2022","722","13","735","2024-12-30"
"22027","2024","COM","2022","408","12","420","2024-12-30"
"22028","2024","COM","2022","832","25","857","2024-12-30"
"22029","2024","COM","2022","348","11","359","2024-12-30"
"22030","2024","COM","2022","904","19","923","2024-12-30"
"22031","2024","COM","2022","667","12","679","2024-12-30"
"22032","2024","COM","2022","2506","134","2640","2024-12-30"
"22033","2024","COM","2022","355","9","364","2024-12-30"
"22034","2024","COM","2022","1548","57","1605","2024-12-30"
"22035","2024","COM","2022","1053","23","1076","2024-12-30"
"22036","2024","COM","2022","211","7","218","2024-12-30"
"22037","2024","COM","2022","403","4","407","2024-12-30"
"22039","2024","COM","2022","572","8","580","2024-12-30"
"22040","2024","COM","2022","538","12","550","2024-12-30"
"22041","2024","COM","2022","251","4","255","2024-12-30"
"22042","2024","COM","2022","493","9","502","2024-12-30"
"22043","2024","COM","2022","225","7","232","2024-12-30"
"22044","2024","COM","2022","1840","47","1887","2024-12-30"
"22045","2024","COM","2022","397","4","401","2024-12-30"
"22046","2024","COM","2022","6420","115","6535","2024-12-30"
"22047","2024","COM","2022","913","16","929","2024-12-30"
"22048","2024","COM","2022","2270","51","2321","2024-12-30"
"22049","2024","COM","2022","1664","38","1702","2024-12-30"
"22050","2024","COM","2022","14966","576","15542","2024-12-30"
"22052","2024","COM","2022","388","6","394","2024-12-30"
"22053","2024","COM","2022","676","12","688","2024-12-30"
"22054","2024","COM","2022","3929","89","4018","2024-12-30"
"22055","2024","COM","2022","7020","212","7232","2024-12-30"
"22056","2024","COM","2022","1787","27","1814","2024-12-30"
"22057","2024","COM","2022","410","12","422","2024-12-30"
"22059","2024","COM","2022","1382","39","1421","2024-12-30"
"22060","2024","COM","2022","648","9","657","2024-12-30"
"22061","2024","COM","2022","1412","26","1438","2024-12-30"
"22062","2024","COM","2022","549","13","562","2024-12-30"
"22063","2024","COM","2022","552","8","560","2024-12-30"
"22064","2024","COM","2022","912","23","935","2024-12-30"
"22065","2024","COM","2022","1716","35","1751","2024-12-30"
"22067","2024","COM","2022","2588","59","2647","2024-12-30"
"22068","2024","COM","2022","429","7","436","2024-12-30"
"22069","2024","COM","2022","217","5","222","2024-12-30"
"22070","2024","COM","2022","7127","562","7689","2024-12-30"
"22071","2024","COM","2022","711","14","725","2024-12-30"
"22072","2024","COM","2022","406","7","413","2024-12-30"
"22073","2024","COM","2022","379","15","394","2024-12-30"
"22074","2024","COM","2022","650","15","665","2024-12-30"
"22075","2024","COM","2022","708","13","721","2024-12-30"
"22076","2024","COM","2022","1429","31","1460","2024-12-30"
"22077","2024","COM","2022","1263","21","1284","2024-12-30"
"22079","2024","COM","2022","2315","41","2356","2024-12-30"
"22081","2024","COM","2022","4304","91","4395","2024-12-30"
"22082","2024","COM","2022","912","36","948","2024-12-30"
"22083","2024","COM","2022","688","8","696","2024-12-30"
"22084","2024","COM","2022","2528","51","2579","2024-12-30"
"22085","2024","COM","2022","286","7","293","2024-12-30"
"22086","2024","COM","2022","634","12","646","2024-12-30"
"22087","2024","COM","2022","636","19","655","2024-12-30"
"22088","2024","COM","2022","247","5","252","2024-12-30"
"22090","2024","COM","2022","1106","30","1136","2024-12-30"
"22091","2024","COM","2022","429","9","438","2024-12-30"
"22092","2024","COM","2022","269","3","272","2024-12-30"
"22093","2024","COM","2022","16911","494","17405","2024-12-30"
"22094","2024","COM","2022","1602","59","1661","2024-12-30"
"22095","2024","COM","2022","169","10","179","2024-12-30"
"22096","2024","COM","2022","442","4","446","2024-12-30"
"22097","2024","COM","2022","749","14","763","2024-12-30"
"22098","2024","COM","2022","1445","37","1482","2024-12-30"
"22099","2024","COM","2022","1091","25","1116","2024-12-30"
"22101","2024","COM","2022","1161","26","1187","2024-12-30"
"22103","2024","COM","2022","992","40","1032","2024-12-30"
"22104","2024","COM","2022","558","21","579","2024-12-30"
"22105","2024","COM","2022","1160","19","1179","2024-12-30"
"22106","2024","COM","2022","7947","234","8181","2024-12-30"
"22107","2024","COM","2022","1237","34","1271","2024-12-30"
"22108","2024","COM","2022","121","0","121","2024-12-30"
"22109","2024","COM","2022","251","6","257","2024-12-30"
"22110","2024","COM","2022","573","14","587","2024-12-30"
"22111","2024","COM","2022","400","7","407","2024-12-30"
"22112","2024","COM","2022","431","12","443","2024-12-30"
"22113","2024","COM","2022","20525","756","21281","2024-12-30"
"22114","2024","COM","2022","866","17","883","2024-12-30"
"22115","2024","COM","2022","465","12","477","2024-12-30"
"22116","2024","COM","2022","1380","22","1402","2024-12-30"
"22117","2024","COM","2022","1799","35","1834","2024-12-30"
"22118","2024","COM","2022","4235","107","4342","2024-12-30"
"22119","2024","COM","2022","602","10","612","2024-12-30"
"22121","2024","COM","2022","1907","30","1937","2024-12-30"
"22122","2024","COM","2022","742","14","756","2024-12-30"
"22124","2024","COM","2022","215","7","222","2024-12-30"
"22126","2024","COM","2022","154","3","157","2024-12-30"
"22127","2024","COM","2022","1632","37","1669","2024-12-30"
"22128","2024","COM","2022","421","6","427","2024-12-30"
"22129","2024","COM","2022","74","2","76","2024-12-30"
"22131","2024","COM","2022","788","13","801","2024-12-30"
"22132","2024","COM","2022","246","0","246","2024-12-30"
"22133","2024","COM","2022","644","14","658","2024-12-30"
"22134","2024","COM","2022","3053","116","3169","2024-12-30"
"22135","2024","COM","2022","2393","48","2441","2024-12-30"
"22136","2024","COM","2022","9875","340","10215","2024-12-30"
"22137","2024","COM","2022","1455","31","1486","2024-12-30"
"22138","2024","COM","2022","360","3","363","2024-12-30"
"22139","2024","COM","2022","75","2","77","2024-12-30"
"22140","2024","COM","2022","621","6","627","2024-12-30"
"22141","2024","COM","2022","234","6","240","2024-12-30"
"22143","2024","COM","2022","1738","24","1762","2024-12-30"
"22144","2024","COM","2022","1326","23","1349","2024-12-30"
"22145","2024","COM","2022","809","22","831","2024-12-30"
"22146","2024","COM","2022","420","16","436","2024-12-30"
"22147","2024","COM","2022","2950","233","3183","2024-12-30"
"22148","2024","COM","2022","242","7","249","2024-12-30"
"22149","2024","COM","2022","463","10","473","2024-12-30"
"22150","2024","COM","2022","974","13","987","2024-12-30"
"22152","2024","COM","2022","1263","24","1287","2024-12-30"
"22153","2024","COM","2022","742","16","758","2024-12-30"
"22155","2024","COM","2022","2159","44","2203","2024-12-30"
"22156","2024","COM","2022","642","11","653","2024-12-30"
"22157","2024","COM","2022","659","23","682","2024-12-30"
"22158","2024","COM","2022","2528","66","2594","2024-12-30"
"22160","2024","COM","2022","981","20","1001","2024-12-30"
"22161","2024","COM","2022","2769","108","2877","2024-12-30"
"22162","2024","COM","2022","7266","308","7574","2024-12-30"
"22163","2024","COM","2022","674","21","695","2024-12-30"
"22164","2024","COM","2022","1891","43","1934","2024-12-30"
"22165","2024","COM","2022","608","19","627","2024-12-30"
"22166","2024","COM","2022","2548","56","2604","2024-12-30"
"22168","2024","COM","2022","7260","139","7399","2024-12-30"
"22169","2024","COM","2022","184","5","189","2024-12-30"
"22170","2024","COM","2022","1705","35","1740","2024-12-30"
"22171","2024","COM","2022","4571","76","4647","2024-12-30"
"22172","2024","COM","2022","3095","54","3149","2024-12-30"
"22174","2024","COM","2022","716","12","728","2024-12-30"
"22175","2024","COM","2022","1602","21","1623","2024-12-30"
"22176","2024","COM","2022","6909","113","7022","2024-12-30"
"22177","2024","COM","2022","1440","32","1472","2024-12-30"
"22178","2024","COM","2022","1317","45","1362","2024-12-30"
"22179","2024","COM","2022","1611","27","1638","2024-12-30"
"22180","2024","COM","2022","1947","33","1980","2024-12-30"
"22181","2024","COM","2022","687","16","703","2024-12-30"
"22182","2024","COM","2022","3283","86","3369","2024-12-30"
"22183","2024","COM","2022","3751","83","3834","2024-12-30"
"22184","2024","COM","2022","1583","32","1615","2024-12-30"
"22185","2024","COM","2022","2533","45","2578","2024-12-30"
"22186","2024","COM","2022","4094","131","4225","2024-12-30"
"22187","2024","COM","2022","14527","475","15002","2024-12-30"
"22188","2024","COM","2022","1119","13","1132","2024-12-30"
"22189","2024","COM","2022","562","12","574","2024-12-30"
"22190","2024","COM","2022","4043","84","4127","2024-12-30"
"22193","2024","COM","2022","1637","34","1671","2024-12-30"
"22194","2024","COM","2022","3649","97","3746","2024-12-30"
"22195","2024","COM","2022","2334","34","2368","2024-12-30"
"22196","2024","COM","2022","925","21","946","2024-12-30"
"22197","2024","COM","2022","2974","77","3051","2024-12-30"
"22198","2024","COM","2022","3828","103","3931","2024-12-30"
"22199","2024","COM","2022","1186","19","1205","2024-12-30"
"22200","2024","COM","2022","609","10","619","2024-12-30"
"22201","2024","COM","2022","757","13","770","2024-12-30"
"22202","2024","COM","2022","754","15","769","2024-12-30"
"22203","2024","COM","2022","4117","70","4187","2024-12-30"
"22204","2024","COM","2022","1227","19","1246","2024-12-30"
"22205","2024","COM","2022","445","3","448","2024-12-30"
"22206","2024","COM","2022","3968","63","4031","2024-12-30"
"22207","2024","COM","2022","2230","39","2269","2024-12-30"
"22208","2024","COM","2022","1749","40","1789","2024-12-30"
"22209","2024","COM","2022","4379","69","4448","2024-12-30"
"22210","2024","COM","2022","2985","132","3117","2024-12-30"
"22211","2024","COM","2022","3741","105","3846","2024-12-30"
"22212","2024","COM","2022","1140","31","1171","2024-12-30"
"22213","2024","COM","2022","3423","108","3531","2024-12-30"
"22214","2024","COM","2022","3129","71","3200","2024-12-30"
"22215","2024","COM","2022","11347","328","11675","2024-12-30"
"22216","2024","COM","2022","766","14","780","2024-12-30"
"22217","2024","COM","2022","428","9","437","2024-12-30"
"22218","2024","COM","2022","1198","13","1211","2024-12-30"
"22219","2024","COM","2022","2390","54","2444","2024-12-30"
"22220","2024","COM","2022","1602","47","1649","2024-12-30"
"22221","2024","COM","2022","1745","30","1775","2024-12-30"
"22222","2024","COM","2022","4677","91","4768","2024-12-30"
"22223","2024","COM","2022","2013","274","2287","2024-12-30"
"22224","2024","COM","2022","1591","54","1645","2024-12-30"
"22225","2024","COM","2022","5418","107","5525","2024-12-30"
"22226","2024","COM","2022","2460","68","2528","2024-12-30"
"22227","2024","COM","2022","799","12","811","2024-12-30"
"22228","2024","COM","2022","1473","24","1497","2024-12-30"
"22229","2024","COM","2022","1057","25","1082","2024-12-30"
"22231","2024","COM","2022","350","3","353","2024-12-30"
"22232","2024","COM","2022","2137","34","2171","2024-12-30"
"22233","2024","COM","2022","2267","56","2323","2024-12-30"
"22234","2024","COM","2022","1149","10","1159","2024-12-30"
"22235","2024","COM","2022","202","5","207","2024-12-30"
"22236","2024","COM","2022","737","9","746","2024-12-30"
"22237","2024","COM","2022","2205","66","2271","2024-12-30"
"22238","2024","COM","2022","533","12","545","2024-12-30"
"22239","2024","COM","2022","1403","39","1442","2024-12-30"
"22240","2024","COM","2022","1156","17","1173","2024-12-30"
"22241","2024","COM","2022","1021","28","1049","2024-12-30"
"22242","2024","COM","2022","1513","28","1541","2024-12-30"
"22243","2024","COM","2022","557","16","573","2024-12-30"
"22244","2024","COM","2022","507","17","524","2024-12-30"
"22245","2024","COM","2022","984","15","999","2024-12-30"
"22246","2024","COM","2022","2119","41","2160","2024-12-30"
"22248","2024","COM","2022","1842","39","1881","2024-12-30"
"22249","2024","COM","2022","600","10","610","2024-12-30"
"22250","2024","COM","2022","1004","23","1027","2024-12-30"
"22251","2024","COM","2022","7393","217","7610","2024-12-30"
"22254","2024","COM","2022","1090","20","1110","2024-12-30"
"22255","2024","COM","2022","870","18","888","2024-12-30"
"22256","2024","COM","2022","1089","12","1101","2024-12-30"
"22257","2024","COM","2022","416","10","426","2024-12-30"
"22258","2024","COM","2022","3930","217","4147","2024-12-30"
"22259","2024","COM","2022","3963","88","4051","2024-12-30"
"22260","2024","COM","2022","591","11","602","2024-12-30"
"22261","2024","COM","2022","364","12","376","2024-12-30"
"22262","2024","COM","2022","2743","181","2924","2024-12-30"
"22263","2024","COM","2022","355","3","358","2024-12-30"
"22264","2024","COM","2022","2643","661","3304","2024-12-30"
"22265","2024","COM","2022","1790","53","1843","2024-12-30"
"22266","2024","COM","2022","3282","273","3555","2024-12-30"
"22267","2024","COM","2022","402","9","411","2024-12-30"
"22268","2024","COM","2022","596","11","607","2024-12-30"
"22269","2024","COM","2022","253","3","256","2024-12-30"
"22271","2024","COM","2022","367","3","370","2024-12-30"
"22272","2024","COM","2022","2202","46","2248","2024-12-30"
"22273","2024","COM","2022","2376","41","2417","2024-12-30"
"22274","2024","COM","2022","395","5","400","2024-12-30"
"22275","2024","COM","2022","1219","30","1249","2024-12-30"
"22276","2024","COM","2022","261","7","268","2024-12-30"
"22277","2024","COM","2022","2285","48","2333","2024-12-30"
"22278","2024","COM","2022","44607","1379","45986","2024-12-30"
"22279","2024","COM","2022","1132","40","1172","2024-12-30"
"22280","2024","COM","2022","1140","39","1179","2024-12-30"
"22281","2024","COM","2022","1554","28","1582","2024-12-30"
"22282","2024","COM","2022","3353","79","3432","2024-12-30"
"22283","2024","COM","2022","868","24","892","2024-12-30"
"22284","2024","COM","2022","297","8","305","2024-12-30"
"22285","2024","COM","2022","258","9","267","2024-12-30"
"22286","2024","COM","2022","490","7","497","2024-12-30"
"22287","2024","COM","2022","1467","33","1500","2024-12-30"
"22288","2024","COM","2022","372","5","377","2024-12-30"
"22289","2024","COM","2022","212","1","213","2024-12-30"
"22291","2024","COM","2022","242","8","250","2024-12-30"
"22293","2024","COM","2022","389","13","402","2024-12-30"
"22294","2024","COM","2022","304","4","308","2024-12-30"
"22295","2024","COM","2022","315","13","328","2024-12-30"
"22296","2024","COM","2022","667","10","677","2024-12-30"
"22299","2024","COM","2022","1535","44","1579","2024-12-30"
"22300","2024","COM","2022","413","5","418","2024-12-30"
"22302","2024","COM","2022","909","17","926","2024-12-30"
"22304","2024","COM","2022","691","10","701","2024-12-30"
"22305","2024","COM","2022","456","8","464","2024-12-30"
"22306","2024","COM","2022","590","9","599","2024-12-30"
"22307","2024","COM","2022","2072","49","2121","2024-12-30"
"22308","2024","COM","2022","649","17","666","2024-12-30"
"22309","2024","COM","2022","190","4","194","2024-12-30"
"22310","2024","COM","2022","533","7","540","2024-12-30"
"22311","2024","COM","2022","883","39","922","2024-12-30"
"22312","2024","COM","2022","220","9","229","2024-12-30"
"22313","2024","COM","2022","321","8","329","2024-12-30"
"22314","2024","COM","2022","399","7","406","2024-12-30"
"22315","2024","COM","2022","285","8","293","2024-12-30"
"22316","2024","COM","2022","460","7","467","2024-12-30"
"22317","2024","COM","2022","272","5","277","2024-12-30"
"22318","2024","COM","2022","320","9","329","2024-12-30"
"22319","2024","COM","2022","447","12","459","2024-12-30"
"22320","2024","COM","2022","168","4","172","2024-12-30"
"22321","2024","COM","2022","1536","42","1578","2024-12-30"
"22322","2024","COM","2022","388","7","395","2024-12-30"
"22323","2024","COM","2022","833","13","846","2024-12-30"
"22324","2024","COM","2022","1289","54","1343","2024-12-30"
"22325","2024","COM","2022","3253","226","3479","2024-12-30"
"22326","2024","COM","2022","548","3","551","2024-12-30"
"22327","2024","COM","2022","1630","28","1658","2024-12-30"
"22328","2024","COM","2022","427","7","434","2024-12-30"
"22330","2024","COM","2022","377","11","388","2024-12-30"
"22331","2024","COM","2022","187","1","188","2024-12-30"
"22332","2024","COM","2022","521","9","530","2024-12-30"
"22333","2024","COM","2022","755","28","783","2024-12-30"
"22334","2024","COM","2022","124","8","132","2024-12-30"
"22335","2024","COM","2022","241","1","242","2024-12-30"
"22337","2024","COM","2022","1116","24","1140","2024-12-30"
"22338","2024","COM","2022","752","10","762","2024-12-30"
"22339","2024","COM","2022","2599","68","2667","2024-12-30"
"22340","2024","COM","2022","1201","30","1231","2024-12-30"
"22341","2024","COM","2022","700","15","715","2024-12-30"
"22342","2024","COM","2022","439","7","446","2024-12-30"
"22343","2024","COM","2022","3821","118","3939","2024-12-30"
"22344","2024","COM","2022","763","17","780","2024-12-30"
"22345","2024","COM","2022","822","12","834","2024-12-30"
"22346","2024","COM","2022","896","19","915","2024-12-30"
"22347","2024","COM","2022","1069","22","1091","2024-12-30"
"22348","2024","COM","2022","504","8","512","2024-12-30"
"22349","2024","COM","2022","1468","39","1507","2024-12-30"
"22350","2024","COM","2022","201","6","207","2024-12-30"
"22351","2024","COM","2022","524","19","543","2024-12-30"
"22352","2024","COM","2022","279","3","282","2024-12-30"
"22353","2024","COM","2022","2532","80","2612","2024-12-30"
"22354","2024","COM","2022","1100","19","1119","2024-12-30"
"22356","2024","COM","2022","947","27","974","2024-12-30"
"22358","2024","COM","2022","523","7","530","2024-12-30"
"22359","2024","COM","2022","447","6","453","2024-12-30"
"22360","2024","COM","2022","8462","167","8629","2024-12-30"
"22361","2024","COM","2022","630","12","642","2024-12-30"
"22362","2024","COM","2022","2349","274","2623","2024-12-30"
"22363","2024","COM","2022","1240","27","1267","2024-12-30"
"22364","2024","COM","2022","2875","81","2956","2024-12-30"
"22365","2024","COM","2022","182","3","185","2024-12-30"
"22366","2024","COM","2022","406","6","412","2024-12-30"
"22368","2024","COM","2022","728","29","757","2024-12-30"
"22369","2024","COM","2022","806","13","819","2024-12-30"
"22370","2024","COM","2022","355","8","363","2024-12-30"
"22371","2024","COM","2022","1154","21","1175","2024-12-30"
"22372","2024","COM","2022","2238","36","2274","2024-12-30"
"22373","2024","COM","2022","107","2","109","2024-12-30"
"22375","2024","COM","2022","682","5","687","2024-12-30"
"22376","2024","COM","2022","1680","45","1725","2024-12-30"
"22377","2024","COM","2022","813","21","834","2024-12-30"
"22378","2024","COM","2022","224","7","231","2024-12-30"
"22379","2024","COM","2022","1581","37","1618","2024-12-30"
"22380","2024","COM","2022","681","14","695","2024-12-30"
"22381","2024","COM","2022","355","9","364","2024-12-30"
"22383","2024","COM","2022","219","5","224","2024-12-30"
"22384","2024","COM","2022","1134","28","1162","2024-12-30"
"22385","2024","COM","2022","1142","26","1168","2024-12-30"
"22386","2024","COM","2022","760","19","779","2024-12-30"
"22387","2024","COM","2022","1276","29","1305","2024-12-30"
"22388","2024","COM","2022","1294","27","1321","2024-12-30"
"22389","2024","COM","2022","4980","102","5082","2024-12-30"
"22390","2024","COM","2022","770","15","785","2024-12-30"
"22391","2024","COM","2022","1106","17","1123","2024-12-30"
"23001","2024","COM","2022","1442","232","1674","2024-12-30"
"23002","2024","COM","2022","1028","12","1040","2024-12-30"
"23003","2024","COM","2022","141","3","144","2024-12-30"
"23004","2024","COM","2022","549","9","558","2024-12-30"
"23005","2024","COM","2022","196","0","196","2024-12-30"
"23006","2024","COM","2022","205","4","209","2024-12-30"
"23007","2024","COM","2022","236","4","240","2024-12-30"
"23008","2024","COM","2022","3036","144","3180","2024-12-30"
"23009","2024","COM","2022","92","0","92","2024-12-30"
"23010","2024","COM","2022","117","2","119","2024-12-30"
"23011","2024","COM","2022","163","4","167","2024-12-30"
"23012","2024","COM","2022","116","1","117","2024-12-30"
"23013","2024","COM","2022","1153","18","1171","2024-12-30"
"23014","2024","COM","2022","116","1","117","2024-12-30"
"23015","2024","COM","2022","803","17","820","2024-12-30"
"23016","2024","COM","2022","181","3","184","2024-12-30"
"23017","2024","COM","2022","167","2","169","2024-12-30"
"23018","2024","COM","2022","229","6","235","2024-12-30"
"23019","2024","COM","2022","30","0","30","2024-12-30"
"23020","2024","COM","2022","357","3","360","2024-12-30"
"23021","2024","COM","2022","767","12","779","2024-12-30"
"23022","2024","COM","2022","386","6","392","2024-12-30"
"23023","2024","COM","2022","110","1","111","2024-12-30"
"23024","2024","COM","2022","532","13","545","2024-12-30"
"23025","2024","COM","2022","1354","24","1378","2024-12-30"
"23026","2024","COM","2022","371","4","375","2024-12-30"
"23027","2024","COM","2022","226","6","232","2024-12-30"
"23028","2024","COM","2022","117","3","120","2024-12-30"
"23029","2024","COM","2022","233","2","235","2024-12-30"
"23030","2024","COM","2022","2408","211","2619","2024-12-30"
"23031","2024","COM","2022","1239","15","1254","2024-12-30"
"23032","2024","COM","2022","687","14","701","2024-12-30"
"23033","2024","COM","2022","452","8","460","2024-12-30"
"23034","2024","COM","2022","31","1","32","2024-12-30"
"23035","2024","COM","2022","713","5","718","2024-12-30"
"23036","2024","COM","2022","1045","14","1059","2024-12-30"
"23037","2024","COM","2022","75","1","76","2024-12-30"
"23038","2024","COM","2022","259","7","266","2024-12-30"
"23039","2024","COM","2022","532","24","556","2024-12-30"
"23040","2024","COM","2022","159","1","160","2024-12-30"
"23041","2024","COM","2022","251","7","258","2024-12-30"
"23042","2024","COM","2022","125","1","126","2024-12-30"
"23043","2024","COM","2022","97","0","97","2024-12-30"
"23044","2024","COM","2022","86","2","88","2024-12-30"
"23045","2024","COM","2022","827","18","845","2024-12-30"
"23046","2024","COM","2022","79","3","82","2024-12-30"
"23047","2024","COM","2022","243","7","250","2024-12-30"
"23048","2024","COM","2022","480","10","490","2024-12-30"
"23049","2024","COM","2022","255","8","263","2024-12-30"
"23050","2024","COM","2022","118","1","119","2024-12-30"
"23051","2024","COM","2022","77","1","78","2024-12-30"
"23052","2024","COM","2022","444","10","454","2024-12-30"
"23053","2024","COM","2022","206","0","206","2024-12-30"
"23054","2024","COM","2022","194","1","195","2024-12-30"
"23055","2024","COM","2022","29","0","29","2024-12-30"
"23056","2024","COM","2022","310","3","313","2024-12-30"
"23057","2024","COM","2022","545","3","548","2024-12-30"
"23058","2024","COM","2022","105","1","106","2024-12-30"
"23059","2024","COM","2022","97","0","97","2024-12-30"
"23060","2024","COM","2022","138","6","144","2024-12-30"
"23061","2024","COM","2022","736","15","751","2024-12-30"
"23062","2024","COM","2022","560","8","568","2024-12-30"
"23063","2024","COM","2022","151","1","152","2024-12-30"
"23064","2024","COM","2022","653","3","656","2024-12-30"
"23065","2024","COM","2022","288","9","297","2024-12-30"
"23066","2024","COM","2022","192","13","205","2024-12-30"
"23067","2024","COM","2022","737","7","744","2024-12-30"
"23068","2024","COM","2022","514","7","521","2024-12-30"
"23069","2024","COM","2022","389","3","392","2024-12-30"
"23070","2024","COM","2022","433","9","442","2024-12-30"
"23071","2024","COM","2022","187","3","190","2024-12-30"
"23072","2024","COM","2022","232","6","238","2024-12-30"
"23073","2024","COM","2022","405","7","412","2024-12-30"
"23074","2024","COM","2022","188","2","190","2024-12-30"
"23075","2024","COM","2022","1086","23","1109","2024-12-30"
"23076","2024","COM","2022","1285","24","1309","2024-12-30"
"23077","2024","COM","2022","448","10","458","2024-12-30"
"23078","2024","COM","2022","189","2","191","2024-12-30"
"23079","2024","COM","2022","1552","171","1723","2024-12-30"
"23080","2024","COM","2022","108","2","110","2024-12-30"
"23081","2024","COM","2022","300","6","306","2024-12-30"
"23082","2024","COM","2022","307","6","313","2024-12-30"
"23083","2024","COM","2022","255","6","261","2024-12-30"
"23084","2024","COM","2022","143","2","145","2024-12-30"
"23086","2024","COM","2022","241","3","244","2024-12-30"
"23087","2024","COM","2022","501","16","517","2024-12-30"
"23088","2024","COM","2022","113","2","115","2024-12-30"
"23089","2024","COM","2022","724","12","736","2024-12-30"
"23090","2024","COM","2022","371","6","377","2024-12-30"
"23091","2024","COM","2022","179","2","181","2024-12-30"
"23092","2024","COM","2022","644","17","661","2024-12-30"
"23093","2024","COM","2022","1565","22","1587","2024-12-30"
"23095","2024","COM","2022","1182","33","1215","2024-12-30"
"23096","2024","COM","2022","12814","630","13444","2024-12-30"
"23097","2024","COM","2022","292","6","298","2024-12-30"
"23098","2024","COM","2022","94","2","96","2024-12-30"
"23099","2024","COM","2022","319","6","325","2024-12-30"
"23100","2024","COM","2022","477","7","484","2024-12-30"
"23101","2024","COM","2022","383","5","388","2024-12-30"
"23102","2024","COM","2022","356","7","363","2024-12-30"
"23103","2024","COM","2022","319","17","336","2024-12-30"
"23104","2024","COM","2022","241","3","244","2024-12-30"
"23105","2024","COM","2022","642","3","645","2024-12-30"
"23106","2024","COM","2022","371","4","375","2024-12-30"
"23107","2024","COM","2022","136","2","138","2024-12-30"
"23108","2024","COM","2022","143","3","146","2024-12-30"
"23109","2024","COM","2022","207","2","209","2024-12-30"
"23110","2024","COM","2022","55","1","56","2024-12-30"
"23111","2024","COM","2022","236","2","238","2024-12-30"
"23112","2024","COM","2022","720","17","737","2024-12-30"
"23113","2024","COM","2022","291","4","295","2024-12-30"
"23114","2024","COM","2022","409","4","413","2024-12-30"
"23115","2024","COM","2022","240","2","242","2024-12-30"
"23116","2024","COM","2022","532","9","541","2024-12-30"
"23117","2024","COM","2022","284","9","293","2024-12-30"
"23118","2024","COM","2022","175","4","179","2024-12-30"
"23119","2024","COM","2022","43","1","44","2024-12-30"
"23120","2024","COM","2022","179","4","183","2024-12-30"
"23122","2024","COM","2022","68","3","71","2024-12-30"
"23123","2024","COM","2022","181","2","183","2024-12-30"
"23124","2024","COM","2022","642","16","658","2024-12-30"
"23125","2024","COM","2022","94","6","100","2024-12-30"
"23127","2024","COM","2022","198","5","203","2024-12-30"
"23128","2024","COM","2022","123","4","127","2024-12-30"
"23129","2024","COM","2022","56","1","57","2024-12-30"
"23130","2024","COM","2022","525","5","530","2024-12-30"
"23131","2024","COM","2022","661","16","677","2024-12-30"
"23132","2024","COM","2022","372","7","379","2024-12-30"
"23133","2024","COM","2022","370","10","380","2024-12-30"
"23134","2024","COM","2022","217","3","220","2024-12-30"
"23136","2024","COM","2022","276","4","280","2024-12-30"
"23137","2024","COM","2022","523","14","537","2024-12-30"
"23138","2024","COM","2022","161","1","162","2024-12-30"
"23139","2024","COM","2022","558","6","564","2024-12-30"
"23140","2024","COM","2022","433","8","441","2024-12-30"
"23141","2024","COM","2022","667","16","683","2024-12-30"
"23142","2024","COM","2022","279","7","286","2024-12-30"
"23143","2024","COM","2022","495","9","504","2024-12-30"
"23144","2024","COM","2022","228","4","232","2024-12-30"
"23145","2024","COM","2022","301","3","304","2024-12-30"
"23146","2024","COM","2022","238","6","244","2024-12-30"
"23147","2024","COM","2022","97","1","98","2024-12-30"
"23148","2024","COM","2022","250","4","254","2024-12-30"
"23149","2024","COM","2022","713","5","718","2024-12-30"
"23150","2024","COM","2022","151","3","154","2024-12-30"
"23151","2024","COM","2022","422","9","431","2024-12-30"
"23152","2024","COM","2022","68","0","68","2024-12-30"
"23154","2024","COM","2022","715","11","726","2024-12-30"
"23155","2024","COM","2022","359","3","362","2024-12-30"
"23156","2024","COM","2022","83","0","83","2024-12-30"
"23157","2024","COM","2022","96","0","96","2024-12-30"
"23158","2024","COM","2022","150","2","152","2024-12-30"
"23159","2024","COM","2022","144","4","148","2024-12-30"
"23160","2024","COM","2022","262","1","263","2024-12-30"
"23162","2024","COM","2022","371","4","375","2024-12-30"
"23164","2024","COM","2022","474","6","480","2024-12-30"
"23165","2024","COM","2022","572","7","579","2024-12-30"
"23166","2024","COM","2022","195","7","202","2024-12-30"
"23167","2024","COM","2022","347","2","349","2024-12-30"
"23168","2024","COM","2022","758","18","776","2024-12-30"
"23169","2024","COM","2022","659","12","671","2024-12-30"
"23170","2024","COM","2022","209","6","215","2024-12-30"
"23171","2024","COM","2022","103","0","103","2024-12-30"
"23172","2024","COM","2022","121","1","122","2024-12-30"
"23173","2024","COM","2022","139","3","142","2024-12-30"
"23174","2024","COM","2022","591","5","596","2024-12-30"
"23175","2024","COM","2022","114","0","114","2024-12-30"
"23176","2024","COM","2022","4928","227","5155","2024-12-30"
"23177","2024","COM","2022","1059","31","1090","2024-12-30"
"23178","2024","COM","2022","186","2","188","2024-12-30"
"23179","2024","COM","2022","290","4","294","2024-12-30"
"23180","2024","COM","2022","453","9","462","2024-12-30"
"23181","2024","COM","2022","152","2","154","2024-12-30"
"23182","2024","COM","2022","163","2","165","2024-12-30"
"23183","2024","COM","2022","88","0","88","2024-12-30"
"23184","2024","COM","2022","95","5","100","2024-12-30"
"23185","2024","COM","2022","317","2","319","2024-12-30"
"23186","2024","COM","2022","150","5","155","2024-12-30"
"23187","2024","COM","2022","180","2","182","2024-12-30"
"23188","2024","COM","2022","203","5","208","2024-12-30"
"23189","2024","COM","2022","1134","20","1154","2024-12-30"
"23190","2024","COM","2022","162","1","163","2024-12-30"
"23191","2024","COM","2022","176","6","182","2024-12-30"
"23192","2024","COM","2022","1433","22","1455","2024-12-30"
"23193","2024","COM","2022","2531","75","2606","2024-12-30"
"23194","2024","COM","2022","120","1","121","2024-12-30"
"23195","2024","COM","2022","1079","29","1108","2024-12-30"
"23196","2024","COM","2022","252","6","258","2024-12-30"
"23197","2024","COM","2022","361","6","367","2024-12-30"
"23198","2024","COM","2022","145","2","147","2024-12-30"
"23199","2024","COM","2022","355","8","363","2024-12-30"
"23200","2024","COM","2022","160","10","170","2024-12-30"
"23201","2024","COM","2022","211","5","216","2024-12-30"
"23202","2024","COM","2022","225","4","229","2024-12-30"
"23203","2024","COM","2022","218","5","223","2024-12-30"
"23204","2024","COM","2022","150","1","151","2024-12-30"
"23205","2024","COM","2022","144","5","149","2024-12-30"
"23206","2024","COM","2022","678","7","685","2024-12-30"
"23207","2024","COM","2022","165","6","171","2024-12-30"
"23208","2024","COM","2022","398","9","407","2024-12-30"
"23209","2024","COM","2022","192","3","195","2024-12-30"
"23210","2024","COM","2022","233","5","238","2024-12-30"
"23211","2024","COM","2022","427","9","436","2024-12-30"
"23212","2024","COM","2022","126","1","127","2024-12-30"
"23213","2024","COM","2022","199","3","202","2024-12-30"
"23214","2024","COM","2022","264","4","268","2024-12-30"
"23215","2024","COM","2022","151","6","157","2024-12-30"
"23216","2024","COM","2022","152","5","157","2024-12-30"
"23217","2024","COM","2022","330","4","334","2024-12-30"
"23218","2024","COM","2022","100","3","103","2024-12-30"
"23219","2024","COM","2022","1126","18","1144","2024-12-30"
"23220","2024","COM","2022","553","12","565","2024-12-30"
"23221","2024","COM","2022","195","4","199","2024-12-30"
"23222","2024","COM","2022","166","5","171","2024-12-30"
"23223","2024","COM","2022","218","2","220","2024-12-30"
"23224","2024","COM","2022","71","0","71","2024-12-30"
"23225","2024","COM","2022","109","1","110","2024-12-30"
"23226","2024","COM","2022","164","1","165","2024-12-30"
"23227","2024","COM","2022","211","5","216","2024-12-30"
"23228","2024","COM","2022","196","6","202","2024-12-30"
"23229","2024","COM","2022","289","1","290","2024-12-30"
"23230","2024","COM","2022","165","5","170","2024-12-30"
"23232","2024","COM","2022","213","5","218","2024-12-30"
"23233","2024","COM","2022","119","0","119","2024-12-30"
"23234","2024","COM","2022","150","2","152","2024-12-30"
"23235","2024","COM","2022","721","15","736","2024-12-30"
"23236","2024","COM","2022","256","8","264","2024-12-30"
"23237","2024","COM","2022","55","0","55","2024-12-30"
"23238","2024","COM","2022","368","7","375","2024-12-30"
"23239","2024","COM","2022","629","10","639","2024-12-30"
"23240","2024","COM","2022","409","5","414","2024-12-30"
"23241","2024","COM","2022","198","4","202","2024-12-30"
"23242","2024","COM","2022","193","4","197","2024-12-30"
"23243","2024","COM","2022","147","2","149","2024-12-30"
"23244","2024","COM","2022","570","14","584","2024-12-30"
"23245","2024","COM","2022","1901","32","1933","2024-12-30"
"23246","2024","COM","2022","343","7","350","2024-12-30"
"23247","2024","COM","2022","1729","141","1870","2024-12-30"
"23248","2024","COM","2022","348","7","355","2024-12-30"
"23249","2024","COM","2022","221","3","224","2024-12-30"
"23250","2024","COM","2022","281","4","285","2024-12-30"
"23251","2024","COM","2022","119","2","121","2024-12-30"
"23252","2024","COM","2022","154","1","155","2024-12-30"
"23253","2024","COM","2022","170","3","173","2024-12-30"
"23254","2024","COM","2022","252","2","254","2024-12-30"
"23255","2024","COM","2022","132","1","133","2024-12-30"
"23257","2024","COM","2022","714","12","726","2024-12-30"
"23258","2024","COM","2022","322","6","328","2024-12-30"
"23259","2024","COM","2022","124","1","125","2024-12-30"
"23260","2024","COM","2022","201","1","202","2024-12-30"
"23261","2024","COM","2022","281","5","286","2024-12-30"
"23262","2024","COM","2022","164","3","167","2024-12-30"
"23263","2024","COM","2022","381","5","386","2024-12-30"
"23264","2024","COM","2022","51","1","52","2024-12-30"
"23265","2024","COM","2022","45","0","45","2024-12-30"
"23266","2024","COM","2022","166","4","170","2024-12-30"
"24001","2024","COM","2022","635","10","645","2024-12-30"
"24002","2024","COM","2022","1809","23","1832","2024-12-30"
"24004","2024","COM","2022","300","3","303","2024-12-30"
"24005","2024","COM","2022","384","9","393","2024-12-30"
"24006","2024","COM","2022","195","4","199","2024-12-30"
"24007","2024","COM","2022","543","9","552","2024-12-30"
"24008","2024","COM","2022","595","11","606","2024-12-30"
"24009","2024","COM","2022","266","9","275","2024-12-30"
"24010","2024","COM","2022","1478","46","1524","2024-12-30"
"24011","2024","COM","2022","1221","18","1239","2024-12-30"
"24012","2024","COM","2022","403","7","410","2024-12-30"
"24014","2024","COM","2022","615","11","626","2024-12-30"
"24015","2024","COM","2022","272","6","278","2024-12-30"
"24016","2024","COM","2022","825","20","845","2024-12-30"
"24018","2024","COM","2022","400","10","410","2024-12-30"
"24019","2024","COM","2022","449","6","455","2024-12-30"
"24020","2024","COM","2022","895","21","916","2024-12-30"
"24021","2024","COM","2022","410","1","411","2024-12-30"
"24022","2024","COM","2022","205","5","210","2024-12-30"
"24023","2024","COM","2022","316","10","326","2024-12-30"
"24024","2024","COM","2022","43","0","43","2024-12-30"
"24025","2024","COM","2022","243","7","250","2024-12-30"
"24026","2024","COM","2022","4365","83","4448","2024-12-30"
"24027","2024","COM","2022","356","1","357","2024-12-30"
"24028","2024","COM","2022","1730","36","1766","2024-12-30"
"24029","2024","COM","2022","558","6","564","2024-12-30"
"24030","2024","COM","2022","706","7","713","2024-12-30"
"24031","2024","COM","2022","308","6","314","2024-12-30"
"24032","2024","COM","2022","372","10","382","2024-12-30"
"24034","2024","COM","2022","281","5","286","2024-12-30"
"24035","2024","COM","2022","1310","38","1348","2024-12-30"
"24036","2024","COM","2022","178","3","181","2024-12-30"
"24037","2024","COM","2022","26852","774","27626","2024-12-30"
"24038","2024","COM","2022","435","8","443","2024-12-30"
"24039","2024","COM","2022","153","3","156","2024-12-30"
"24040","2024","COM","2022","447","11","458","2024-12-30"
"24042","2024","COM","2022","715","10","725","2024-12-30"
"24043","2024","COM","2022","146","6","152","2024-12-30"
"24045","2024","COM","2022","249","6","255","2024-12-30"
"24046","2024","COM","2022","110","3","113","2024-12-30"
"24048","2024","COM","2022","302","10","312","2024-12-30"
"24050","2024","COM","2022","352","4","356","2024-12-30"
"24051","2024","COM","2022","233","0","233","2024-12-30"
"24052","2024","COM","2022","123","3","126","2024-12-30"
"24053","2024","COM","2022","10628","335","10963","2024-12-30"
"24054","2024","COM","2022","589","12","601","2024-12-30"
"24055","2024","COM","2022","793","16","809","2024-12-30"
"24056","2024","COM","2022","240","6","246","2024-12-30"
"24057","2024","COM","2022","72","2","74","2024-12-30"
"24058","2024","COM","2022","237","8","245","2024-12-30"
"24059","2024","COM","2022","352","5","357","2024-12-30"
"24060","2024","COM","2022","67","2","69","2024-12-30"
"24061","2024","COM","2022","132","6","138","2024-12-30"
"24062","2024","COM","2022","175","2","177","2024-12-30"
"24063","2024","COM","2022","154","3","157","2024-12-30"
"24064","2024","COM","2022","3748","72","3820","2024-12-30"
"24066","2024","COM","2022","217","4","221","2024-12-30"
"24067","2024","COM","2022","2638","29","2667","2024-12-30"
"24068","2024","COM","2022","1954","47","2001","2024-12-30"
"24069","2024","COM","2022","385","9","394","2024-12-30"
"24070","2024","COM","2022","505","8","513","2024-12-30"
"24071","2024","COM","2022","372","2","374","2024-12-30"
"24073","2024","COM","2022","373","6","379","2024-12-30"
"24074","2024","COM","2022","541","11","552","2024-12-30"
"24075","2024","COM","2022","324","4","328","2024-12-30"
"24076","2024","COM","2022","418","15","433","2024-12-30"
"24077","2024","COM","2022","398","6","404","2024-12-30"
"24080","2024","COM","2022","461","12","473","2024-12-30"
"24081","2024","COM","2022","655","12","667","2024-12-30"
"24082","2024","COM","2022","1549","27","1576","2024-12-30"
"24083","2024","COM","2022","212","2","214","2024-12-30"
"24084","2024","COM","2022","101","1","102","2024-12-30"
"24085","2024","COM","2022","151","4","155","2024-12-30"
"24086","2024","COM","2022","449","9","458","2024-12-30"
"24087","2024","COM","2022","805","15","820","2024-12-30"
"24088","2024","COM","2022","336","3","339","2024-12-30"
"24090","2024","COM","2022","611","8","619","2024-12-30"
"24091","2024","COM","2022","1189","31","1220","2024-12-30"
"24094","2024","COM","2022","442","8","450","2024-12-30"
"24095","2024","COM","2022","404","2","406","2024-12-30"
"24096","2024","COM","2022","783","14","797","2024-12-30"
"24097","2024","COM","2022","343","13","356","2024-12-30"
"24098","2024","COM","2022","3077","71","3148","2024-12-30"
"24100","2024","COM","2022","511","11","522","2024-12-30"
"24101","2024","COM","2022","287","2","289","2024-12-30"
"24102","2024","COM","2022","4442","91","4533","2024-12-30"
"24104","2024","COM","2022","647","7","654","2024-12-30"
"24105","2024","COM","2022","140","1","141","2024-12-30"
"24106","2024","COM","2022","542","23","565","2024-12-30"
"24107","2024","COM","2022","386","8","394","2024-12-30"
"24108","2024","COM","2022","1058","27","1085","2024-12-30"
"24109","2024","COM","2022","102","3","105","2024-12-30"
"24110","2024","COM","2022","57","2","59","2024-12-30"
"24111","2024","COM","2022","75","1","76","2024-12-30"
"24113","2024","COM","2022","84","3","87","2024-12-30"
"24114","2024","COM","2022","73","1","74","2024-12-30"
"24115","2024","COM","2022","2162","34","2196","2024-12-30"
"24116","2024","COM","2022","181","2","183","2024-12-30"
"24117","2024","COM","2022","551","18","569","2024-12-30"
"24119","2024","COM","2022","226","3","229","2024-12-30"
"24120","2024","COM","2022","555","6","561","2024-12-30"
"24121","2024","COM","2022","69","0","69","2024-12-30"
"24122","2024","COM","2022","87","3","90","2024-12-30"
"24123","2024","COM","2022","123","1","124","2024-12-30"
"24124","2024","COM","2022","248","7","255","2024-12-30"
"24126","2024","COM","2022","279","7","286","2024-12-30"
"24128","2024","COM","2022","165","3","168","2024-12-30"
"24129","2024","COM","2022","495","4","499","2024-12-30"
"24130","2024","COM","2022","865","24","889","2024-12-30"
"24131","2024","COM","2022","76","2","78","2024-12-30"
"24132","2024","COM","2022","255","6","261","2024-12-30"
"24133","2024","COM","2022","1259","12","1271","2024-12-30"
"24134","2024","COM","2022","862","13","875","2024-12-30"
"24135","2024","COM","2022","688","15","703","2024-12-30"
"24136","2024","COM","2022","108","6","114","2024-12-30"
"24137","2024","COM","2022","758","74","832","2024-12-30"
"24138","2024","COM","2022","7537","278","7815","2024-12-30"
"24139","2024","COM","2022","2326","53","2379","2024-12-30"
"24140","2024","COM","2022","1563","30","1593","2024-12-30"
"24141","2024","COM","2022","198","3","201","2024-12-30"
"24142","2024","COM","2022","1234","26","1260","2024-12-30"
"24143","2024","COM","2022","715","15","730","2024-12-30"
"24144","2024","COM","2022","104","0","104","2024-12-30"
"24145","2024","COM","2022","1738","36","1774","2024-12-30"
"24146","2024","COM","2022","266","4","270","2024-12-30"
"24147","2024","COM","2022","1116","11","1127","2024-12-30"
"24148","2024","COM","2022","315","3","318","2024-12-30"
"24150","2024","COM","2022","556","8","564","2024-12-30"
"24151","2024","COM","2022","101","2","103","2024-12-30"
"24152","2024","COM","2022","901","25","926","2024-12-30"
"24153","2024","COM","2022","404","13","417","2024-12-30"
"24154","2024","COM","2022","349","7","356","2024-12-30"
"24155","2024","COM","2022","456","5","461","2024-12-30"
"24156","2024","COM","2022","1147","17","1164","2024-12-30"
"24157","2024","COM","2022","846","14","860","2024-12-30"
"24158","2024","COM","2022","426","5","431","2024-12-30"
"24159","2024","COM","2022","395","6","401","2024-12-30"
"24160","2024","COM","2022","583","2","585","2024-12-30"
"24161","2024","COM","2022","122","2","124","2024-12-30"
"24162","2024","COM","2022","399","8","407","2024-12-30"
"24163","2024","COM","2022","165","2","167","2024-12-30"
"24164","2024","COM","2022","1195","30","1225","2024-12-30"
"24165","2024","COM","2022","407","5","412","2024-12-30"
"24167","2024","COM","2022","2553","45","2598","2024-12-30"
"24168","2024","COM","2022","410","10","420","2024-12-30"
"24171","2024","COM","2022","547","7","554","2024-12-30"
"24172","2024","COM","2022","1133","18","1151","2024-12-30"
"24174","2024","COM","2022","137","2","139","2024-12-30"
"24175","2024","COM","2022","308","10","318","2024-12-30"
"24176","2024","COM","2022","36","2","38","2024-12-30"
"24177","2024","COM","2022","669","9","678","2024-12-30"
"24179","2024","COM","2022","797","31","828","2024-12-30"
"24180","2024","COM","2022","298","5","303","2024-12-30"
"24182","2024","COM","2022","1498","35","1533","2024-12-30"
"24183","2024","COM","2022","320","3","323","2024-12-30"
"24184","2024","COM","2022","163","1","164","2024-12-30"
"24186","2024","COM","2022","333","5","338","2024-12-30"
"24188","2024","COM","2022","553","10","563","2024-12-30"
"24189","2024","COM","2022","454","17","471","2024-12-30"
"24190","2024","COM","2022","273","8","281","2024-12-30"
"24191","2024","COM","2022","173","4","177","2024-12-30"
"24192","2024","COM","2022","97","3","100","2024-12-30"
"24193","2024","COM","2022","441","8","449","2024-12-30"
"24194","2024","COM","2022","1607","29","1636","2024-12-30"
"24195","2024","COM","2022","107","1","108","2024-12-30"
"24196","2024","COM","2022","508","6","514","2024-12-30"
"24197","2024","COM","2022","758","18","776","2024-12-30"
"24199","2024","COM","2022","362","5","367","2024-12-30"
"24200","2024","COM","2022","538","11","549","2024-12-30"
"24202","2024","COM","2022","148","1","149","2024-12-30"
"24205","2024","COM","2022","668","5","673","2024-12-30"
"24206","2024","COM","2022","106","4","110","2024-12-30"
"24207","2024","COM","2022","675","9","684","2024-12-30"
"24208","2024","COM","2022","247","5","252","2024-12-30"
"24209","2024","COM","2022","128","1","129","2024-12-30"
"24210","2024","COM","2022","814","17","831","2024-12-30"
"24211","2024","COM","2022","437","4","441","2024-12-30"
"24212","2024","COM","2022","748","9","757","2024-12-30"
"24213","2024","COM","2022","178","3","181","2024-12-30"
"24214","2024","COM","2022","818","10","828","2024-12-30"
"24215","2024","COM","2022","188","6","194","2024-12-30"
"24216","2024","COM","2022","148","4","152","2024-12-30"
"24217","2024","COM","2022","481","2","483","2024-12-30"
"24218","2024","COM","2022","1140","43","1183","2024-12-30"
"24220","2024","COM","2022","691","10","701","2024-12-30"
"24221","2024","COM","2022","154","4","158","2024-12-30"
"24222","2024","COM","2022","2687","92","2779","2024-12-30"
"24223","2024","COM","2022","2936","44","2980","2024-12-30"
"24224","2024","COM","2022","692","13","705","2024-12-30"
"24225","2024","COM","2022","2745","42","2787","2024-12-30"
"24226","2024","COM","2022","1430","22","1452","2024-12-30"
"24227","2024","COM","2022","938","21","959","2024-12-30"
"24228","2024","COM","2022","501","11","512","2024-12-30"
"24229","2024","COM","2022","1666","38","1704","2024-12-30"
"24230","2024","COM","2022","148","3","151","2024-12-30"
"24231","2024","COM","2022","105","1","106","2024-12-30"
"24232","2024","COM","2022","81","0","81","2024-12-30"
"24234","2024","COM","2022","383","7","390","2024-12-30"
"24236","2024","COM","2022","974","18","992","2024-12-30"
"24237","2024","COM","2022","1255","25","1280","2024-12-30"
"24238","2024","COM","2022","133","6","139","2024-12-30"
"24240","2024","COM","2022","339","8","347","2024-12-30"
"24241","2024","COM","2022","430","6","436","2024-12-30"
"24242","2024","COM","2022","260","2","262","2024-12-30"
"24243","2024","COM","2022","873","12","885","2024-12-30"
"24244","2024","COM","2022","191","2","193","2024-12-30"
"24245","2024","COM","2022","256","6","262","2024-12-30"
"24246","2024","COM","2022","445","5","450","2024-12-30"
"24247","2024","COM","2022","163","5","168","2024-12-30"
"24248","2024","COM","2022","285","6","291","2024-12-30"
"24251","2024","COM","2022","541","8","549","2024-12-30"
"24252","2024","COM","2022","839","19","858","2024-12-30"
"24253","2024","COM","2022","2316","44","2360","2024-12-30"
"24254","2024","COM","2022","179","1","180","2024-12-30"
"24255","2024","COM","2022","587","15","602","2024-12-30"
"24256","2024","COM","2022","3165","54","3219","2024-12-30"
"24257","2024","COM","2022","225","5","230","2024-12-30"
"24259","2024","COM","2022","1666","24","1690","2024-12-30"
"24260","2024","COM","2022","876","8","884","2024-12-30"
"24261","2024","COM","2022","290","12","302","2024-12-30"
"24262","2024","COM","2022","322","10","332","2024-12-30"
"24263","2024","COM","2022","305","7","312","2024-12-30"
"24264","2024","COM","2022","1911","23","1934","2024-12-30"
"24266","2024","COM","2022","1520","29","1549","2024-12-30"
"24267","2024","COM","2022","178","4","182","2024-12-30"
"24268","2024","COM","2022","710","17","727","2024-12-30"
"24269","2024","COM","2022","629","5","634","2024-12-30"
"24271","2024","COM","2022","512","7","519","2024-12-30"
"24272","2024","COM","2022","495","5","500","2024-12-30"
"24273","2024","COM","2022","352","11","363","2024-12-30"
"24274","2024","COM","2022","819","81","900","2024-12-30"
"24276","2024","COM","2022","396","12","408","2024-12-30"
"24277","2024","COM","2022","290","4","294","2024-12-30"
"24278","2024","COM","2022","80","1","81","2024-12-30"
"24279","2024","COM","2022","61","1","62","2024-12-30"
"24280","2024","COM","2022","442","6","448","2024-12-30"
"24281","2024","COM","2022","178","2","180","2024-12-30"
"24282","2024","COM","2022","135","4","139","2024-12-30"
"24284","2024","COM","2022","137","5","142","2024-12-30"
"24285","2024","COM","2022","391","8","399","2024-12-30"
"24286","2024","COM","2022","507","10","517","2024-12-30"
"24287","2024","COM","2022","127","0","127","2024-12-30"
"24288","2024","COM","2022","280","3","283","2024-12-30"
"24289","2024","COM","2022","1405","19","1424","2024-12-30"
"24290","2024","COM","2022","155","4","159","2024-12-30"
"24291","2024","COM","2022","2760","51","2811","2024-12-30"
"24292","2024","COM","2022","502","15","517","2024-12-30"
"24293","2024","COM","2022","268","9","277","2024-12-30"
"24294","2024","COM","2022","5845","69","5914","2024-12-30"
"24295","2024","COM","2022","1203","22","1225","2024-12-30"
"24296","2024","COM","2022","1155","11","1166","2024-12-30"
"24297","2024","COM","2022","973","6","979","2024-12-30"
"24299","2024","COM","2022","2778","45","2823","2024-12-30"
"24300","2024","COM","2022","350","9","359","2024-12-30"
"24301","2024","COM","2022","376","9","385","2024-12-30"
"24302","2024","COM","2022","292","2","294","2024-12-30"
"24303","2024","COM","2022","233","1","234","2024-12-30"
"24304","2024","COM","2022","984","13","997","2024-12-30"
"24305","2024","COM","2022","239","3","242","2024-12-30"
"24306","2024","COM","2022","135","4","139","2024-12-30"
"24307","2024","COM","2022","236","3","239","2024-12-30"
"24308","2024","COM","2022","782","24","806","2024-12-30"
"24309","2024","COM","2022","3663","54","3717","2024-12-30"
"24311","2024","COM","2022","3049","125","3174","2024-12-30"
"24312","2024","COM","2022","4720","102","4822","2024-12-30"
"24313","2024","COM","2022","45","0","45","2024-12-30"
"24316","2024","COM","2022","809","15","824","2024-12-30"
"24317","2024","COM","2022","245","11","256","2024-12-30"
"24318","2024","COM","2022","318","7","325","2024-12-30"
"24319","2024","COM","2022","455","8","463","2024-12-30"
"24320","2024","COM","2022","977","20","997","2024-12-30"
"24321","2024","COM","2022","803","15","818","2024-12-30"
"24322","2024","COM","2022","29876","1484","31360","2024-12-30"
"24323","2024","COM","2022","187","4","191","2024-12-30"
"24324","2024","COM","2022","594","9","603","2024-12-30"
"24325","2024","COM","2022","784","15","799","2024-12-30"
"24326","2024","COM","2022","198","2","200","2024-12-30"
"24327","2024","COM","2022","118","2","120","2024-12-30"
"24328","2024","COM","2022","1178","18","1196","2024-12-30"
"24329","2024","COM","2022","1416","22","1438","2024-12-30"
"24330","2024","COM","2022","710","13","723","2024-12-30"
"24331","2024","COM","2022","738","21","759","2024-12-30"
"24334","2024","COM","2022","208","5","213","2024-12-30"
"24335","2024","COM","2022","2515","42","2557","2024-12-30"
"24336","2024","COM","2022","487","19","506","2024-12-30"
"24337","2024","COM","2022","144","2","146","2024-12-30"
"24338","2024","COM","2022","454","7","461","2024-12-30"
"24339","2024","COM","2022","147","6","153","2024-12-30"
"24340","2024","COM","2022","4362","78","4440","2024-12-30"
"24341","2024","COM","2022","1086","18","1104","2024-12-30"
"24345","2024","COM","2022","530","12","542","2024-12-30"
"24346","2024","COM","2022","384","8","392","2024-12-30"
"24347","2024","COM","2022","139","0","139","2024-12-30"
"24348","2024","COM","2022","321","2","323","2024-12-30"
"24349","2024","COM","2022","339","8","347","2024-12-30"
"24350","2024","COM","2022","2367","48","2415","2024-12-30"
"24351","2024","COM","2022","334","4","338","2024-12-30"
"24352","2024","COM","2022","3770","159","3929","2024-12-30"
"24353","2024","COM","2022","331","8","339","2024-12-30"
"24354","2024","COM","2022","3023","49","3072","2024-12-30"
"24355","2024","COM","2022","439","9","448","2024-12-30"
"24356","2024","COM","2022","1662","34","1696","2024-12-30"
"24357","2024","COM","2022","321","6","327","2024-12-30"
"24359","2024","COM","2022","102","2","104","2024-12-30"
"24360","2024","COM","2022","317","5","322","2024-12-30"
"24361","2024","COM","2022","443","6","449","2024-12-30"
"24362","2024","COM","2022","1592","20","1612","2024-12-30"
"24364","2024","COM","2022","629","17","646","2024-12-30"
"24365","2024","COM","2022","245","2","247","2024-12-30"
"24366","2024","COM","2022","885","23","908","2024-12-30"
"24367","2024","COM","2022","168","3","171","2024-12-30"
"24370","2024","COM","2022","1784","28","1812","2024-12-30"
"24371","2024","COM","2022","463","5","468","2024-12-30"
"24372","2024","COM","2022","5309","94","5403","2024-12-30"
"24373","2024","COM","2022","347","8","355","2024-12-30"
"24374","2024","COM","2022","357","4","361","2024-12-30"
"24375","2024","COM","2022","157","2","159","2024-12-30"
"24376","2024","COM","2022","1432","25","1457","2024-12-30"
"24377","2024","COM","2022","151","2","153","2024-12-30"
"24378","2024","COM","2022","89","1","90","2024-12-30"
"24379","2024","COM","2022","416","4","420","2024-12-30"
"24380","2024","COM","2022","506","1","507","2024-12-30"
"24381","2024","COM","2022","215","4","219","2024-12-30"
"24382","2024","COM","2022","526","9","535","2024-12-30"
"24383","2024","COM","2022","172","1","173","2024-12-30"
"24384","2024","COM","2022","32","2","34","2024-12-30"
"24385","2024","COM","2022","226","2","228","2024-12-30"
"24386","2024","COM","2022","195","10","205","2024-12-30"
"24388","2024","COM","2022","496","15","511","2024-12-30"
"24390","2024","COM","2022","336","9","345","2024-12-30"
"24392","2024","COM","2022","532","8","540","2024-12-30"
"24393","2024","COM","2022","85","0","85","2024-12-30"
"24394","2024","COM","2022","144","7","151","2024-12-30"
"24395","2024","COM","2022","373","8","381","2024-12-30"
"24396","2024","COM","2022","1566","27","1593","2024-12-30"
"24397","2024","COM","2022","302","8","310","2024-12-30"
"24398","2024","COM","2022","584","7","591","2024-12-30"
"24399","2024","COM","2022","109","4","113","2024-12-30"
"24401","2024","COM","2022","296","3","299","2024-12-30"
"24403","2024","COM","2022","70","0","70","2024-12-30"
"24404","2024","COM","2022","178","1","179","2024-12-30"
"24405","2024","COM","2022","319","4","323","2024-12-30"
"24406","2024","COM","2022","141","1","142","2024-12-30"
"24407","2024","COM","2022","244","7","251","2024-12-30"
"24408","2024","COM","2022","252","3","255","2024-12-30"
"24409","2024","COM","2022","1157","26","1183","2024-12-30"
"24410","2024","COM","2022","497","8","505","2024-12-30"
"24411","2024","COM","2022","166","3","169","2024-12-30"
"24412","2024","COM","2022","893","29","922","2024-12-30"
"24413","2024","COM","2022","280","8","288","2024-12-30"
"24414","2024","COM","2022","279","5","284","2024-12-30"
"24415","2024","COM","2022","207","5","212","2024-12-30"
"24416","2024","COM","2022","176","5","181","2024-12-30"
"24417","2024","COM","2022","482","11","493","2024-12-30"
"24418","2024","COM","2022","906","17","923","2024-12-30"
"24419","2024","COM","2022","893","20","913","2024-12-30"
"24420","2024","COM","2022","243","3","246","2024-12-30"
"24421","2024","COM","2022","192","5","197","2024-12-30"
"24422","2024","COM","2022","126","1","127","2024-12-30"
"24423","2024","COM","2022","311","1","312","2024-12-30"
"24424","2024","COM","2022","132","0","132","2024-12-30"
"24425","2024","COM","2022","365","6","371","2024-12-30"
"24426","2024","COM","2022","158","6","164","2024-12-30"
"24428","2024","COM","2022","543","35","578","2024-12-30"
"24429","2024","COM","2022","239","7","246","2024-12-30"
"24432","2024","COM","2022","657","15","672","2024-12-30"
"24434","2024","COM","2022","145","2","147","2024-12-30"
"24436","2024","COM","2022","1022","24","1046","2024-12-30"
"24437","2024","COM","2022","1028","16","1044","2024-12-30"
"24438","2024","COM","2022","235","9","244","2024-12-30"
"24441","2024","COM","2022","146","0","146","2024-12-30"
"24442","2024","COM","2022","2072","28","2100","2024-12-30"
"24443","2024","COM","2022","430","12","442","2024-12-30"
"24444","2024","COM","2022","311","7","318","2024-12-30"
"24445","2024","COM","2022","138","5","143","2024-12-30"
"24446","2024","COM","2022","54","0","54","2024-12-30"
"24448","2024","COM","2022","485","10","495","2024-12-30"
"24449","2024","COM","2022","944","19","963","2024-12-30"
"24450","2024","COM","2022","578","11","589","2024-12-30"
"24451","2024","COM","2022","801","19","820","2024-12-30"
"24452","2024","COM","2022","184","3","187","2024-12-30"
"24453","2024","COM","2022","362","7","369","2024-12-30"
"24454","2024","COM","2022","637","7","644","2024-12-30"
"24455","2024","COM","2022","728","12","740","2024-12-30"
"24456","2024","COM","2022","203","3","206","2024-12-30"
"24457","2024","COM","2022","140","2","142","2024-12-30"
"24458","2024","COM","2022","273","5","278","2024-12-30"
"24459","2024","COM","2022","287","9","296","2024-12-30"
"24460","2024","COM","2022","489","6","495","2024-12-30"
"24461","2024","COM","2022","801","11","812","2024-12-30"
"24462","2024","COM","2022","1619","32","1651","2024-12-30"
"24463","2024","COM","2022","545","10","555","2024-12-30"
"24464","2024","COM","2022","334","6","340","2024-12-30"
"24465","2024","COM","2022","228","5","233","2024-12-30"
"24466","2024","COM","2022","323","5","328","2024-12-30"
"24468","2024","COM","2022","299","2","301","2024-12-30"
"24470","2024","COM","2022","301","7","308","2024-12-30"
"24471","2024","COM","2022","648","12","660","2024-12-30"
"24472","2024","COM","2022","1013","13","1026","2024-12-30"
"24473","2024","COM","2022","349","4","353","2024-12-30"
"24474","2024","COM","2022","150","1","151","2024-12-30"
"24476","2024","COM","2022","160","4","164","2024-12-30"
"24477","2024","COM","2022","191","2","193","2024-12-30"
"24478","2024","COM","2022","187","0","187","2024-12-30"
"24479","2024","COM","2022","1170","19","1189","2024-12-30"
"24480","2024","COM","2022","333","3","336","2024-12-30"
"24481","2024","COM","2022","533","3","536","2024-12-30"
"24482","2024","COM","2022","277","2","279","2024-12-30"
"24483","2024","COM","2022","142","7","149","2024-12-30"
"24484","2024","COM","2022","944","10","954","2024-12-30"
"24485","2024","COM","2022","428","7","435","2024-12-30"
"24486","2024","COM","2022","482","6","488","2024-12-30"
"24487","2024","COM","2022","1801","20","1821","2024-12-30"
"24488","2024","COM","2022","363","1","364","2024-12-30"
"24489","2024","COM","2022","376","3","379","2024-12-30"
"24490","2024","COM","2022","1127","13","1140","2024-12-30"
"24491","2024","COM","2022","560","15","575","2024-12-30"
"24492","2024","COM","2022","76","2","78","2024-12-30"
"24493","2024","COM","2022","94","2","96","2024-12-30"
"24494","2024","COM","2022","502","5","507","2024-12-30"
"24495","2024","COM","2022","108","3","111","2024-12-30"
"24496","2024","COM","2022","331","7","338","2024-12-30"
"24498","2024","COM","2022","823","20","843","2024-12-30"
"24499","2024","COM","2022","855","21","876","2024-12-30"
"24500","2024","COM","2022","149","7","156","2024-12-30"
"24501","2024","COM","2022","461","5","466","2024-12-30"
"24502","2024","COM","2022","91","0","91","2024-12-30"
"24504","2024","COM","2022","283","2","285","2024-12-30"
"24505","2024","COM","2022","368","3","371","2024-12-30"
"24507","2024","COM","2022","113","2","115","2024-12-30"
"24508","2024","COM","2022","212","5","217","2024-12-30"
"24509","2024","COM","2022","671","12","683","2024-12-30"
"24510","2024","COM","2022","384","9","393","2024-12-30"
"24511","2024","COM","2022","220","0","220","2024-12-30"
"24512","2024","COM","2022","293","12","305","2024-12-30"
"24513","2024","COM","2022","309","9","318","2024-12-30"
"24514","2024","COM","2022","238","2","240","2024-12-30"
"24515","2024","COM","2022","717","5","722","2024-12-30"
"24516","2024","COM","2022","1184","71","1255","2024-12-30"
"24517","2024","COM","2022","77","2","79","2024-12-30"
"24518","2024","COM","2022","275","3","278","2024-12-30"
"24519","2024","COM","2022","423","5","428","2024-12-30"
"24520","2024","COM","2022","8786","357","9143","2024-12-30"
"24521","2024","COM","2022","1050","17","1067","2024-12-30"
"24522","2024","COM","2022","364","10","374","2024-12-30"
"24523","2024","COM","2022","412","7","419","2024-12-30"
"24524","2024","COM","2022","174","2","176","2024-12-30"
"24525","2024","COM","2022","205","2","207","2024-12-30"
"24526","2024","COM","2022","715","9","724","2024-12-30"
"24527","2024","COM","2022","947","17","964","2024-12-30"
"24528","2024","COM","2022","126","1","127","2024-12-30"
"24529","2024","COM","2022","204","2","206","2024-12-30"
"24531","2024","COM","2022","215","3","218","2024-12-30"
"24532","2024","COM","2022","237","4","241","2024-12-30"
"24533","2024","COM","2022","77","0","77","2024-12-30"
"24534","2024","COM","2022","1251","201","1452","2024-12-30"
"24535","2024","COM","2022","256","4","260","2024-12-30"
"24536","2024","COM","2022","314","5","319","2024-12-30"
"24537","2024","COM","2022","259","7","266","2024-12-30"
"24538","2024","COM","2022","1079","16","1095","2024-12-30"
"24540","2024","COM","2022","1639","31","1670","2024-12-30"
"24541","2024","COM","2022","102","1","103","2024-12-30"
"24542","2024","COM","2022","70","2","72","2024-12-30"
"24543","2024","COM","2022","1127","16","1143","2024-12-30"
"24544","2024","COM","2022","405","12","417","2024-12-30"
"24545","2024","COM","2022","99","2","101","2024-12-30"
"24546","2024","COM","2022","35","0","35","2024-12-30"
"24547","2024","COM","2022","6262","110","6372","2024-12-30"
"24548","2024","COM","2022","279","4","283","2024-12-30"
"24549","2024","COM","2022","443","5","448","2024-12-30"
"24550","2024","COM","2022","1267","13","1280","2024-12-30"
"24551","2024","COM","2022","2889","188","3077","2024-12-30"
"24552","2024","COM","2022","268","6","274","2024-12-30"
"24553","2024","COM","2022","1757","38","1795","2024-12-30"
"24554","2024","COM","2022","549","14","563","2024-12-30"
"24555","2024","COM","2022","638","10","648","2024-12-30"
"24557","2024","COM","2022","7319","200","7519","2024-12-30"
"24558","2024","COM","2022","629","6","635","2024-12-30"
"24559","2024","COM","2022","339","3","342","2024-12-30"
"24560","2024","COM","2022","115","0","115","2024-12-30"
"24562","2024","COM","2022","261","11","272","2024-12-30"
"24563","2024","COM","2022","286","6","292","2024-12-30"
"24564","2024","COM","2022","692","104","796","2024-12-30"
"24565","2024","COM","2022","357","7","364","2024-12-30"
"24566","2024","COM","2022","460","10","470","2024-12-30"
"24567","2024","COM","2022","240","2","242","2024-12-30"
"24568","2024","COM","2022","1058","11","1069","2024-12-30"
"24569","2024","COM","2022","135","2","137","2024-12-30"
"24570","2024","COM","2022","36","1","37","2024-12-30"
"24571","2024","COM","2022","1750","17","1767","2024-12-30"
"24572","2024","COM","2022","188","5","193","2024-12-30"
"24573","2024","COM","2022","546","10","556","2024-12-30"
"24574","2024","COM","2022","325","11","336","2024-12-30"
"24575","2024","COM","2022","235","12","247","2024-12-30"
"24576","2024","COM","2022","247","9","256","2024-12-30"
"24577","2024","COM","2022","512","8","520","2024-12-30"
"24580","2024","COM","2022","285","2","287","2024-12-30"
"24581","2024","COM","2022","870","12","882","2024-12-30"
"24582","2024","COM","2022","464","8","472","2024-12-30"
"24584","2024","COM","2022","956","19","975","2024-12-30"
"24585","2024","COM","2022","671","10","681","2024-12-30"
"24586","2024","COM","2022","893","19","912","2024-12-30"
"24587","2024","COM","2022","857","17","874","2024-12-30"
"25001","2024","COM","2022","247","5","252","2024-12-30"
"25002","2024","COM","2022","283","5","288","2024-12-30"
"25003","2024","COM","2022","321","6","327","2024-12-30"
"25004","2024","COM","2022","1099","20","1119","2024-12-30"
"25005","2024","COM","2022","88","2","90","2024-12-30"
"25006","2024","COM","2022","88","5","93","2024-12-30"
"25007","2024","COM","2022","103","3","106","2024-12-30"
"25008","2024","COM","2022","449","11","460","2024-12-30"
"25009","2024","COM","2022","165","1","166","2024-12-30"
"25011","2024","COM","2022","735","18","753","2024-12-30"
"25012","2024","COM","2022","171","3","174","2024-12-30"
"25013","2024","COM","2022","237","6","243","2024-12-30"
"25014","2024","COM","2022","937","9","946","2024-12-30"
"25015","2024","COM","2022","731","11","742","2024-12-30"
"25016","2024","COM","2022","173","4","177","2024-12-30"
"25017","2024","COM","2022","86","4","90","2024-12-30"
"25018","2024","COM","2022","600","21","621","2024-12-30"
"25019","2024","COM","2022","385","11","396","2024-12-30"
"25020","2024","COM","2022","891","10","901","2024-12-30"
"25021","2024","COM","2022","1621","28","1649","2024-12-30"
"25022","2024","COM","2022","1491","40","1531","2024-12-30"
"25024","2024","COM","2022","955","32","987","2024-12-30"
"25025","2024","COM","2022","751","11","762","2024-12-30"
"25026","2024","COM","2022","228","5","233","2024-12-30"
"25029","2024","COM","2022","260","3","263","2024-12-30"
"25030","2024","COM","2022","422","10","432","2024-12-30"
"25031","2024","COM","2022","14009","242","14251","2024-12-30"
"25032","2024","COM","2022","431","10","441","2024-12-30"
"25033","2024","COM","2022","497","6","503","2024-12-30"
"25035","2024","COM","2022","2522","54","2576","2024-12-30"
"25036","2024","COM","2022","2237","27","2264","2024-12-30"
"25038","2024","COM","2022","153","1","154","2024-12-30"
"25039","2024","COM","2022","954","19","973","2024-12-30"
"25040","2024","COM","2022","808","15","823","2024-12-30"
"25041","2024","COM","2022","378","9","387","2024-12-30"
"25042","2024","COM","2022","238","7","245","2024-12-30"
"25043","2024","COM","2022","2015","58","2073","2024-12-30"
"25044","2024","COM","2022","60","0","60","2024-12-30"
"25045","2024","COM","2022","42","0","42","2024-12-30"
"25046","2024","COM","2022","79","4","83","2024-12-30"
"25047","2024","COM","2022","5064","138","5202","2024-12-30"
"25048","2024","COM","2022","3566","68","3634","2024-12-30"
"25049","2024","COM","2022","131","7","138","2024-12-30"
"25050","2024","COM","2022","512","12","524","2024-12-30"
"25051","2024","COM","2022","626","12","638","2024-12-30"
"25052","2024","COM","2022","75","0","75","2024-12-30"
"25053","2024","COM","2022","90","7","97","2024-12-30"
"25054","2024","COM","2022","543","14","557","2024-12-30"
"25055","2024","COM","2022","358","2","360","2024-12-30"
"25056","2024","COM","2022","120057","3215","123272","2024-12-30"
"25057","2024","COM","2022","5288","75","5363","2024-12-30"
"25058","2024","COM","2022","1342","15","1357","2024-12-30"
"25059","2024","COM","2022","269","6","275","2024-12-30"
"25060","2024","COM","2022","2128","51","2179","2024-12-30"
"25061","2024","COM","2022","111","2","113","2024-12-30"
"25062","2024","COM","2022","304","11","315","2024-12-30"
"25063","2024","COM","2022","1236","27","1263","2024-12-30"
"25065","2024","COM","2022","55","2","57","2024-12-30"
"25066","2024","COM","2022","78","1","79","2024-12-30"
"25067","2024","COM","2022","188","4","192","2024-12-30"
"25070","2024","COM","2022","379","5","384","2024-12-30"
"25071","2024","COM","2022","481","4","485","2024-12-30"
"25072","2024","COM","2022","19","1","20","2024-12-30"
"25073","2024","COM","2022","828","5","833","2024-12-30"
"25074","2024","COM","2022","1001","22","1023","2024-12-30"
"25075","2024","COM","2022","420","10","430","2024-12-30"
"25077","2024","COM","2022","86","1","87","2024-12-30"
"25078","2024","COM","2022","1057","25","1082","2024-12-30"
"25079","2024","COM","2022","459","7","466","2024-12-30"
"25082","2024","COM","2022","880","14","894","2024-12-30"
"25083","2024","COM","2022","189","3","192","2024-12-30"
"25084","2024","COM","2022","1200","17","1217","2024-12-30"
"25085","2024","COM","2022","441","14","455","2024-12-30"
"25086","2024","COM","2022","205","6","211","2024-12-30"
"25087","2024","COM","2022","181","5","186","2024-12-30"
"25088","2024","COM","2022","87","6","93","2024-12-30"
"25089","2024","COM","2022","102","2","104","2024-12-30"
"25090","2024","COM","2022","75","0","75","2024-12-30"
"25091","2024","COM","2022","487","12","499","2024-12-30"
"25092","2024","COM","2022","70","2","72","2024-12-30"
"25093","2024","COM","2022","76","0","76","2024-12-30"
"25094","2024","COM","2022","119","0","119","2024-12-30"
"25095","2024","COM","2022","285","5","290","2024-12-30"
"25096","2024","COM","2022","179","2","181","2024-12-30"
"25097","2024","COM","2022","477","11","488","2024-12-30"
"25098","2024","COM","2022","190","2","192","2024-12-30"
"25099","2024","COM","2022","248","6","254","2024-12-30"
"25100","2024","COM","2022","500","6","506","2024-12-30"
"25101","2024","COM","2022","568","12","580","2024-12-30"
"25102","2024","COM","2022","48","2","50","2024-12-30"
"25103","2024","COM","2022","675","4","679","2024-12-30"
"25104","2024","COM","2022","83","2","85","2024-12-30"
"25105","2024","COM","2022","619","8","627","2024-12-30"
"25106","2024","COM","2022","66","0","66","2024-12-30"
"25107","2024","COM","2022","200","2","202","2024-12-30"
"25108","2024","COM","2022","318","8","326","2024-12-30"
"25109","2024","COM","2022","321","10","331","2024-12-30"
"25110","2024","COM","2022","1032","25","1057","2024-12-30"
"25111","2024","COM","2022","375","11","386","2024-12-30"
"25112","2024","COM","2022","1326","27","1353","2024-12-30"
"25113","2024","COM","2022","139","5","144","2024-12-30"
"25114","2024","COM","2022","386","6","392","2024-12-30"
"25115","2024","COM","2022","271","4","275","2024-12-30"
"25116","2024","COM","2022","250","7","257","2024-12-30"
"25117","2024","COM","2022","90","0","90","2024-12-30"
"25119","2024","COM","2022","317","9","326","2024-12-30"
"25120","2024","COM","2022","385","9","394","2024-12-30"
"25121","2024","COM","2022","259","15","274","2024-12-30"
"25122","2024","COM","2022","534","10","544","2024-12-30"
"25124","2024","COM","2022","283","6","289","2024-12-30"
"25125","2024","COM","2022","319","13","332","2024-12-30"
"25126","2024","COM","2022","471","13","484","2024-12-30"
"25127","2024","COM","2022","2867","54","2921","2024-12-30"
"25129","2024","COM","2022","129","1","130","2024-12-30"
"25130","2024","COM","2022","9","0","9","2024-12-30"
"25131","2024","COM","2022","110","5","115","2024-12-30"
"25132","2024","COM","2022","141","4","145","2024-12-30"
"25133","2024","COM","2022","2025","53","2078","2024-12-30"
"25136","2024","COM","2022","513","12","525","2024-12-30"
"25138","2024","COM","2022","130","4","134","2024-12-30"
"25139","2024","COM","2022","611","11","622","2024-12-30"
"25141","2024","COM","2022","121","6","127","2024-12-30"
"25142","2024","COM","2022","333","6","339","2024-12-30"
"25143","2024","COM","2022","197","10","207","2024-12-30"
"25145","2024","COM","2022","117","0","117","2024-12-30"
"25147","2024","COM","2022","2114","43","2157","2024-12-30"
"25148","2024","COM","2022","532","14","546","2024-12-30"
"25149","2024","COM","2022","496","10","506","2024-12-30"
"25150","2024","COM","2022","294","3","297","2024-12-30"
"25151","2024","COM","2022","140","3","143","2024-12-30"
"25152","2024","COM","2022","143","1","144","2024-12-30"
"25153","2024","COM","2022","140","1","141","2024-12-30"
"25154","2024","COM","2022","253","10","263","2024-12-30"
"25155","2024","COM","2022","292","6","298","2024-12-30"
"25156","2024","COM","2022","1161","21","1182","2024-12-30"
"25157","2024","COM","2022","1317","28","1345","2024-12-30"
"25159","2024","COM","2022","1215","19","1234","2024-12-30"
"25160","2024","COM","2022","770","27","797","2024-12-30"
"25161","2024","COM","2022","24","1","25","2024-12-30"
"25162","2024","COM","2022","214","5","219","2024-12-30"
"25163","2024","COM","2022","94","1","95","2024-12-30"
"25164","2024","COM","2022","146","0","146","2024-12-30"
"25166","2024","COM","2022","82","2","84","2024-12-30"
"25170","2024","COM","2022","1387","24","1411","2024-12-30"
"25171","2024","COM","2022","105","0","105","2024-12-30"
"25172","2024","COM","2022","242","1","243","2024-12-30"
"25173","2024","COM","2022","148","4","152","2024-12-30"
"25174","2024","COM","2022","247","3","250","2024-12-30"
"25175","2024","COM","2022","91","1","92","2024-12-30"
"25176","2024","COM","2022","319","5","324","2024-12-30"
"25177","2024","COM","2022","148","4","152","2024-12-30"
"25178","2024","COM","2022","121","3","124","2024-12-30"
"25179","2024","COM","2022","56","5","61","2024-12-30"
"25180","2024","COM","2022","117","6","123","2024-12-30"
"25181","2024","COM","2022","148","6","154","2024-12-30"
"25182","2024","COM","2022","102","1","103","2024-12-30"
"25183","2024","COM","2022","76","1","77","2024-12-30"
"25184","2024","COM","2022","280","5","285","2024-12-30"
"25185","2024","COM","2022","68","3","71","2024-12-30"
"25186","2024","COM","2022","1049","25","1074","2024-12-30"
"25187","2024","COM","2022","506","15","521","2024-12-30"
"25188","2024","COM","2022","727","24","751","2024-12-30"
"25189","2024","COM","2022","207","2","209","2024-12-30"
"25190","2024","COM","2022","1565","27","1592","2024-12-30"
"25191","2024","COM","2022","452","8","460","2024-12-30"
"25192","2024","COM","2022","164","1","165","2024-12-30"
"25193","2024","COM","2022","1825","44","1869","2024-12-30"
"25194","2024","COM","2022","120","0","120","2024-12-30"
"25195","2024","COM","2022","1503","304","1807","2024-12-30"
"25196","2024","COM","2022","1370","26","1396","2024-12-30"
"25197","2024","COM","2022","627","6","633","2024-12-30"
"25198","2024","COM","2022","717","19","736","2024-12-30"
"25199","2024","COM","2022","336","6","342","2024-12-30"
"25200","2024","COM","2022","1314","35","1349","2024-12-30"
"25201","2024","COM","2022","819","16","835","2024-12-30"
"25202","2024","COM","2022","291","6","297","2024-12-30"
"25203","2024","COM","2022","173","2","175","2024-12-30"
"25204","2024","COM","2022","3309","77","3386","2024-12-30"
"25207","2024","COM","2022","621","11","632","2024-12-30"
"25208","2024","COM","2022","198","9","207","2024-12-30"
"25209","2024","COM","2022","115","4","119","2024-12-30"
"25210","2024","COM","2022","163","4","167","2024-12-30"
"25211","2024","COM","2022","87","1","88","2024-12-30"
"25212","2024","COM","2022","2620","45","2665","2024-12-30"
"25213","2024","COM","2022","766","21","787","2024-12-30"
"25214","2024","COM","2022","497","10","507","2024-12-30"
"25215","2024","COM","2022","97","1","98","2024-12-30"
"25216","2024","COM","2022","266","6","272","2024-12-30"
"25217","2024","COM","2022","620","8","628","2024-12-30"
"25218","2024","COM","2022","167","7","174","2024-12-30"
"25219","2024","COM","2022","643","13","656","2024-12-30"
"25220","2024","COM","2022","599","13","612","2024-12-30"
"25221","2024","COM","2022","65","0","65","2024-12-30"
"25222","2024","COM","2022","1648","34","1682","2024-12-30"
"25223","2024","COM","2022","325","8","333","2024-12-30"
"25224","2024","COM","2022","824","11","835","2024-12-30"
"25225","2024","COM","2022","184","4","188","2024-12-30"
"25226","2024","COM","2022","204","6","210","2024-12-30"
"25227","2024","COM","2022","290","10","300","2024-12-30"
"25228","2024","COM","2022","3711","67","3778","2024-12-30"
"25229","2024","COM","2022","390","12","402","2024-12-30"
"25230","2024","COM","2022","3273","58","3331","2024-12-30"
"25231","2024","COM","2022","123","2","125","2024-12-30"
"25232","2024","COM","2022","100","2","102","2024-12-30"
"25233","2024","COM","2022","294","11","305","2024-12-30"
"25234","2024","COM","2022","168","7","175","2024-12-30"
"25235","2024","COM","2022","326","6","332","2024-12-30"
"25236","2024","COM","2022","314","3","317","2024-12-30"
"25237","2024","COM","2022","2147","41","2188","2024-12-30"
"25238","2024","COM","2022","159","2","161","2024-12-30"
"25239","2024","COM","2022","189","2","191","2024-12-30"
"25240","2024","COM","2022","3062","99","3161","2024-12-30"
"25241","2024","COM","2022","132","6","138","2024-12-30"
"25242","2024","COM","2022","133","0","133","2024-12-30"
"25243","2024","COM","2022","833","20","853","2024-12-30"
"25244","2024","COM","2022","85","4","89","2024-12-30"
"25245","2024","COM","2022","1200","23","1223","2024-12-30"
"25246","2024","COM","2022","259","8","267","2024-12-30"
"25247","2024","COM","2022","81","3","84","2024-12-30"
"25248","2024","COM","2022","538","112","650","2024-12-30"
"25249","2024","COM","2022","63","2","65","2024-12-30"
"25251","2024","COM","2022","161","6","167","2024-12-30"
"25252","2024","COM","2022","124","3","127","2024-12-30"
"25253","2024","COM","2022","373","2","375","2024-12-30"
"25254","2024","COM","2022","1429","29","1458","2024-12-30"
"25255","2024","COM","2022","351","13","364","2024-12-30"
"25256","2024","COM","2022","878","21","899","2024-12-30"
"25257","2024","COM","2022","267","4","271","2024-12-30"
"25258","2024","COM","2022","2250","40","2290","2024-12-30"
"25259","2024","COM","2022","1958","26","1984","2024-12-30"
"25261","2024","COM","2022","80","0","80","2024-12-30"
"25262","2024","COM","2022","472","25","497","2024-12-30"
"25263","2024","COM","2022","264","2","266","2024-12-30"
"25264","2024","COM","2022","82","3","85","2024-12-30"
"25265","2024","COM","2022","1264","27","1291","2024-12-30"
"25266","2024","COM","2022","125","3","128","2024-12-30"
"25267","2024","COM","2022","676","18","694","2024-12-30"
"25268","2024","COM","2022","117","2","119","2024-12-30"
"25269","2024","COM","2022","59","1","60","2024-12-30"
"25270","2024","COM","2022","153","0","153","2024-12-30"
"25271","2024","COM","2022","1805","37","1842","2024-12-30"
"25273","2024","COM","2022","196","4","200","2024-12-30"
"25274","2024","COM","2022","340","0","340","2024-12-30"
"25275","2024","COM","2022","180","4","184","2024-12-30"
"25276","2024","COM","2022","163","2","165","2024-12-30"
"25277","2024","COM","2022","83","3","86","2024-12-30"
"25278","2024","COM","2022","559","12","571","2024-12-30"
"25279","2024","COM","2022","118","0","118","2024-12-30"
"25280","2024","COM","2022","167","1","168","2024-12-30"
"25281","2024","COM","2022","272","4","276","2024-12-30"
"25283","2024","COM","2022","60","2","62","2024-12-30"
"25284","2024","COM","2022","5865","74","5939","2024-12-30"
"25285","2024","COM","2022","1507","27","1534","2024-12-30"
"25286","2024","COM","2022","122","5","127","2024-12-30"
"25287","2024","COM","2022","1810","44","1854","2024-12-30"
"25288","2024","COM","2022","738","23","761","2024-12-30"
"25289","2024","COM","2022","73","3","76","2024-12-30"
"25290","2024","COM","2022","97","2","99","2024-12-30"
"25293","2024","COM","2022","1355","53","1408","2024-12-30"
"25295","2024","COM","2022","323","5","328","2024-12-30"
"25296","2024","COM","2022","804","15","819","2024-12-30"
"25297","2024","COM","2022","163","3","166","2024-12-30"
"25298","2024","COM","2022","257","6","263","2024-12-30"
"25299","2024","COM","2022","109","1","110","2024-12-30"
"25300","2024","COM","2022","317","7","324","2024-12-30"
"25301","2024","COM","2022","847","27","874","2024-12-30"
"25303","2024","COM","2022","227","3","230","2024-12-30"
"25304","2024","COM","2022","3530","52","3582","2024-12-30"
"25305","2024","COM","2022","605","12","617","2024-12-30"
"25306","2024","COM","2022","122","2","124","2024-12-30"
"25307","2024","COM","2022","947","21","968","2024-12-30"
"25308","2024","COM","2022","463","14","477","2024-12-30"
"25309","2024","COM","2022","1197","28","1225","2024-12-30"
"25310","2024","COM","2022","105","1","106","2024-12-30"
"25311","2024","COM","2022","203","5","208","2024-12-30"
"25312","2024","COM","2022","63","1","64","2024-12-30"
"25313","2024","COM","2022","192","5","197","2024-12-30"
"25314","2024","COM","2022","248","7","255","2024-12-30"
"25315","2024","COM","2022","2812","63","2875","2024-12-30"
"25316","2024","COM","2022","241","3","244","2024-12-30"
"25317","2024","COM","2022","277","4","281","2024-12-30"
"25318","2024","COM","2022","1915","34","1949","2024-12-30"
"25320","2024","COM","2022","1257","32","1289","2024-12-30"
"25321","2024","COM","2022","5248","98","5346","2024-12-30"
"25322","2024","COM","2022","410","10","420","2024-12-30"
"25323","2024","COM","2022","442","4","446","2024-12-30"
"25324","2024","COM","2022","162","8","170","2024-12-30"
"25325","2024","COM","2022","238","8","246","2024-12-30"
"25326","2024","COM","2022","545","2","547","2024-12-30"
"25327","2024","COM","2022","70","0","70","2024-12-30"
"25328","2024","COM","2022","784","8","792","2024-12-30"
"25329","2024","COM","2022","33","3","36","2024-12-30"
"25330","2024","COM","2022","182","6","188","2024-12-30"
"25331","2024","COM","2022","238","5","243","2024-12-30"
"25332","2024","COM","2022","577","13","590","2024-12-30"
"25333","2024","COM","2022","352","16","368","2024-12-30"
"25334","2024","COM","2022","2345","243","2588","2024-12-30"
"25335","2024","COM","2022","147","5","152","2024-12-30"
"25336","2024","COM","2022","558","4","562","2024-12-30"
"25338","2024","COM","2022","91","1","92","2024-12-30"
"25339","2024","COM","2022","244","2","246","2024-12-30"
"25340","2024","COM","2022","195","5","200","2024-12-30"
"25341","2024","COM","2022","171","2","173","2024-12-30"
"25342","2024","COM","2022","78","0","78","2024-12-30"
"25343","2024","COM","2022","163","6","169","2024-12-30"
"25344","2024","COM","2022","40","1","41","2024-12-30"
"25345","2024","COM","2022","653","19","672","2024-12-30"
"25346","2024","COM","2022","180","4","184","2024-12-30"
"25347","2024","COM","2022","844","17","861","2024-12-30"
"25348","2024","COM","2022","615","8","623","2024-12-30"
"25349","2024","COM","2022","636","16","652","2024-12-30"
"25350","2024","COM","2022","725","24","749","2024-12-30"
"25351","2024","COM","2022","243","3","246","2024-12-30"
"25354","2024","COM","2022","156","2","158","2024-12-30"
"25355","2024","COM","2022","64","0","64","2024-12-30"
"25356","2024","COM","2022","4226","104","4330","2024-12-30"
"25357","2024","COM","2022","846","16","862","2024-12-30"
"25359","2024","COM","2022","151","5","156","2024-12-30"
"25360","2024","COM","2022","167","5","172","2024-12-30"
"25361","2024","COM","2022","883","28","911","2024-12-30"
"25362","2024","COM","2022","287","12","299","2024-12-30"
"25364","2024","COM","2022","1811","49","1860","2024-12-30"
"25365","2024","COM","2022","318","6","324","2024-12-30"
"25366","2024","COM","2022","184","3","187","2024-12-30"
"25367","2024","COM","2022","4672","142","4814","2024-12-30"
"25368","2024","COM","2022","1429","19","1448","2024-12-30"
"25369","2024","COM","2022","150","2","152","2024-12-30"
"25370","2024","COM","2022","2131","47","2178","2024-12-30"
"25371","2024","COM","2022","220","7","227","2024-12-30"
"25372","2024","COM","2022","282","5","287","2024-12-30"
"25373","2024","COM","2022","45","1","46","2024-12-30"
"25374","2024","COM","2022","531","12","543","2024-12-30"
"25375","2024","COM","2022","669","10","679","2024-12-30"
"25376","2024","COM","2022","168","1","169","2024-12-30"
"25377","2024","COM","2022","234","5","239","2024-12-30"
"25378","2024","COM","2022","330","11","341","2024-12-30"
"25379","2024","COM","2022","68","5","73","2024-12-30"
"25380","2024","COM","2022","1395","37","1432","2024-12-30"
"25381","2024","COM","2022","2660","36","2696","2024-12-30"
"25382","2024","COM","2022","629","4","633","2024-12-30"
"25383","2024","COM","2022","296","4","300","2024-12-30"
"25384","2024","COM","2022","79","4","83","2024-12-30"
"25385","2024","COM","2022","123","3","126","2024-12-30"
"25386","2024","COM","2022","119","4","123","2024-12-30"
"25387","2024","COM","2022","372","9","381","2024-12-30"
"25388","2024","COM","2022","25516","483","25999","2024-12-30"
"25389","2024","COM","2022","113","2","115","2024-12-30"
"25390","2024","COM","2022","399","12","411","2024-12-30"
"25391","2024","COM","2022","190","9","199","2024-12-30"
"25392","2024","COM","2022","195","6","201","2024-12-30"
"25393","2024","COM","2022","557","12","569","2024-12-30"
"25394","2024","COM","2022","1394","46","1440","2024-12-30"
"25395","2024","COM","2022","1608","46","1654","2024-12-30"
"25397","2024","COM","2022","2191","42","2233","2024-12-30"
"25398","2024","COM","2022","118","1","119","2024-12-30"
"25400","2024","COM","2022","494","7","501","2024-12-30"
"25401","2024","COM","2022","28","0","28","2024-12-30"
"25402","2024","COM","2022","22","1","23","2024-12-30"
"25403","2024","COM","2022","2227","70","2297","2024-12-30"
"25404","2024","COM","2022","91","4","95","2024-12-30"
"25405","2024","COM","2022","933","40","973","2024-12-30"
"25406","2024","COM","2022","559","15","574","2024-12-30"
"25408","2024","COM","2022","54","0","54","2024-12-30"
"25410","2024","COM","2022","1321","63","1384","2024-12-30"
"25411","2024","COM","2022","6905","338","7243","2024-12-30"
"25413","2024","COM","2022","1025","34","1059","2024-12-30"
"25414","2024","COM","2022","132","2","134","2024-12-30"
"25415","2024","COM","2022","357","4","361","2024-12-30"
"25416","2024","COM","2022","181","3","184","2024-12-30"
"25417","2024","COM","2022","822","13","835","2024-12-30"
"25418","2024","COM","2022","1300","30","1330","2024-12-30"
"25419","2024","COM","2022","92","4","96","2024-12-30"
"25420","2024","COM","2022","169","5","174","2024-12-30"
"25421","2024","COM","2022","99","0","99","2024-12-30"
"25422","2024","COM","2022","166","4","170","2024-12-30"
"25424","2024","COM","2022","1576","27","1603","2024-12-30"
"25425","2024","COM","2022","455","15","470","2024-12-30"
"25426","2024","COM","2022","325","6","331","2024-12-30"
"25427","2024","COM","2022","401","8","409","2024-12-30"
"25428","2024","COM","2022","1601","36","1637","2024-12-30"
"25429","2024","COM","2022","1345","22","1367","2024-12-30"
"25430","2024","COM","2022","40","0","40","2024-12-30"
"25431","2024","COM","2022","366","6","372","2024-12-30"
"25432","2024","COM","2022","2180","60","2240","2024-12-30"
"25433","2024","COM","2022","40","1","41","2024-12-30"
"25434","2024","COM","2022","4421","85","4506","2024-12-30"
"25435","2024","COM","2022","179","3","182","2024-12-30"
"25436","2024","COM","2022","58","1","59","2024-12-30"
"25437","2024","COM","2022","364","8","372","2024-12-30"
"25438","2024","COM","2022","956","14","970","2024-12-30"
"25439","2024","COM","2022","253","3","256","2024-12-30"
"25440","2024","COM","2022","393","14","407","2024-12-30"
"25441","2024","COM","2022","68","1","69","2024-12-30"
"25442","2024","COM","2022","714","26","740","2024-12-30"
"25443","2024","COM","2022","59","2","61","2024-12-30"
"25444","2024","COM","2022","145","4","149","2024-12-30"
"25445","2024","COM","2022","118","2","120","2024-12-30"
"25446","2024","COM","2022","182","10","192","2024-12-30"
"25447","2024","COM","2022","334","9","343","2024-12-30"
"25448","2024","COM","2022","1588","24","1612","2024-12-30"
"25449","2024","COM","2022","136","2","138","2024-12-30"
"25450","2024","COM","2022","90","3","93","2024-12-30"
"25451","2024","COM","2022","174","2","176","2024-12-30"
"25452","2024","COM","2022","480","10","490","2024-12-30"
"25453","2024","COM","2022","1361","38","1399","2024-12-30"
"25454","2024","COM","2022","2179","53","2232","2024-12-30"
"25455","2024","COM","2022","193","4","197","2024-12-30"
"25456","2024","COM","2022","280","9","289","2024-12-30"
"25457","2024","COM","2022","116","1","117","2024-12-30"
"25458","2024","COM","2022","211","5","216","2024-12-30"
"25459","2024","COM","2022","325","14","339","2024-12-30"
"25460","2024","COM","2022","245","18","263","2024-12-30"
"25461","2024","COM","2022","298","5","303","2024-12-30"
"25462","2024","COM","2022","17928","863","18791","2024-12-30"
"25463","2024","COM","2022","3971","56","4027","2024-12-30"
"25464","2024","COM","2022","137","2","139","2024-12-30"
"25465","2024","COM","2022","207","4","211","2024-12-30"
"25466","2024","COM","2022","824","16","840","2024-12-30"
"25467","2024","COM","2022","2162","36","2198","2024-12-30"
"25468","2024","COM","2022","850","18","868","2024-12-30"
"25469","2024","COM","2022","468","14","482","2024-12-30"
"25470","2024","COM","2022","160","4","164","2024-12-30"
"25471","2024","COM","2022","139","4","143","2024-12-30"
"25472","2024","COM","2022","33","3","36","2024-12-30"
"25473","2024","COM","2022","686","13","699","2024-12-30"
"25474","2024","COM","2022","105","3","108","2024-12-30"
"25475","2024","COM","2022","1313","23","1336","2024-12-30"
"25476","2024","COM","2022","136","3","139","2024-12-30"
"25477","2024","COM","2022","421","7","428","2024-12-30"
"25478","2024","COM","2022","111","2","113","2024-12-30"
"25479","2024","COM","2022","389","5","394","2024-12-30"
"25481","2024","COM","2022","337","5","342","2024-12-30"
"25482","2024","COM","2022","716","7","723","2024-12-30"
"25483","2024","COM","2022","41","2","43","2024-12-30"
"25485","2024","COM","2022","206","5","211","2024-12-30"
"25486","2024","COM","2022","456","11","467","2024-12-30"
"25487","2024","COM","2022","43","1","44","2024-12-30"
"25488","2024","COM","2022","107","1","108","2024-12-30"
"25489","2024","COM","2022","269","25","294","2024-12-30"
"25490","2024","COM","2022","374","17","391","2024-12-30"
"25491","2024","COM","2022","109","2","111","2024-12-30"
"25492","2024","COM","2022","96","2","98","2024-12-30"
"25493","2024","COM","2022","927","23","950","2024-12-30"
"25494","2024","COM","2022","748","28","776","2024-12-30"
"25495","2024","COM","2022","2185","20","2205","2024-12-30"
"25496","2024","COM","2022","98","0","98","2024-12-30"
"25497","2024","COM","2022","611","15","626","2024-12-30"
"25498","2024","COM","2022","47","1","48","2024-12-30"
"25499","2024","COM","2022","119","3","122","2024-12-30"
"25500","2024","COM","2022","97","2","99","2024-12-30"
"25501","2024","COM","2022","38","2","40","2024-12-30"
"25502","2024","COM","2022","578","7","585","2024-12-30"
"25503","2024","COM","2022","110","4","114","2024-12-30"
"25504","2024","COM","2022","80","1","81","2024-12-30"
"25505","2024","COM","2022","1012","24","1036","2024-12-30"
"25506","2024","COM","2022","89","0","89","2024-12-30"
"25507","2024","COM","2022","82","2","84","2024-12-30"
"25508","2024","COM","2022","1122","27","1149","2024-12-30"
"25510","2024","COM","2022","366","9","375","2024-12-30"
"25511","2024","COM","2022","359","8","367","2024-12-30"
"25512","2024","COM","2022","2546","55","2601","2024-12-30"
"25513","2024","COM","2022","52","0","52","2024-12-30"
"25514","2024","COM","2022","309","11","320","2024-12-30"
"25515","2024","COM","2022","482","6","488","2024-12-30"
"25516","2024","COM","2022","125","6","131","2024-12-30"
"25517","2024","COM","2022","258","9","267","2024-12-30"
"25518","2024","COM","2022","155","8","163","2024-12-30"
"25519","2024","COM","2022","965","13","978","2024-12-30"
"25520","2024","COM","2022","189","3","192","2024-12-30"
"25521","2024","COM","2022","158","7","165","2024-12-30"
"25522","2024","COM","2022","182","9","191","2024-12-30"
"25523","2024","COM","2022","655","14","669","2024-12-30"
"25524","2024","COM","2022","889","23","912","2024-12-30"
"25525","2024","COM","2022","305","12","317","2024-12-30"
"25526","2024","COM","2022","1461","25","1486","2024-12-30"
"25527","2024","COM","2022","5059","56","5115","2024-12-30"
"25528","2024","COM","2022","70","1","71","2024-12-30"
"25529","2024","COM","2022","1364","19","1383","2024-12-30"
"25532","2024","COM","2022","3142","68","3210","2024-12-30"
"25533","2024","COM","2022","20","0","20","2024-12-30"
"25534","2024","COM","2022","194","7","201","2024-12-30"
"25535","2024","COM","2022","232","6","238","2024-12-30"
"25536","2024","COM","2022","194","1","195","2024-12-30"
"25537","2024","COM","2022","289","10","299","2024-12-30"
"25538","2024","COM","2022","115","4","119","2024-12-30"
"25539","2024","COM","2022","5812","141","5953","2024-12-30"
"25540","2024","COM","2022","306","16","322","2024-12-30"
"25541","2024","COM","2022","383","7","390","2024-12-30"
"25542","2024","COM","2022","1921","30","1951","2024-12-30"
"25544","2024","COM","2022","200","9","209","2024-12-30"
"25545","2024","COM","2022","134","0","134","2024-12-30"
"25546","2024","COM","2022","57","0","57","2024-12-30"
"25547","2024","COM","2022","3772","41","3813","2024-12-30"
"25548","2024","COM","2022","133","1","134","2024-12-30"
"25550","2024","COM","2022","238","9","247","2024-12-30"
"25551","2024","COM","2022","138","2","140","2024-12-30"
"25552","2024","COM","2022","116","1","117","2024-12-30"
"25553","2024","COM","2022","364","8","372","2024-12-30"
"25554","2024","COM","2022","123","2","125","2024-12-30"
"25555","2024","COM","2022","1132","28","1160","2024-12-30"
"25556","2024","COM","2022","47","2","49","2024-12-30"
"25557","2024","COM","2022","437","8","445","2024-12-30"
"25558","2024","COM","2022","1498","33","1531","2024-12-30"
"25559","2024","COM","2022","245","6","251","2024-12-30"
"25560","2024","COM","2022","2990","38","3028","2024-12-30"
"25561","2024","COM","2022","336","8","344","2024-12-30"
"25562","2024","COM","2022","206","6","212","2024-12-30"
"25563","2024","COM","2022","116","2","118","2024-12-30"
"25564","2024","COM","2022","1004","17","1021","2024-12-30"
"25565","2024","COM","2022","267","8","275","2024-12-30"
"25566","2024","COM","2022","323","6","329","2024-12-30"
"25567","2024","COM","2022","112","3","115","2024-12-30"
"25569","2024","COM","2022","558","11","569","2024-12-30"
"25570","2024","COM","2022","28","1","29","2024-12-30"
"25571","2024","COM","2022","532","11","543","2024-12-30"
"25572","2024","COM","2022","103","5","108","2024-12-30"
"25573","2024","COM","2022","16","1","17","2024-12-30"
"25574","2024","COM","2022","187","1","188","2024-12-30"
"25575","2024","COM","2022","805","10","815","2024-12-30"
"25578","2024","COM","2022","5715","109","5824","2024-12-30"
"25579","2024","COM","2022","197","3","200","2024-12-30"
"25580","2024","COM","2022","10624","177","10801","2024-12-30"
"25582","2024","COM","2022","144","2","146","2024-12-30"
"25583","2024","COM","2022","265","5","270","2024-12-30"
"25584","2024","COM","2022","125","6","131","2024-12-30"
"25586","2024","COM","2022","808","34","842","2024-12-30"
"25588","2024","COM","2022","117","23","140","2024-12-30"
"25589","2024","COM","2022","77","0","77","2024-12-30"
"25590","2024","COM","2022","78","2","80","2024-12-30"
"25591","2024","COM","2022","147","1","148","2024-12-30"
"25592","2024","COM","2022","663","13","676","2024-12-30"
"25594","2024","COM","2022","363","6","369","2024-12-30"
"25595","2024","COM","2022","95","2","97","2024-12-30"
"25596","2024","COM","2022","65","1","66","2024-12-30"
"25597","2024","COM","2022","247","4","251","2024-12-30"
"25598","2024","COM","2022","518","6","524","2024-12-30"
"25599","2024","COM","2022","249","8","257","2024-12-30"
"25600","2024","COM","2022","243","6","249","2024-12-30"
"25601","2024","COM","2022","1732","84","1816","2024-12-30"
"25602","2024","COM","2022","117","5","122","2024-12-30"
"25604","2024","COM","2022","124","1","125","2024-12-30"
"25605","2024","COM","2022","485","9","494","2024-12-30"
"25607","2024","COM","2022","51","1","52","2024-12-30"
"25608","2024","COM","2022","180","2","182","2024-12-30"
"25609","2024","COM","2022","472","9","481","2024-12-30"
"25611","2024","COM","2022","495","8","503","2024-12-30"
"25612","2024","COM","2022","667","14","681","2024-12-30"
"25613","2024","COM","2022","91","2","93","2024-12-30"
"25614","2024","COM","2022","2829","38","2867","2024-12-30"
"25615","2024","COM","2022","467","8","475","2024-12-30"
"25616","2024","COM","2022","283","3","286","2024-12-30"
"25617","2024","COM","2022","352","8","360","2024-12-30"
"25618","2024","COM","2022","338","7","345","2024-12-30"
"25619","2024","COM","2022","222","4","226","2024-12-30"
"25620","2024","COM","2022","326","7","333","2024-12-30"
"25621","2024","COM","2022","221","23","244","2024-12-30"
"25622","2024","COM","2022","295","2","297","2024-12-30"
"25623","2024","COM","2022","142","2","144","2024-12-30"
"25624","2024","COM","2022","144","3","147","2024-12-30"
"25625","2024","COM","2022","49","1","50","2024-12-30"
"25626","2024","COM","2022","227","7","234","2024-12-30"
"25627","2024","COM","2022","293","11","304","2024-12-30"
"25629","2024","COM","2022","195","6","201","2024-12-30"
"25630","2024","COM","2022","75","0","75","2024-12-30"
"25631","2024","COM","2022","571","8","579","2024-12-30"
"25632","2024","COM","2022","3152","66","3218","2024-12-30"
"25633","2024","COM","2022","681","10","691","2024-12-30"
"25634","2024","COM","2022","669","11","680","2024-12-30"
"25635","2024","COM","2022","183","7","190","2024-12-30"
"26001","2024","COM","2022","444","9","453","2024-12-30"
"26002","2024","COM","2022","1935","44","1979","2024-12-30"
"26003","2024","COM","2022","53","0","53","2024-12-30"
"26004","2024","COM","2022","2698","56","2754","2024-12-30"
"26005","2024","COM","2022","1927","36","1963","2024-12-30"
"26006","2024","COM","2022","2633","54","2687","2024-12-30"
"26007","2024","COM","2022","102","5","107","2024-12-30"
"26008","2024","COM","2022","1353","24","1377","2024-12-30"
"26009","2024","COM","2022","1308","34","1342","2024-12-30"
"26010","2024","COM","2022","4152","102","4254","2024-12-30"
"26011","2024","COM","2022","2696","43","2739","2024-12-30"
"26012","2024","COM","2022","23","0","23","2024-12-30"
"26013","2024","COM","2022","73","2","75","2024-12-30"
"26014","2024","COM","2022","615","12","627","2024-12-30"
"26015","2024","COM","2022","76","3","79","2024-12-30"
"26016","2024","COM","2022","422","9","431","2024-12-30"
"26017","2024","COM","2022","17","0","17","2024-12-30"
"26018","2024","COM","2022","8","0","8","2024-12-30"
"26019","2024","COM","2022","262","5","267","2024-12-30"
"26020","2024","COM","2022","255","6","261","2024-12-30"
"26021","2024","COM","2022","152","2","154","2024-12-30"
"26022","2024","COM","2022","89","2","91","2024-12-30"
"26023","2024","COM","2022","1138","31","1169","2024-12-30"
"26024","2024","COM","2022","341","9","350","2024-12-30"
"26025","2024","COM","2022","216","7","223","2024-12-30"
"26026","2024","COM","2022","67","2","69","2024-12-30"
"26027","2024","COM","2022","152","1","153","2024-12-30"
"26028","2024","COM","2022","223","13","236","2024-12-30"
"26030","2024","COM","2022","4","0","4","2024-12-30"
"26031","2024","COM","2022","1068","21","1089","2024-12-30"
"26032","2024","COM","2022","452","10","462","2024-12-30"
"26033","2024","COM","2022","933","17","950","2024-12-30"
"26034","2024","COM","2022","594","10","604","2024-12-30"
"26035","2024","COM","2022","485","11","496","2024-12-30"
"26036","2024","COM","2022","102","1","103","2024-12-30"
"26037","2024","COM","2022","4272","88","4360","2024-12-30"
"26038","2024","COM","2022","1379","33","1412","2024-12-30"
"26039","2024","COM","2022","902","15","917","2024-12-30"
"26040","2024","COM","2022","78","2","80","2024-12-30"
"26041","2024","COM","2022","1453","26","1479","2024-12-30"
"26042","2024","COM","2022","1638","24","1662","2024-12-30"
"26043","2024","COM","2022","143","4","147","2024-12-30"
"26045","2024","COM","2022","1739","46","1785","2024-12-30"
"26046","2024","COM","2022","73","0","73","2024-12-30"
"26047","2024","COM","2022","94","2","96","2024-12-30"
"26048","2024","COM","2022","76","1","77","2024-12-30"
"26049","2024","COM","2022","1309","21","1330","2024-12-30"
"26050","2024","COM","2022","79","1","80","2024-12-30"
"26051","2024","COM","2022","71","0","71","2024-12-30"
"26052","2024","COM","2022","456","7","463","2024-12-30"
"26054","2024","COM","2022","1417","33","1450","2024-12-30"
"26055","2024","COM","2022","162","2","164","2024-12-30"
"26056","2024","COM","2022","682","13","695","2024-12-30"
"26057","2024","COM","2022","9777","173","9950","2024-12-30"
"26058","2024","COM","2022","19872","461","20333","2024-12-30"
"26059","2024","COM","2022","211","3","214","2024-12-30"
"26060","2024","COM","2022","149","8","157","2024-12-30"
"26061","2024","COM","2022","680","9","689","2024-12-30"
"26062","2024","COM","2022","31","3","34","2024-12-30"
"26063","2024","COM","2022","2226","64","2290","2024-12-30"
"26064","2024","COM","2022","6860","163","7023","2024-12-30"
"26065","2024","COM","2022","755","27","782","2024-12-30"
"26066","2024","COM","2022","37","1","38","2024-12-30"
"26067","2024","COM","2022","59","2","61","2024-12-30"
"26068","2024","COM","2022","200","5","205","2024-12-30"
"26069","2024","COM","2022","121","6","127","2024-12-30"
"26070","2024","COM","2022","527","14","541","2024-12-30"
"26071","2024","COM","2022","1177","28","1205","2024-12-30"
"26072","2024","COM","2022","1342","23","1365","2024-12-30"
"26073","2024","COM","2022","244","9","253","2024-12-30"
"26074","2024","COM","2022","772","77","849","2024-12-30"
"26075","2024","COM","2022","24","1","25","2024-12-30"
"26076","2024","COM","2022","31","0","31","2024-12-30"
"26077","2024","COM","2022","823","21","844","2024-12-30"
"26078","2024","COM","2022","957","29","986","2024-12-30"
"26079","2024","COM","2022","1539","39","1578","2024-12-30"
"26080","2024","COM","2022","48","0","48","2024-12-30"
"26081","2024","COM","2022","613","10","623","2024-12-30"
"26082","2024","COM","2022","101","1","102","2024-12-30"
"26083","2024","COM","2022","1807","622","2429","2024-12-30"
"26084","2024","COM","2022","4159","123","4282","2024-12-30"
"26085","2024","COM","2022","2807","54","2861","2024-12-30"
"26086","2024","COM","2022","659","5","664","2024-12-30"
"26087","2024","COM","2022","1299","44","1343","2024-12-30"
"26088","2024","COM","2022","6375","113","6488","2024-12-30"
"26089","2024","COM","2022","60","1","61","2024-12-30"
"26090","2024","COM","2022","31","0","31","2024-12-30"
"26091","2024","COM","2022","43","1","44","2024-12-30"
"26092","2024","COM","2022","770","11","781","2024-12-30"
"26093","2024","COM","2022","520","23","543","2024-12-30"
"26094","2024","COM","2022","926","15","941","2024-12-30"
"26095","2024","COM","2022","989","30","1019","2024-12-30"
"26096","2024","COM","2022","1952","29","1981","2024-12-30"
"26097","2024","COM","2022","612","18","630","2024-12-30"
"26098","2024","COM","2022","168","5","173","2024-12-30"
"26099","2024","COM","2022","528","13","541","2024-12-30"
"26100","2024","COM","2022","472","15","487","2024-12-30"
"26101","2024","COM","2022","137","6","143","2024-12-30"
"26102","2024","COM","2022","133","3","136","2024-12-30"
"26103","2024","COM","2022","506","4","510","2024-12-30"
"26104","2024","COM","2022","90","0","90","2024-12-30"
"26105","2024","COM","2022","75","1","76","2024-12-30"
"26106","2024","COM","2022","1214","18","1232","2024-12-30"
"26107","2024","COM","2022","527","15","542","2024-12-30"
"26108","2024","COM","2022","8712","254","8966","2024-12-30"
"26110","2024","COM","2022","653","18","671","2024-12-30"
"26111","2024","COM","2022","97","3","100","2024-12-30"
"26112","2024","COM","2022","211","10","221","2024-12-30"
"26113","2024","COM","2022","4796","243","5039","2024-12-30"
"26114","2024","COM","2022","3204","128","3332","2024-12-30"
"26115","2024","COM","2022","687","102","789","2024-12-30"
"26116","2024","COM","2022","5981","97","6078","2024-12-30"
"26117","2024","COM","2022","56","5","61","2024-12-30"
"26118","2024","COM","2022","1527","36","1563","2024-12-30"
"26119","2024","COM","2022","835","20","855","2024-12-30"
"26121","2024","COM","2022","1137","31","1168","2024-12-30"
"26122","2024","COM","2022","189","0","189","2024-12-30"
"26123","2024","COM","2022","25","0","25","2024-12-30"
"26124","2024","COM","2022","5497","112","5609","2024-12-30"
"26125","2024","COM","2022","1426","34","1460","2024-12-30"
"26126","2024","COM","2022","90","0","90","2024-12-30"
"26127","2024","COM","2022","134","2","136","2024-12-30"
"26128","2024","COM","2022","60","1","61","2024-12-30"
"26129","2024","COM","2022","1083","20","1103","2024-12-30"
"26130","2024","COM","2022","22","0","22","2024-12-30"
"26131","2024","COM","2022","153","3","156","2024-12-30"
"26133","2024","COM","2022","180","7","187","2024-12-30"
"26134","2024","COM","2022","84","2","86","2024-12-30"
"26135","2024","COM","2022","123","4","127","2024-12-30"
"26136","2024","COM","2022","49","0","49","2024-12-30"
"26137","2024","COM","2022","185","2","187","2024-12-30"
"26138","2024","COM","2022","1147","30","1177","2024-12-30"
"26139","2024","COM","2022","2422","56","2478","2024-12-30"
"26140","2024","COM","2022","739","26","765","2024-12-30"
"26141","2024","COM","2022","219","7","226","2024-12-30"
"26142","2024","COM","2022","115","1","116","2024-12-30"
"26143","2024","COM","2022","949","55","1004","2024-12-30"
"26144","2024","COM","2022","2136","49","2185","2024-12-30"
"26145","2024","COM","2022","692","21","713","2024-12-30"
"26146","2024","COM","2022","1589","46","1635","2024-12-30"
"26147","2024","COM","2022","20","1","21","2024-12-30"
"26148","2024","COM","2022","1895","46","1941","2024-12-30"
"26149","2024","COM","2022","1048","20","1068","2024-12-30"
"26150","2024","COM","2022","12","0","12","2024-12-30"
"26152","2024","COM","2022","26","1","27","2024-12-30"
"26153","2024","COM","2022","114","3","117","2024-12-30"
"26154","2024","COM","2022","221","3","224","2024-12-30"
"26155","2024","COM","2022","1188","16","1204","2024-12-30"
"26156","2024","COM","2022","1029","42","1071","2024-12-30"
"26157","2024","COM","2022","776","26","802","2024-12-30"
"26159","2024","COM","2022","112","3","115","2024-12-30"
"26160","2024","COM","2022","1253","20","1273","2024-12-30"
"26161","2024","COM","2022","43","0","43","2024-12-30"
"26162","2024","COM","2022","885","7","892","2024-12-30"
"26163","2024","COM","2022","46","0","46","2024-12-30"
"26164","2024","COM","2022","58","1","59","2024-12-30"
"26165","2024","COM","2022","9272","146","9418","2024-12-30"
"26166","2024","COM","2022","6584","91","6675","2024-12-30"
"26167","2024","COM","2022","589","12","601","2024-12-30"
"26168","2024","COM","2022","525","14","539","2024-12-30"
"26169","2024","COM","2022","2238","57","2295","2024-12-30"
"26170","2024","COM","2022","3303","94","3397","2024-12-30"
"26171","2024","COM","2022","178","8","186","2024-12-30"
"26172","2024","COM","2022","678","10","688","2024-12-30"
"26173","2024","COM","2022","867","22","889","2024-12-30"
"26174","2024","COM","2022","1076","32","1108","2024-12-30"
"26175","2024","COM","2022","226","2","228","2024-12-30"
"26176","2024","COM","2022","1262","43","1305","2024-12-30"
"26177","2024","COM","2022","690","22","712","2024-12-30"
"26178","2024","COM","2022","538","14","552","2024-12-30"
"26179","2024","COM","2022","2828","59","2887","2024-12-30"
"26180","2024","COM","2022","209","6","215","2024-12-30"
"26181","2024","COM","2022","239","6","245","2024-12-30"
"26182","2024","COM","2022","1514","33","1547","2024-12-30"
"26183","2024","COM","2022","1202","31","1233","2024-12-30"
"26185","2024","COM","2022","606","15","621","2024-12-30"
"26186","2024","COM","2022","72","0","72","2024-12-30"
"26188","2024","COM","2022","1055","23","1078","2024-12-30"
"26189","2024","COM","2022","117","2","119","2024-12-30"
"26190","2024","COM","2022","88","3","91","2024-12-30"
"26191","2024","COM","2022","2559","73","2632","2024-12-30"
"26192","2024","COM","2022","269","6","275","2024-12-30"
"26193","2024","COM","2022","444","3","447","2024-12-30"
"26194","2024","COM","2022","600","17","617","2024-12-30"
"26195","2024","COM","2022","195","2","197","2024-12-30"
"26196","2024","COM","2022","1670","121","1791","2024-12-30"
"26197","2024","COM","2022","4284","116","4400","2024-12-30"
"26198","2024","COM","2022","40356","1126","41482","2024-12-30"
"26199","2024","COM","2022","27","1","28","2024-12-30"
"26200","2024","COM","2022","101","1","102","2024-12-30"
"26201","2024","COM","2022","44","3","47","2024-12-30"
"26202","2024","COM","2022","322","9","331","2024-12-30"
"26203","2024","COM","2022","277","6","283","2024-12-30"
"26204","2024","COM","2022","140","4","144","2024-12-30"
"26205","2024","COM","2022","95","3","98","2024-12-30"
"26206","2024","COM","2022","2964","100","3064","2024-12-30"
"26207","2024","COM","2022","659","11","670","2024-12-30"
"26208","2024","COM","2022","1935","33","1968","2024-12-30"
"26209","2024","COM","2022","25","0","25","2024-12-30"
"26210","2024","COM","2022","1020","17","1037","2024-12-30"
"26211","2024","COM","2022","1371","29","1400","2024-12-30"
"26212","2024","COM","2022","1283","32","1315","2024-12-30"
"26213","2024","COM","2022","685","14","699","2024-12-30"
"26214","2024","COM","2022","79","0","79","2024-12-30"
"26215","2024","COM","2022","400","20","420","2024-12-30"
"26216","2024","COM","2022","1258","25","1283","2024-12-30"
"26217","2024","COM","2022","197","4","201","2024-12-30"
"26218","2024","COM","2022","3404","63","3467","2024-12-30"
"26220","2024","COM","2022","6794","154","6948","2024-12-30"
"26221","2024","COM","2022","60","1","61","2024-12-30"
"26222","2024","COM","2022","39","0","39","2024-12-30"
"26223","2024","COM","2022","513","5","518","2024-12-30"
"26224","2024","COM","2022","286","8","294","2024-12-30"
"26225","2024","COM","2022","701","16","717","2024-12-30"
"26226","2024","COM","2022","363","5","368","2024-12-30"
"26227","2024","COM","2022","25","0","25","2024-12-30"
"26228","2024","COM","2022","22","1","23","2024-12-30"
"26229","2024","COM","2022","89","6","95","2024-12-30"
"26231","2024","COM","2022","2630","72","2702","2024-12-30"
"26232","2024","COM","2022","576","14","590","2024-12-30"
"26233","2024","COM","2022","240","8","248","2024-12-30"
"26234","2024","COM","2022","883","17","900","2024-12-30"
"26235","2024","COM","2022","13909","229","14138","2024-12-30"
"26236","2024","COM","2022","228","1","229","2024-12-30"
"26238","2024","COM","2022","225","4","229","2024-12-30"
"26239","2024","COM","2022","214","5","219","2024-12-30"
"26240","2024","COM","2022","164","2","166","2024-12-30"
"26241","2024","COM","2022","147","2","149","2024-12-30"
"26242","2024","COM","2022","22","1","23","2024-12-30"
"26243","2024","COM","2022","958","36","994","2024-12-30"
"26244","2024","COM","2022","117","5","122","2024-12-30"
"26245","2024","COM","2022","7","0","7","2024-12-30"
"26246","2024","COM","2022","143","3","146","2024-12-30"
"26247","2024","COM","2022","527","6","533","2024-12-30"
"26248","2024","COM","2022","176","6","182","2024-12-30"
"26249","2024","COM","2022","659","21","680","2024-12-30"
"26250","2024","COM","2022","3683","53","3736","2024-12-30"
"26251","2024","COM","2022","455","7","462","2024-12-30"
"26252","2024","COM","2022","10369","164","10533","2024-12-30"
"26253","2024","COM","2022","89","1","90","2024-12-30"
"26254","2024","COM","2022","25","0","25","2024-12-30"
"26255","2024","COM","2022","28","0","28","2024-12-30"
"26256","2024","COM","2022","131","5","136","2024-12-30"
"26257","2024","COM","2022","447","13","460","2024-12-30"
"26258","2024","COM","2022","834","18","852","2024-12-30"
"26259","2024","COM","2022","275","4","279","2024-12-30"
"26261","2024","COM","2022","394","9","403","2024-12-30"
"26262","2024","COM","2022","327","3","330","2024-12-30"
"26263","2024","COM","2022","120","2","122","2024-12-30"
"26264","2024","COM","2022","317","9","326","2024-12-30"
"26266","2024","COM","2022","22","0","22","2024-12-30"
"26267","2024","COM","2022","25","1","26","2024-12-30"
"26268","2024","COM","2022","119","3","122","2024-12-30"
"26269","2024","COM","2022","52","0","52","2024-12-30"
"26270","2024","COM","2022","130","1","131","2024-12-30"
"26271","2024","COM","2022","3579","70","3649","2024-12-30"
"26272","2024","COM","2022","359","10","369","2024-12-30"
"26273","2024","COM","2022","1061","24","1085","2024-12-30"
"26274","2024","COM","2022","2","0","2","2024-12-30"
"26275","2024","COM","2022","1677","48","1725","2024-12-30"
"26276","2024","COM","2022","477","14","491","2024-12-30"
"26277","2024","COM","2022","190","4","194","2024-12-30"
"26278","2024","COM","2022","288","3","291","2024-12-30"
"26279","2024","COM","2022","54","1","55","2024-12-30"
"26281","2024","COM","2022","33139","655","33794","2024-12-30"
"26282","2024","COM","2022","231","5","236","2024-12-30"
"26283","2024","COM","2022","25","0","25","2024-12-30"
"26284","2024","COM","2022","400","7","407","2024-12-30"
"26285","2024","COM","2022","275","8","283","2024-12-30"
"26286","2024","COM","2022","24","1","25","2024-12-30"
"26287","2024","COM","2022","480","14","494","2024-12-30"
"26288","2024","COM","2022","298","7","305","2024-12-30"
"26289","2024","COM","2022","1421","21","1442","2024-12-30"
"26290","2024","COM","2022","365","11","376","2024-12-30"
"26291","2024","COM","2022","83","2","85","2024-12-30"
"26292","2024","COM","2022","204","6","210","2024-12-30"
"26293","2024","COM","2022","320","5","325","2024-12-30"
"26294","2024","COM","2022","599","17","616","2024-12-30"
"26295","2024","COM","2022","1852","30","1882","2024-12-30"
"26296","2024","COM","2022","34","1","35","2024-12-30"
"26298","2024","COM","2022","425","5","430","2024-12-30"
"26299","2024","COM","2022","101","3","104","2024-12-30"
"26300","2024","COM","2022","46","1","47","2024-12-30"
"26301","2024","COM","2022","4224","71","4295","2024-12-30"
"26302","2024","COM","2022","542","9","551","2024-12-30"
"26303","2024","COM","2022","72","4","76","2024-12-30"
"26304","2024","COM","2022","221","7","228","2024-12-30"
"26305","2024","COM","2022","1088","20","1108","2024-12-30"
"26306","2024","COM","2022","326","12","338","2024-12-30"
"26307","2024","COM","2022","2827","47","2874","2024-12-30"
"26308","2024","COM","2022","163","0","163","2024-12-30"
"26309","2024","COM","2022","252","9","261","2024-12-30"
"26310","2024","COM","2022","157","1","158","2024-12-30"
"26311","2024","COM","2022","1383","51","1434","2024-12-30"
"26312","2024","COM","2022","1231","28","1259","2024-12-30"
"26313","2024","COM","2022","6214","123","6337","2024-12-30"
"26314","2024","COM","2022","389","15","404","2024-12-30"
"26315","2024","COM","2022","436","8","444","2024-12-30"
"26316","2024","COM","2022","225","6","231","2024-12-30"
"26317","2024","COM","2022","795","8","803","2024-12-30"
"26318","2024","COM","2022","31","1","32","2024-12-30"
"26319","2024","COM","2022","567","13","580","2024-12-30"
"26320","2024","COM","2022","821","15","836","2024-12-30"
"26321","2024","COM","2022","205","0","205","2024-12-30"
"26322","2024","COM","2022","400","22","422","2024-12-30"
"26323","2024","COM","2022","1927","33","1960","2024-12-30"
"26324","2024","COM","2022","8776","435","9211","2024-12-30"
"26325","2024","COM","2022","6947","75","7022","2024-12-30"
"26326","2024","COM","2022","1450","43","1493","2024-12-30"
"26327","2024","COM","2022","231","8","239","2024-12-30"
"26328","2024","COM","2022","54","0","54","2024-12-30"
"26329","2024","COM","2022","185","4","189","2024-12-30"
"26330","2024","COM","2022","2237","42","2279","2024-12-30"
"26331","2024","COM","2022","582","12","594","2024-12-30"
"26332","2024","COM","2022","2129","25","2154","2024-12-30"
"26333","2024","COM","2022","4083","158","4241","2024-12-30"
"26334","2024","COM","2022","143","4","147","2024-12-30"
"26335","2024","COM","2022","214","5","219","2024-12-30"
"26336","2024","COM","2022","582","11","593","2024-12-30"
"26337","2024","COM","2022","1882","31","1913","2024-12-30"
"26338","2024","COM","2022","1834","58","1892","2024-12-30"
"26339","2024","COM","2022","1630","45","1675","2024-12-30"
"26340","2024","COM","2022","236","5","241","2024-12-30"
"26341","2024","COM","2022","737","11","748","2024-12-30"
"26342","2024","COM","2022","311","7","318","2024-12-30"
"26343","2024","COM","2022","108","2","110","2024-12-30"
"26344","2024","COM","2022","402","9","411","2024-12-30"
"26345","2024","COM","2022","2067","69","2136","2024-12-30"
"26346","2024","COM","2022","247","10","257","2024-12-30"
"26347","2024","COM","2022","5890","213","6103","2024-12-30"
"26348","2024","COM","2022","1632","33","1665","2024-12-30"
"26349","2024","COM","2022","354","8","362","2024-12-30"
"26350","2024","COM","2022","66","1","67","2024-12-30"
"26351","2024","COM","2022","22","0","22","2024-12-30"
"26352","2024","COM","2022","260","9","269","2024-12-30"
"26353","2024","COM","2022","1084","19","1103","2024-12-30"
"26355","2024","COM","2022","639","9","648","2024-12-30"
"26356","2024","COM","2022","143","4","147","2024-12-30"
"26357","2024","COM","2022","2001","39","2040","2024-12-30"
"26358","2024","COM","2022","1532","41","1573","2024-12-30"
"26359","2024","COM","2022","35","0","35","2024-12-30"
"26360","2024","COM","2022","720","26","746","2024-12-30"
"26361","2024","COM","2022","134","3","137","2024-12-30"
"26362","2024","COM","2022","64288","1198","65486","2024-12-30"
"26363","2024","COM","2022","41","0","41","2024-12-30"
"26364","2024","COM","2022","338","7","345","2024-12-30"
"26365","2024","COM","2022","611","15","626","2024-12-30"
"26367","2024","COM","2022","632","13","645","2024-12-30"
"26368","2024","COM","2022","450","8","458","2024-12-30"
"26369","2024","COM","2022","67","0","67","2024-12-30"
"26370","2024","COM","2022","134","5","139","2024-12-30"
"26371","2024","COM","2022","38","1","39","2024-12-30"
"26372","2024","COM","2022","40","1","41","2024-12-30"
"26373","2024","COM","2022","251","6","257","2024-12-30"
"26374","2024","COM","2022","19","0","19","2024-12-30"
"26375","2024","COM","2022","18","0","18","2024-12-30"
"26376","2024","COM","2022","102","2","104","2024-12-30"
"26377","2024","COM","2022","1005","24","1029","2024-12-30"
"26378","2024","COM","2022","36","2","38","2024-12-30"
"26379","2024","COM","2022","904","12","916","2024-12-30"
"26380","2024","COM","2022","545","8","553","2024-12-30"
"26381","2024","COM","2022","976","18","994","2024-12-30"
"26382","2024","COM","2022","619","11","630","2024-12-30"
"27001","2024","COM","2022","345","9","354","2024-12-30"
"27002","2024","COM","2022","472","12","484","2024-12-30"
"27003","2024","COM","2022","1725","35","1760","2024-12-30"
"27004","2024","COM","2022","411","14","425","2024-12-30"
"27005","2024","COM","2022","1230","22","1252","2024-12-30"
"27006","2024","COM","2022","156","3","159","2024-12-30"
"27008","2024","COM","2022","1575","19","1594","2024-12-30"
"27009","2024","COM","2022","551","12","563","2024-12-30"
"27010","2024","COM","2022","174","8","182","2024-12-30"
"27011","2024","COM","2022","1200","19","1219","2024-12-30"
"27012","2024","COM","2022","444","16","460","2024-12-30"
"27013","2024","COM","2022","517","9","526","2024-12-30"
"27014","2024","COM","2022","882","22","904","2024-12-30"
"27015","2024","COM","2022","1324","25","1349","2024-12-30"
"27016","2024","COM","2022","7822","146","7968","2024-12-30"
"27017","2024","COM","2022","1404","38","1442","2024-12-30"
"27018","2024","COM","2022","996","12","1008","2024-12-30"
"27019","2024","COM","2022","161","7","168","2024-12-30"
"27020","2024","COM","2022","1651","28","1679","2024-12-30"
"27021","2024","COM","2022","338","9","347","2024-12-30"
"27022","2024","COM","2022","5156","109","5265","2024-12-30"
"27023","2024","COM","2022","707","19","726","2024-12-30"
"27025","2024","COM","2022","944","32","976","2024-12-30"
"27026","2024","COM","2022","466","8","474","2024-12-30"
"27027","2024","COM","2022","292","7","299","2024-12-30"
"27028","2024","COM","2022","333","7","340","2024-12-30"
"27031","2024","COM","2022","1098","38","1136","2024-12-30"
"27032","2024","COM","2022","1347","33","1380","2024-12-30"
"27033","2024","COM","2022","307","4","311","2024-12-30"
"27034","2024","COM","2022","620","7","627","2024-12-30"
"27035","2024","COM","2022","97","0","97","2024-12-30"
"27036","2024","COM","2022","545","22","567","2024-12-30"
"27037","2024","COM","2022","1168","21","1189","2024-12-30"
"27038","2024","COM","2022","270","5","275","2024-12-30"
"27039","2024","COM","2022","530","26","556","2024-12-30"
"27040","2024","COM","2022","449","5","454","2024-12-30"
"27042","2024","COM","2022","85","1","86","2024-12-30"
"27043","2024","COM","2022","686","20","706","2024-12-30"
"27044","2024","COM","2022","868","19","887","2024-12-30"
"27045","2024","COM","2022","780","17","797","2024-12-30"
"27046","2024","COM","2022","140","1","141","2024-12-30"
"27047","2024","COM","2022","338","8","346","2024-12-30"
"27048","2024","COM","2022","207","5","212","2024-12-30"
"27049","2024","COM","2022","4441","120","4561","2024-12-30"
"27050","2024","COM","2022","634","14","648","2024-12-30"
"27051","2024","COM","2022","2767","52","2819","2024-12-30"
"27052","2024","COM","2022","378","5","383","2024-12-30"
"27053","2024","COM","2022","200","2","202","2024-12-30"
"27054","2024","COM","2022","557","13","570","2024-12-30"
"27055","2024","COM","2022","330","9","339","2024-12-30"
"27056","2024","COM","2022","9801","249","10050","2024-12-30"
"27057","2024","COM","2022","295","5","300","2024-12-30"
"27059","2024","COM","2022","317","7","324","2024-12-30"
"27061","2024","COM","2022","336","5","341","2024-12-30"
"27062","2024","COM","2022","1609","46","1655","2024-12-30"
"27063","2024","COM","2022","265","3","268","2024-12-30"
"27064","2024","COM","2022","680","8","688","2024-12-30"
"27065","2024","COM","2022","4697","69","4766","2024-12-30"
"27066","2024","COM","2022","289","3","292","2024-12-30"
"27067","2024","COM","2022","1616","29","1645","2024-12-30"
"27068","2024","COM","2022","186","2","188","2024-12-30"
"27069","2024","COM","2022","699","15","714","2024-12-30"
"27070","2024","COM","2022","1690","28","1718","2024-12-30"
"27071","2024","COM","2022","210","2","212","2024-12-30"
"27072","2024","COM","2022","744","20","764","2024-12-30"
"27073","2024","COM","2022","1234","23","1257","2024-12-30"
"27074","2024","COM","2022","287","6","293","2024-12-30"
"27075","2024","COM","2022","371","7","378","2024-12-30"
"27076","2024","COM","2022","489","8","497","2024-12-30"
"27077","2024","COM","2022","877","6","883","2024-12-30"
"27078","2024","COM","2022","261","11","272","2024-12-30"
"27079","2024","COM","2022","379","3","382","2024-12-30"
"27081","2024","COM","2022","186","8","194","2024-12-30"
"27082","2024","COM","2022","2045","33","2078","2024-12-30"
"27083","2024","COM","2022","261","5","266","2024-12-30"
"27085","2024","COM","2022","1586","24","1610","2024-12-30"
"27089","2024","COM","2022","1016","18","1034","2024-12-30"
"27090","2024","COM","2022","3855","78","3933","2024-12-30"
"27091","2024","COM","2022","776","11","787","2024-12-30"
"27094","2024","COM","2022","128","1","129","2024-12-30"
"27095","2024","COM","2022","671","11","682","2024-12-30"
"27096","2024","COM","2022","347","5","352","2024-12-30"
"27097","2024","COM","2022","647","13","660","2024-12-30"
"27098","2024","COM","2022","72","5","77","2024-12-30"
"27099","2024","COM","2022","818","22","840","2024-12-30"
"27100","2024","COM","2022","1227","23","1250","2024-12-30"
"27101","2024","COM","2022","489","11","500","2024-12-30"
"27102","2024","COM","2022","1049","16","1065","2024-12-30"
"27103","2024","COM","2022","4029","74","4103","2024-12-30"
"27104","2024","COM","2022","725","5","730","2024-12-30"
"27105","2024","COM","2022","4006","86","4092","2024-12-30"
"27106","2024","COM","2022","486","6","492","2024-12-30"
"27107","2024","COM","2022","1297","28","1325","2024-12-30"
"27108","2024","COM","2022","1166","34","1200","2024-12-30"
"27109","2024","COM","2022","400","8","408","2024-12-30"
"27110","2024","COM","2022","636","9","645","2024-12-30"
"27111","2024","COM","2022","202","2","204","2024-12-30"
"27112","2024","COM","2022","4284","135","4419","2024-12-30"
"27113","2024","COM","2022","142","2","144","2024-12-30"
"27114","2024","COM","2022","1212","23","1235","2024-12-30"
"27115","2024","COM","2022","336","6","342","2024-12-30"
"27116","2024","COM","2022","4220","158","4378","2024-12-30"
"27117","2024","COM","2022","1035","13","1048","2024-12-30"
"27118","2024","COM","2022","647","9","656","2024-12-30"
"27119","2024","COM","2022","1635","29","1664","2024-12-30"
"27120","2024","COM","2022","402","6","408","2024-12-30"
"27123","2024","COM","2022","490","10","500","2024-12-30"
"27124","2024","COM","2022","223","10","233","2024-12-30"
"27125","2024","COM","2022","661","11","672","2024-12-30"
"27126","2024","COM","2022","1097","21","1118","2024-12-30"
"27127","2024","COM","2022","704","22","726","2024-12-30"
"27129","2024","COM","2022","603","19","622","2024-12-30"
"27130","2024","COM","2022","426","9","435","2024-12-30"
"27132","2024","COM","2022","817","23","840","2024-12-30"
"27133","2024","COM","2022","1132","12","1144","2024-12-30"
"27134","2024","COM","2022","211","7","218","2024-12-30"
"27135","2024","COM","2022","443","11","454","2024-12-30"
"27136","2024","COM","2022","267","4","271","2024-12-30"
"27137","2024","COM","2022","207","2","209","2024-12-30"
"27138","2024","COM","2022","359","11","370","2024-12-30"
"27139","2024","COM","2022","172","1","173","2024-12-30"
"27140","2024","COM","2022","396","9","405","2024-12-30"
"27141","2024","COM","2022","63","1","64","2024-12-30"
"27142","2024","COM","2022","304","7","311","2024-12-30"
"27144","2024","COM","2022","272","4","276","2024-12-30"
"27146","2024","COM","2022","383","11","394","2024-12-30"
"27147","2024","COM","2022","656","15","671","2024-12-30"
"27148","2024","COM","2022","406","9","415","2024-12-30"
"27149","2024","COM","2022","122","2","124","2024-12-30"
"27151","2024","COM","2022","1703","18","1721","2024-12-30"
"27152","2024","COM","2022","626","6","632","2024-12-30"
"27153","2024","COM","2022","393","7","400","2024-12-30"
"27154","2024","COM","2022","580","7","587","2024-12-30"
"27155","2024","COM","2022","100","1","101","2024-12-30"
"27156","2024","COM","2022","457","18","475","2024-12-30"
"27157","2024","COM","2022","1307","20","1327","2024-12-30"
"27158","2024","COM","2022","808","28","836","2024-12-30"
"27161","2024","COM","2022","1068","21","1089","2024-12-30"
"27162","2024","COM","2022","254","3","257","2024-12-30"
"27163","2024","COM","2022","179","3","182","2024-12-30"
"27164","2024","COM","2022","822","15","837","2024-12-30"
"27165","2024","COM","2022","4860","72","4932","2024-12-30"
"27167","2024","COM","2022","656","12","668","2024-12-30"
"27168","2024","COM","2022","172","7","179","2024-12-30"
"27169","2024","COM","2022","1032","13","1045","2024-12-30"
"27170","2024","COM","2022","1136","19","1155","2024-12-30"
"27171","2024","COM","2022","361","10","371","2024-12-30"
"27173","2024","COM","2022","123","1","124","2024-12-30"
"27174","2024","COM","2022","1371","28","1399","2024-12-30"
"27176","2024","COM","2022","217","8","225","2024-12-30"
"27177","2024","COM","2022","541","11","552","2024-12-30"
"27179","2024","COM","2022","725","14","739","2024-12-30"
"27180","2024","COM","2022","2157","40","2197","2024-12-30"
"27181","2024","COM","2022","593","11","604","2024-12-30"
"27182","2024","COM","2022","177","2","179","2024-12-30"
"27183","2024","COM","2022","2301","36","2337","2024-12-30"
"27184","2024","COM","2022","121","3","124","2024-12-30"
"27185","2024","COM","2022","544","8","552","2024-12-30"
"27187","2024","COM","2022","351","6","357","2024-12-30"
"27188","2024","COM","2022","1537","32","1569","2024-12-30"
"27189","2024","COM","2022","409","7","416","2024-12-30"
"27190","2024","COM","2022","225","4","229","2024-12-30"
"27191","2024","COM","2022","2490","64","2554","2024-12-30"
"27192","2024","COM","2022","610","16","626","2024-12-30"
"27193","2024","COM","2022","1419","19","1438","2024-12-30"
"27194","2024","COM","2022","248","2","250","2024-12-30"
"27196","2024","COM","2022","1335","24","1359","2024-12-30"
"27198","2024","COM","2022","6142","215","6357","2024-12-30"
"27199","2024","COM","2022","542","12","554","2024-12-30"
"27200","2024","COM","2022","131","6","137","2024-12-30"
"27201","2024","COM","2022","245","3","248","2024-12-30"
"27202","2024","COM","2022","460","11","471","2024-12-30"
"27203","2024","COM","2022","456","18","474","2024-12-30"
"27204","2024","COM","2022","265","7","272","2024-12-30"
"27205","2024","COM","2022","414","8","422","2024-12-30"
"27206","2024","COM","2022","459","9","468","2024-12-30"
"27207","2024","COM","2022","576","7","583","2024-12-30"
"27208","2024","COM","2022","144","1","145","2024-12-30"
"27209","2024","COM","2022","608","12","620","2024-12-30"
"27210","2024","COM","2022","446","13","459","2024-12-30"
"27212","2024","COM","2022","114","3","117","2024-12-30"
"27213","2024","COM","2022","6026","135","6161","2024-12-30"
"27214","2024","COM","2022","849","15","864","2024-12-30"
"27215","2024","COM","2022","388","8","396","2024-12-30"
"27216","2024","COM","2022","465","25","490","2024-12-30"
"27217","2024","COM","2022","544","10","554","2024-12-30"
"27218","2024","COM","2022","1562","28","1590","2024-12-30"
"27219","2024","COM","2022","529","6","535","2024-12-30"
"27220","2024","COM","2022","353","8","361","2024-12-30"
"27222","2024","COM","2022","199","7","206","2024-12-30"
"27224","2024","COM","2022","444","10","454","2024-12-30"
"27226","2024","COM","2022","3677","63","3740","2024-12-30"
"27227","2024","COM","2022","669","11","680","2024-12-30"
"27228","2024","COM","2022","303","11","314","2024-12-30"
"27229","2024","COM","2022","48335","1279","49614","2024-12-30"
"27230","2024","COM","2022","3653","48","3701","2024-12-30"
"27231","2024","COM","2022","423","10","433","2024-12-30"
"27232","2024","COM","2022","343","6","349","2024-12-30"
"27233","2024","COM","2022","710","13","723","2024-12-30"
"27234","2024","COM","2022","317","6","323","2024-12-30"
"27235","2024","COM","2022","154","1","155","2024-12-30"
"27237","2024","COM","2022","183","4","187","2024-12-30"
"27238","2024","COM","2022","1119","36","1155","2024-12-30"
"27239","2024","COM","2022","428","4","432","2024-12-30"
"27240","2024","COM","2022","201","3","204","2024-12-30"
"27241","2024","COM","2022","169","3","172","2024-12-30"
"27242","2024","COM","2022","1016","23","1039","2024-12-30"
"27243","2024","COM","2022","743","14","757","2024-12-30"
"27245","2024","COM","2022","289","5","294","2024-12-30"
"27246","2024","COM","2022","1810","21","1831","2024-12-30"
"27247","2024","COM","2022","321","4","325","2024-12-30"
"27248","2024","COM","2022","192","3","195","2024-12-30"
"27249","2024","COM","2022","1089","23","1112","2024-12-30"
"27251","2024","COM","2022","567","7","574","2024-12-30"
"27252","2024","COM","2022","338","5","343","2024-12-30"
"27254","2024","COM","2022","848","23","871","2024-12-30"
"27256","2024","COM","2022","636","10","646","2024-12-30"
"27258","2024","COM","2022","510","12","522","2024-12-30"
"27259","2024","COM","2022","92","4","96","2024-12-30"
"27260","2024","COM","2022","649","8","657","2024-12-30"
"27261","2024","COM","2022","443","10","453","2024-12-30"
"27263","2024","COM","2022","1221","21","1242","2024-12-30"
"27266","2024","COM","2022","304","2","306","2024-12-30"
"27267","2024","COM","2022","336","7","343","2024-12-30"
"27269","2024","COM","2022","190","2","192","2024-12-30"
"27271","2024","COM","2022","318","14","332","2024-12-30"
"27273","2024","COM","2022","365","13","378","2024-12-30"
"27275","2024","COM","2022","6785","103","6888","2024-12-30"
"27276","2024","COM","2022","290","7","297","2024-12-30"
"27277","2024","COM","2022","760","16","776","2024-12-30"
"27278","2024","COM","2022","2024","37","2061","2024-12-30"
"27279","2024","COM","2022","3080","62","3142","2024-12-30"
"27280","2024","COM","2022","976","8","984","2024-12-30"
"27281","2024","COM","2022","228","2","230","2024-12-30"
"27282","2024","COM","2022","647","19","666","2024-12-30"
"27284","2024","COM","2022","12395","213","12608","2024-12-30"
"27285","2024","COM","2022","448","22","470","2024-12-30"
"27286","2024","COM","2022","382","10","392","2024-12-30"
"27287","2024","COM","2022","851","21","872","2024-12-30"
"27288","2024","COM","2022","598","14","612","2024-12-30"
"27289","2024","COM","2022","169","3","172","2024-12-30"
"27290","2024","COM","2022","1254","18","1272","2024-12-30"
"27291","2024","COM","2022","119","4","123","2024-12-30"
"27294","2024","COM","2022","990","14","1004","2024-12-30"
"27295","2024","COM","2022","458","15","473","2024-12-30"
"27298","2024","COM","2022","321","6","327","2024-12-30"
"27299","2024","COM","2022","4016","82","4098","2024-12-30"
"27300","2024","COM","2022","525","9","534","2024-12-30"
"27301","2024","COM","2022","1431","36","1467","2024-12-30"
"27302","2024","COM","2022","1314","13","1327","2024-12-30"
"27304","2024","COM","2022","155","4","159","2024-12-30"
"27306","2024","COM","2022","3077","57","3134","2024-12-30"
"27307","2024","COM","2022","488","11","499","2024-12-30"
"27309","2024","COM","2022","486","15","501","2024-12-30"
"27310","2024","COM","2022","403","6","409","2024-12-30"
"27311","2024","COM","2022","1076","16","1092","2024-12-30"
"27312","2024","COM","2022","286","7","293","2024-12-30"
"27313","2024","COM","2022","598","17","615","2024-12-30"
"27315","2024","COM","2022","273","9","282","2024-12-30"
"27316","2024","COM","2022","1270","27","1297","2024-12-30"
"27317","2024","COM","2022","419","13","432","2024-12-30"
"27318","2024","COM","2022","252","4","256","2024-12-30"
"27319","2024","COM","2022","286","3","289","2024-12-30"
"27320","2024","COM","2022","324","2","326","2024-12-30"
"27321","2024","COM","2022","145","2","147","2024-12-30"
"27322","2024","COM","2022","1374","19","1393","2024-12-30"
"27323","2024","COM","2022","293","3","296","2024-12-30"
"27324","2024","COM","2022","634","13","647","2024-12-30"
"27325","2024","COM","2022","197","3","200","2024-12-30"
"27326","2024","COM","2022","318","7","325","2024-12-30"
"27327","2024","COM","2022","216","8","224","2024-12-30"
"27329","2024","COM","2022","749","23","772","2024-12-30"
"27330","2024","COM","2022","125","0","125","2024-12-30"
"27331","2024","COM","2022","461","6","467","2024-12-30"
"27332","2024","COM","2022","809","11","820","2024-12-30"
"27333","2024","COM","2022","723","9","732","2024-12-30"
"27334","2024","COM","2022","115","1","116","2024-12-30"
"27335","2024","COM","2022","1066","27","1093","2024-12-30"
"27336","2024","COM","2022","454","7","461","2024-12-30"
"27337","2024","COM","2022","347","6","353","2024-12-30"
"27338","2024","COM","2022","685","6","691","2024-12-30"
"27339","2024","COM","2022","813","14","827","2024-12-30"
"27340","2024","COM","2022","702","10","712","2024-12-30"
"27341","2024","COM","2022","66","1","67","2024-12-30"
"27342","2024","COM","2022","194","3","197","2024-12-30"
"27343","2024","COM","2022","1270","54","1324","2024-12-30"
"27345","2024","COM","2022","206","2","208","2024-12-30"
"27346","2024","COM","2022","234","4","238","2024-12-30"
"27347","2024","COM","2022","776","26","802","2024-12-30"
"27348","2024","COM","2022","1701","26","1727","2024-12-30"
"27349","2024","COM","2022","857","13","870","2024-12-30"
"27350","2024","COM","2022","1018","6","1024","2024-12-30"
"27351","2024","COM","2022","1352","20","1372","2024-12-30"
"27353","2024","COM","2022","472","11","483","2024-12-30"
"27354","2024","COM","2022","420","10","430","2024-12-30"
"27355","2024","COM","2022","2640","24","2664","2024-12-30"
"27358","2024","COM","2022","558","12","570","2024-12-30"
"27359","2024","COM","2022","293","2","295","2024-12-30"
"27360","2024","COM","2022","327","8","335","2024-12-30"
"27361","2024","COM","2022","404","4","408","2024-12-30"
"27363","2024","COM","2022","262","8","270","2024-12-30"
"27364","2024","COM","2022","180","5","185","2024-12-30"
"27365","2024","COM","2022","1984","25","2009","2024-12-30"
"27366","2024","COM","2022","208","5","213","2024-12-30"
"27367","2024","COM","2022","1471","33","1504","2024-12-30"
"27368","2024","COM","2022","356","8","364","2024-12-30"
"27369","2024","COM","2022","74","1","75","2024-12-30"
"27370","2024","COM","2022","299","9","308","2024-12-30"
"27371","2024","COM","2022","165","1","166","2024-12-30"
"27372","2024","COM","2022","685","7","692","2024-12-30"
"27373","2024","COM","2022","101","1","102","2024-12-30"
"27374","2024","COM","2022","506","12","518","2024-12-30"
"27375","2024","COM","2022","18347","362","18709","2024-12-30"
"27376","2024","COM","2022","215","2","217","2024-12-30"
"27377","2024","COM","2022","730","12","742","2024-12-30"
"27378","2024","COM","2022","1160","24","1184","2024-12-30"
"27379","2024","COM","2022","460","8","468","2024-12-30"
"27380","2024","COM","2022","269","5","274","2024-12-30"
"27381","2024","COM","2022","171","0","171","2024-12-30"
"27382","2024","COM","2022","343","6","349","2024-12-30"
"27383","2024","COM","2022","350","11","361","2024-12-30"
"27384","2024","COM","2022","482","11","493","2024-12-30"
"27385","2024","COM","2022","1436","44","1480","2024-12-30"
"27386","2024","COM","2022","1279","12","1291","2024-12-30"
"27388","2024","COM","2022","473","9","482","2024-12-30"
"27389","2024","COM","2022","487","5","492","2024-12-30"
"27390","2024","COM","2022","1117","17","1134","2024-12-30"
"27391","2024","COM","2022","1611","21","1632","2024-12-30"
"27392","2024","COM","2022","136","3","139","2024-12-30"
"27393","2024","COM","2022","497","6","503","2024-12-30"
"27394","2024","COM","2022","458","12","470","2024-12-30"
"27395","2024","COM","2022","92","1","93","2024-12-30"
"27396","2024","COM","2022","478","5","483","2024-12-30"
"27397","2024","COM","2022","1722","31","1753","2024-12-30"
"27398","2024","COM","2022","1532","119","1651","2024-12-30"
"27399","2024","COM","2022","56","1","57","2024-12-30"
"27400","2024","COM","2022","344","4","348","2024-12-30"
"27401","2024","COM","2022","197","3","200","2024-12-30"
"27403","2024","COM","2022","238","12","250","2024-12-30"
"27404","2024","COM","2022","84","3","87","2024-12-30"
"27405","2024","COM","2022","101","1","102","2024-12-30"
"27406","2024","COM","2022","942","24","966","2024-12-30"
"27407","2024","COM","2022","304","4","308","2024-12-30"
"27408","2024","COM","2022","598","10","608","2024-12-30"
"27410","2024","COM","2022","599","11","610","2024-12-30"
"27411","2024","COM","2022","233","2","235","2024-12-30"
"27412","2024","COM","2022","1577","34","1611","2024-12-30"
"27413","2024","COM","2022","778","14","792","2024-12-30"
"27414","2024","COM","2022","788","7","795","2024-12-30"
"27415","2024","COM","2022","372","7","379","2024-12-30"
"27417","2024","COM","2022","663","12","675","2024-12-30"
"27418","2024","COM","2022","122","3","125","2024-12-30"
"27419","2024","COM","2022","753","17","770","2024-12-30"
"27420","2024","COM","2022","162","4","166","2024-12-30"
"27421","2024","COM","2022","641","13","654","2024-12-30"
"27422","2024","COM","2022","864","20","884","2024-12-30"
"27423","2024","COM","2022","780","17","797","2024-12-30"
"27424","2024","COM","2022","334","4","338","2024-12-30"
"27425","2024","COM","2022","2291","37","2328","2024-12-30"
"27426","2024","COM","2022","1306","23","1329","2024-12-30"
"27427","2024","COM","2022","413","5","418","2024-12-30"
"27428","2024","COM","2022","4251","224","4475","2024-12-30"
"27429","2024","COM","2022","174","5","179","2024-12-30"
"27430","2024","COM","2022","389","4","393","2024-12-30"
"27431","2024","COM","2022","532","4","536","2024-12-30"
"27432","2024","COM","2022","713","8","721","2024-12-30"
"27433","2024","COM","2022","192","2","194","2024-12-30"
"27434","2024","COM","2022","61","0","61","2024-12-30"
"27435","2024","COM","2022","251","5","256","2024-12-30"
"27436","2024","COM","2022","429","10","439","2024-12-30"
"27437","2024","COM","2022","347","6","353","2024-12-30"
"27438","2024","COM","2022","2300","43","2343","2024-12-30"
"27439","2024","COM","2022","1164","25","1189","2024-12-30"
"27440","2024","COM","2022","643","23","666","2024-12-30"
"27441","2024","COM","2022","69","1","70","2024-12-30"
"27442","2024","COM","2022","188","6","194","2024-12-30"
"27444","2024","COM","2022","206","4","210","2024-12-30"
"27445","2024","COM","2022","251","2","253","2024-12-30"
"27446","2024","COM","2022","460","7","467","2024-12-30"
"27447","2024","COM","2022","883","55","938","2024-12-30"
"27448","2024","COM","2022","4975","123","5098","2024-12-30"
"27451","2024","COM","2022","288","6","294","2024-12-30"
"27453","2024","COM","2022","1791","18","1809","2024-12-30"
"27454","2024","COM","2022","466","6","472","2024-12-30"
"27455","2024","COM","2022","169","3","172","2024-12-30"
"27456","2024","COM","2022","805","21","826","2024-12-30"
"27457","2024","COM","2022","691","13","704","2024-12-30"
"27458","2024","COM","2022","2572","29","2601","2024-12-30"
"27459","2024","COM","2022","74","2","76","2024-12-30"
"27460","2024","COM","2022","206","5","211","2024-12-30"
"27462","2024","COM","2022","161","1","162","2024-12-30"
"27463","2024","COM","2022","728","17","745","2024-12-30"
"27464","2024","COM","2022","928","22","950","2024-12-30"
"27465","2024","COM","2022","402","8","410","2024-12-30"
"27466","2024","COM","2022","355","6","361","2024-12-30"
"27467","2024","COM","2022","9950","281","10231","2024-12-30"
"27468","2024","COM","2022","580","9","589","2024-12-30"
"27469","2024","COM","2022","4130","54","4184","2024-12-30"
"27470","2024","COM","2022","1137","18","1155","2024-12-30"
"27471","2024","COM","2022","209","5","214","2024-12-30"
"27472","2024","COM","2022","260","6","266","2024-12-30"
"27473","2024","COM","2022","891","24","915","2024-12-30"
"27474","2024","COM","2022","1118","19","1137","2024-12-30"
"27475","2024","COM","2022","166","2","168","2024-12-30"
"27476","2024","COM","2022","396","9","405","2024-12-30"
"27477","2024","COM","2022","696","16","712","2024-12-30"
"27478","2024","COM","2022","976","23","999","2024-12-30"
"27480","2024","COM","2022","609","19","628","2024-12-30"
"27481","2024","COM","2022","387","53","440","2024-12-30"
"27482","2024","COM","2022","157","2","159","2024-12-30"
"27483","2024","COM","2022","440","2","442","2024-12-30"
"27485","2024","COM","2022","838","10","848","2024-12-30"
"27486","2024","COM","2022","654","18","672","2024-12-30"
"27487","2024","COM","2022","643","3","646","2024-12-30"
"27488","2024","COM","2022","207","6","213","2024-12-30"
"27489","2024","COM","2022","518","14","532","2024-12-30"
"27490","2024","COM","2022","266","4","270","2024-12-30"
"27492","2024","COM","2022","329","6","335","2024-12-30"
"27493","2024","COM","2022","3227","41","3268","2024-12-30"
"27495","2024","COM","2022","236","4","240","2024-12-30"
"27496","2024","COM","2022","510","12","522","2024-12-30"
"27497","2024","COM","2022","1033","18","1051","2024-12-30"
"27498","2024","COM","2022","368","4","372","2024-12-30"
"27500","2024","COM","2022","1659","83","1742","2024-12-30"
"27501","2024","COM","2022","257","12","269","2024-12-30"
"27502","2024","COM","2022","2199","29","2228","2024-12-30"
"27504","2024","COM","2022","1207","37","1244","2024-12-30"
"27505","2024","COM","2022","154","2","156","2024-12-30"
"27507","2024","COM","2022","3903","47","3950","2024-12-30"
"27508","2024","COM","2022","213","2","215","2024-12-30"
"27511","2024","COM","2022","749","22","771","2024-12-30"
"27512","2024","COM","2022","330","8","338","2024-12-30"
"27514","2024","COM","2022","350","6","356","2024-12-30"
"27516","2024","COM","2022","1334","33","1367","2024-12-30"
"27517","2024","COM","2022","2164","50","2214","2024-12-30"
"27518","2024","COM","2022","757","14","771","2024-12-30"
"27520","2024","COM","2022","142","1","143","2024-12-30"
"27521","2024","COM","2022","141","2","143","2024-12-30"
"27522","2024","COM","2022","429","5","434","2024-12-30"
"27524","2024","COM","2022","854","12","866","2024-12-30"
"27525","2024","COM","2022","310","19","329","2024-12-30"
"27527","2024","COM","2022","206","2","208","2024-12-30"
"27528","2024","COM","2022","3622","87","3709","2024-12-30"
"27529","2024","COM","2022","429","6","435","2024-12-30"
"27530","2024","COM","2022","77","0","77","2024-12-30"
"27531","2024","COM","2022","208","4","212","2024-12-30"
"27533","2024","COM","2022","502","20","522","2024-12-30"
"27534","2024","COM","2022","895","11","906","2024-12-30"
"27535","2024","COM","2022","404","10","414","2024-12-30"
"27536","2024","COM","2022","548","15","563","2024-12-30"
"27537","2024","COM","2022","890","14","904","2024-12-30"
"27538","2024","COM","2022","524","10","534","2024-12-30"
"27539","2024","COM","2022","388","5","393","2024-12-30"
"27540","2024","COM","2022","648","12","660","2024-12-30"
"27541","2024","COM","2022","166","5","171","2024-12-30"
"27542","2024","COM","2022","894","13","907","2024-12-30"
"27543","2024","COM","2022","880","14","894","2024-12-30"
"27544","2024","COM","2022","195","4","199","2024-12-30"
"27545","2024","COM","2022","122","0","122","2024-12-30"
"27546","2024","COM","2022","171","4","175","2024-12-30"
"27547","2024","COM","2022","858","21","879","2024-12-30"
"27548","2024","COM","2022","1188","23","1211","2024-12-30"
"27550","2024","COM","2022","312","8","320","2024-12-30"
"27552","2024","COM","2022","214","5","219","2024-12-30"
"27553","2024","COM","2022","419","10","429","2024-12-30"
"27554","2024","COM","2022","3283","89","3372","2024-12-30"
"27555","2024","COM","2022","245","5","250","2024-12-30"
"27556","2024","COM","2022","66","0","66","2024-12-30"
"27557","2024","COM","2022","456","10","466","2024-12-30"
"27558","2024","COM","2022","170","3","173","2024-12-30"
"27560","2024","COM","2022","244","12","256","2024-12-30"
"27561","2024","COM","2022","667","11","678","2024-12-30"
"27562","2024","COM","2022","4474","102","4576","2024-12-30"
"27563","2024","COM","2022","856","27","883","2024-12-30"
"27564","2024","COM","2022","344","3","347","2024-12-30"
"27565","2024","COM","2022","702","10","712","2024-12-30"
"27567","2024","COM","2022","268","6","274","2024-12-30"
"27568","2024","COM","2022","491","8","499","2024-12-30"
"27569","2024","COM","2022","245","10","255","2024-12-30"
"27570","2024","COM","2022","101","2","103","2024-12-30"
"27571","2024","COM","2022","336","12","348","2024-12-30"
"27572","2024","COM","2022","308","5","313","2024-12-30"
"27576","2024","COM","2022","636","22","658","2024-12-30"
"27577","2024","COM","2022","429","11","440","2024-12-30"
"27578","2024","COM","2022","579","13","592","2024-12-30"
"27579","2024","COM","2022","101","3","104","2024-12-30"
"27580","2024","COM","2022","2426","35","2461","2024-12-30"
"27582","2024","COM","2022","1777","27","1804","2024-12-30"
"27584","2024","COM","2022","268","9","277","2024-12-30"
"27586","2024","COM","2022","172","4","176","2024-12-30"
"27587","2024","COM","2022","824","14","838","2024-12-30"
"27589","2024","COM","2022","975","32","1007","2024-12-30"
"27590","2024","COM","2022","235","5","240","2024-12-30"
"27591","2024","COM","2022","580","10","590","2024-12-30"
"27592","2024","COM","2022","231","5","236","2024-12-30"
"27593","2024","COM","2022","1688","25","1713","2024-12-30"
"27594","2024","COM","2022","258","3","261","2024-12-30"
"27595","2024","COM","2022","962","19","981","2024-12-30"
"27597","2024","COM","2022","589","1","590","2024-12-30"
"27598","2024","COM","2022","1231","22","1253","2024-12-30"
"27599","2024","COM","2022","923","7","930","2024-12-30"
"27601","2024","COM","2022","437","11","448","2024-12-30"
"27602","2024","COM","2022","5508","172","5680","2024-12-30"
"27603","2024","COM","2022","323","8","331","2024-12-30"
"27604","2024","COM","2022","156","2","158","2024-12-30"
"27605","2024","COM","2022","226","3","229","2024-12-30"
"27606","2024","COM","2022","470","3","473","2024-12-30"
"27608","2024","COM","2022","439","9","448","2024-12-30"
"27609","2024","COM","2022","337","6","343","2024-12-30"
"27610","2024","COM","2022","56","1","57","2024-12-30"
"27611","2024","COM","2022","312","10","322","2024-12-30"
"27612","2024","COM","2022","338","10","348","2024-12-30"
"27613","2024","COM","2022","370","5","375","2024-12-30"
"27614","2024","COM","2022","171","3","174","2024-12-30"
"27615","2024","COM","2022","198","5","203","2024-12-30"
"27616","2024","COM","2022","1914","40","1954","2024-12-30"
"27617","2024","COM","2022","532","7","539","2024-12-30"
"27618","2024","COM","2022","462","11","473","2024-12-30"
"27620","2024","COM","2022","476","9","485","2024-12-30"
"27621","2024","COM","2022","171","1","172","2024-12-30"
"27622","2024","COM","2022","1772","47","1819","2024-12-30"
"27623","2024","COM","2022","489","14","503","2024-12-30"
"27624","2024","COM","2022","854","25","879","2024-12-30"
"27625","2024","COM","2022","344","6","350","2024-12-30"
"27627","2024","COM","2022","272","3","275","2024-12-30"
"27629","2024","COM","2022","1765","23","1788","2024-12-30"
"27630","2024","COM","2022","326","31","357","2024-12-30"
"27631","2024","COM","2022","368","9","377","2024-12-30"
"27632","2024","COM","2022","594","11","605","2024-12-30"
"27633","2024","COM","2022","493","3","496","2024-12-30"
"27635","2024","COM","2022","143","0","143","2024-12-30"
"27638","2024","COM","2022","3801","86","3887","2024-12-30"
"27640","2024","COM","2022","197","2","199","2024-12-30"
"27641","2024","COM","2022","265","6","271","2024-12-30"
"27643","2024","COM","2022","1037","16","1053","2024-12-30"
"27644","2024","COM","2022","575","41","616","2024-12-30"
"27645","2024","COM","2022","143","5","148","2024-12-30"
"27646","2024","COM","2022","460","10","470","2024-12-30"
"27649","2024","COM","2022","340","7","347","2024-12-30"
"27650","2024","COM","2022","450","9","459","2024-12-30"
"27652","2024","COM","2022","318","9","327","2024-12-30"
"27654","2024","COM","2022","1114","27","1141","2024-12-30"
"27655","2024","COM","2022","722","161","883","2024-12-30"
"27656","2024","COM","2022","1280","30","1310","2024-12-30"
"27658","2024","COM","2022","383","9","392","2024-12-30"
"27659","2024","COM","2022","128","6","134","2024-12-30"
"27660","2024","COM","2022","244","5","249","2024-12-30"
"27661","2024","COM","2022","416","5","421","2024-12-30"
"27662","2024","COM","2022","349","10","359","2024-12-30"
"27663","2024","COM","2022","170","4","174","2024-12-30"
"27664","2024","COM","2022","525","8","533","2024-12-30"
"27665","2024","COM","2022","754","13","767","2024-12-30"
"27666","2024","COM","2022","557","19","576","2024-12-30"
"27667","2024","COM","2022","409","11","420","2024-12-30"
"27668","2024","COM","2022","672","10","682","2024-12-30"
"27669","2024","COM","2022","411","9","420","2024-12-30"
"27670","2024","COM","2022","966","19","985","2024-12-30"
"27671","2024","COM","2022","163","0","163","2024-12-30"
"27672","2024","COM","2022","322","3","325","2024-12-30"
"27673","2024","COM","2022","177","4","181","2024-12-30"
"27674","2024","COM","2022","271","10","281","2024-12-30"
"27676","2024","COM","2022","1748","44","1792","2024-12-30"
"27677","2024","COM","2022","389","6","395","2024-12-30"
"27678","2024","COM","2022","1047","18","1065","2024-12-30"
"27679","2024","COM","2022","7262","342","7604","2024-12-30"
"27680","2024","COM","2022","180","5","185","2024-12-30"
"27681","2024","COM","2022","24841","576","25417","2024-12-30"
"27682","2024","COM","2022","621","15","636","2024-12-30"
"27683","2024","COM","2022","234","3","237","2024-12-30"
"27684","2024","COM","2022","840","12","852","2024-12-30"
"27685","2024","COM","2022","653","17","670","2024-12-30"
"27686","2024","COM","2022","50","0","50","2024-12-30"
"27689","2024","COM","2022","353","18","371","2024-12-30"
"27690","2024","COM","2022","313","7","320","2024-12-30"
"27691","2024","COM","2022","841","19","860","2024-12-30"
"27692","2024","COM","2022","169","7","176","2024-12-30"
"27693","2024","COM","2022","1280","44","1324","2024-12-30"
"27694","2024","COM","2022","318","15","333","2024-12-30"
"27695","2024","COM","2022","233","10","243","2024-12-30"
"27696","2024","COM","2022","859","20","879","2024-12-30"
"27697","2024","COM","2022","331","18","349","2024-12-30"
"27698","2024","COM","2022","559","10","569","2024-12-30"
"27699","2024","COM","2022","117","3","120","2024-12-30"
"27700","2024","COM","2022","725","14","739","2024-12-30"
"27701","2024","COM","2022","12939","318","13257","2024-12-30"
"28001","2024","COM","2022","2446","48","2494","2024-12-30"
"28003","2024","COM","2022","153","3","156","2024-12-30"
"28004","2024","COM","2022","319","3","322","2024-12-30"
"28005","2024","COM","2022","758","82","840","2024-12-30"
"28006","2024","COM","2022","1823","48","1871","2024-12-30"
"28007","2024","COM","2022","2708","117","2825","2024-12-30"
"28008","2024","COM","2022","210","4","214","2024-12-30"
"28009","2024","COM","2022","72","1","73","2024-12-30"
"28010","2024","COM","2022","318","8","326","2024-12-30"
"28012","2024","COM","2022","3608","53","3661","2024-12-30"
"28013","2024","COM","2022","1511","24","1535","2024-12-30"
"28014","2024","COM","2022","659","12","671","2024-12-30"
"28015","2024","COM","2022","6354","77","6431","2024-12-30"
"28016","2024","COM","2022","110","5","115","2024-12-30"
"28018","2024","COM","2022","1482","27","1509","2024-12-30"
"28019","2024","COM","2022","216","3","219","2024-12-30"
"28021","2024","COM","2022","1645","26","1671","2024-12-30"
"28022","2024","COM","2022","1190","33","1223","2024-12-30"
"28023","2024","COM","2022","1322","32","1354","2024-12-30"
"28024","2024","COM","2022","1755","44","1799","2024-12-30"
"28025","2024","COM","2022","94","2","96","2024-12-30"
"28026","2024","COM","2022","239","0","239","2024-12-30"
"28027","2024","COM","2022","1230","12","1242","2024-12-30"
"28028","2024","COM","2022","262","6","268","2024-12-30"
"28029","2024","COM","2022","328","6","334","2024-12-30"
"28030","2024","COM","2022","284","6","290","2024-12-30"
"28031","2024","COM","2022","430","73","503","2024-12-30"
"28032","2024","COM","2022","342","6","348","2024-12-30"
"28033","2024","COM","2022","811","32","843","2024-12-30"
"28034","2024","COM","2022","898","25","923","2024-12-30"
"28035","2024","COM","2022","1000","26","1026","2024-12-30"
"28036","2024","COM","2022","855","19","874","2024-12-30"
"28037","2024","COM","2022","345","4","349","2024-12-30"
"28038","2024","COM","2022","132","4","136","2024-12-30"
"28039","2024","COM","2022","1693","25","1718","2024-12-30"
"28040","2024","COM","2022","314","9","323","2024-12-30"
"28041","2024","COM","2022","282","4","286","2024-12-30"
"28045","2024","COM","2022","229","2","231","2024-12-30"
"28046","2024","COM","2022","495","8","503","2024-12-30"
"28047","2024","COM","2022","721","15","736","2024-12-30"
"28048","2024","COM","2022","751","13","764","2024-12-30"
"28049","2024","COM","2022","223","7","230","2024-12-30"
"28050","2024","COM","2022","283","6","289","2024-12-30"
"28051","2024","COM","2022","4890","98","4988","2024-12-30"
"28052","2024","COM","2022","737","15","752","2024-12-30"
"28053","2024","COM","2022","250","3","253","2024-12-30"
"28054","2024","COM","2022","529","10","539","2024-12-30"
"28055","2024","COM","2022","585","9","594","2024-12-30"
"28056","2024","COM","2022","1708","47","1755","2024-12-30"
"28057","2024","COM","2022","553","10","563","2024-12-30"
"28058","2024","COM","2022","365","7","372","2024-12-30"
"28059","2024","COM","2022","1796","25","1821","2024-12-30"
"28060","2024","COM","2022","268","4","272","2024-12-30"
"28061","2024","COM","2022","3245","37","3282","2024-12-30"
"28062","2024","COM","2022","859","15","874","2024-12-30"
"28064","2024","COM","2022","2093","52","2145","2024-12-30"
"28065","2024","COM","2022","111","2","113","2024-12-30"
"28067","2024","COM","2022","83","4","87","2024-12-30"
"28068","2024","COM","2022","432","13","445","2024-12-30"
"28070","2024","COM","2022","3674","117","3791","2024-12-30"
"28071","2024","COM","2022","733","2","735","2024-12-30"
"28072","2024","COM","2022","389","13","402","2024-12-30"
"28073","2024","COM","2022","347","6","353","2024-12-30"
"28074","2024","COM","2022","243","4","247","2024-12-30"
"28075","2024","COM","2022","1014","170","1184","2024-12-30"
"28076","2024","COM","2022","214","3","217","2024-12-30"
"28077","2024","COM","2022","169","4","173","2024-12-30"
"28078","2024","COM","2022","182","2","184","2024-12-30"
"28079","2024","COM","2022","321","3","324","2024-12-30"
"28080","2024","COM","2022","259","5","264","2024-12-30"
"28081","2024","COM","2022","298","4","302","2024-12-30"
"28082","2024","COM","2022","638","15","653","2024-12-30"
"28084","2024","COM","2022","665","22","687","2024-12-30"
"28085","2024","COM","2022","37990","964","38954","2024-12-30"
"28086","2024","COM","2022","304","8","312","2024-12-30"
"28087","2024","COM","2022","227","1","228","2024-12-30"
"28088","2024","COM","2022","12898","315","13213","2024-12-30"
"28089","2024","COM","2022","2632","44","2676","2024-12-30"
"28090","2024","COM","2022","111","3","114","2024-12-30"
"28091","2024","COM","2022","149","3","152","2024-12-30"
"28092","2024","COM","2022","236","4","240","2024-12-30"
"28094","2024","COM","2022","1689","26","1715","2024-12-30"
"28095","2024","COM","2022","290","5","295","2024-12-30"
"28096","2024","COM","2022","1307","14","1321","2024-12-30"
"28098","2024","COM","2022","1857","49","1906","2024-12-30"
"28099","2024","COM","2022","1123","24","1147","2024-12-30"
"28100","2024","COM","2022","470","11","481","2024-12-30"
"28102","2024","COM","2022","753","25","778","2024-12-30"
"28103","2024","COM","2022","5601","97","5698","2024-12-30"
"28104","2024","COM","2022","904","27","931","2024-12-30"
"28105","2024","COM","2022","553","5","558","2024-12-30"
"28106","2024","COM","2022","389","8","397","2024-12-30"
"28107","2024","COM","2022","361","5","366","2024-12-30"
"28108","2024","COM","2022","222","12","234","2024-12-30"
"28109","2024","COM","2022","327","5","332","2024-12-30"
"28110","2024","COM","2022","4063","138","4201","2024-12-30"
"28111","2024","COM","2022","364","13","377","2024-12-30"
"28113","2024","COM","2022","1371","32","1403","2024-12-30"
"28114","2024","COM","2022","137","2","139","2024-12-30"
"28116","2024","COM","2022","2802","64","2866","2024-12-30"
"28117","2024","COM","2022","263","6","269","2024-12-30"
"28118","2024","COM","2022","423","8","431","2024-12-30"
"28119","2024","COM","2022","148","1","149","2024-12-30"
"28120","2024","COM","2022","467","2","469","2024-12-30"
"28121","2024","COM","2022","99","0","99","2024-12-30"
"28122","2024","COM","2022","1500","36","1536","2024-12-30"
"28123","2024","COM","2022","445","5","450","2024-12-30"
"28124","2024","COM","2022","763","19","782","2024-12-30"
"28126","2024","COM","2022","204","4","208","2024-12-30"
"28127","2024","COM","2022","1260","25","1285","2024-12-30"
"28128","2024","COM","2022","433","16","449","2024-12-30"
"28129","2024","COM","2022","773","22","795","2024-12-30"
"28130","2024","COM","2022","1002","17","1019","2024-12-30"
"28132","2024","COM","2022","661","16","677","2024-12-30"
"28134","2024","COM","2022","31205","484","31689","2024-12-30"
"28135","2024","COM","2022","1204","29","1233","2024-12-30"
"28136","2024","COM","2022","159","1","160","2024-12-30"
"28137","2024","COM","2022","860","18","878","2024-12-30"
"28139","2024","COM","2022","169","1","170","2024-12-30"
"28140","2024","COM","2022","5509","65","5574","2024-12-30"
"28141","2024","COM","2022","315","9","324","2024-12-30"
"28142","2024","COM","2022","189","4","193","2024-12-30"
"28143","2024","COM","2022","234","4","238","2024-12-30"
"28144","2024","COM","2022","194","8","202","2024-12-30"
"28146","2024","COM","2022","818","9","827","2024-12-30"
"28147","2024","COM","2022","625","13","638","2024-12-30"
"28148","2024","COM","2022","365","6","371","2024-12-30"
"28149","2024","COM","2022","558","15","573","2024-12-30"
"28151","2024","COM","2022","172","2","174","2024-12-30"
"28153","2024","COM","2022","212","5","217","2024-12-30"
"28154","2024","COM","2022","1675","33","1708","2024-12-30"
"28155","2024","COM","2022","187","5","192","2024-12-30"
"28156","2024","COM","2022","887","8","895","2024-12-30"
"28157","2024","COM","2022","149","2","151","2024-12-30"
"28158","2024","COM","2022","1180","23","1203","2024-12-30"
"28159","2024","COM","2022","337","3","340","2024-12-30"
"28160","2024","COM","2022","930","11","941","2024-12-30"
"28161","2024","COM","2022","488","11","499","2024-12-30"
"28162","2024","COM","2022","286","5","291","2024-12-30"
"28163","2024","COM","2022","223","3","226","2024-12-30"
"28164","2024","COM","2022","741","11","752","2024-12-30"
"28166","2024","COM","2022","261","3","264","2024-12-30"
"28167","2024","COM","2022","378","7","385","2024-12-30"
"28168","2024","COM","2022","3537","65","3602","2024-12-30"
"28169","2024","COM","2022","222","7","229","2024-12-30"
"28170","2024","COM","2022","283","6","289","2024-12-30"
"28171","2024","COM","2022","1000","24","1024","2024-12-30"
"28172","2024","COM","2022","730","17","747","2024-12-30"
"28173","2024","COM","2022","1474","29","1503","2024-12-30"
"28175","2024","COM","2022","179","3","182","2024-12-30"
"28176","2024","COM","2022","674","16","690","2024-12-30"
"28177","2024","COM","2022","763","15","778","2024-12-30"
"28178","2024","COM","2022","345","6","351","2024-12-30"
"28180","2024","COM","2022","503","13","516","2024-12-30"
"28182","2024","COM","2022","319","2","321","2024-12-30"
"28183","2024","COM","2022","667","12","679","2024-12-30"
"28184","2024","COM","2022","337","5","342","2024-12-30"
"28185","2024","COM","2022","1340","22","1362","2024-12-30"
"28187","2024","COM","2022","684","10","694","2024-12-30"
"28188","2024","COM","2022","889","19","908","2024-12-30"
"28189","2024","COM","2022","163","4","167","2024-12-30"
"28190","2024","COM","2022","463","12","475","2024-12-30"
"28191","2024","COM","2022","2710","58","2768","2024-12-30"
"28192","2024","COM","2022","309","5","314","2024-12-30"
"28193","2024","COM","2022","131","4","135","2024-12-30"
"28194","2024","COM","2022","414","13","427","2024-12-30"
"28195","2024","COM","2022","750","12","762","2024-12-30"
"28196","2024","COM","2022","3228","50","3278","2024-12-30"
"28197","2024","COM","2022","121","1","122","2024-12-30"
"28198","2024","COM","2022","787","9","796","2024-12-30"
"28199","2024","COM","2022","2482","43","2525","2024-12-30"
"28200","2024","COM","2022","409","4","413","2024-12-30"
"28201","2024","COM","2022","1989","47","2036","2024-12-30"
"28202","2024","COM","2022","323","2","325","2024-12-30"
"28203","2024","COM","2022","631","8","639","2024-12-30"
"28206","2024","COM","2022","655","14","669","2024-12-30"
"28207","2024","COM","2022","240","3","243","2024-12-30"
"28208","2024","COM","2022","377","14","391","2024-12-30"
"28209","2024","COM","2022","5701","164","5865","2024-12-30"
"28210","2024","COM","2022","235","3","238","2024-12-30"
"28211","2024","COM","2022","587","6","593","2024-12-30"
"28212","2024","COM","2022","215","7","222","2024-12-30"
"28213","2024","COM","2022","683","13","696","2024-12-30"
"28214","2024","COM","2022","3230","64","3294","2024-12-30"
"28215","2024","COM","2022","247","3","250","2024-12-30"
"28216","2024","COM","2022","221","4","225","2024-12-30"
"28217","2024","COM","2022","198","3","201","2024-12-30"
"28218","2024","COM","2022","15658","190","15848","2024-12-30"
"28219","2024","COM","2022","423","7","430","2024-12-30"
"28220","2024","COM","2022","6818","283","7101","2024-12-30"
"28221","2024","COM","2022","137","3","140","2024-12-30"
"28222","2024","COM","2022","387","11","398","2024-12-30"
"28223","2024","COM","2022","1570","26","1596","2024-12-30"
"28225","2024","COM","2022","652","16","668","2024-12-30"
"28226","2024","COM","2022","926","17","943","2024-12-30"
"28227","2024","COM","2022","4532","82","4614","2024-12-30"
"28229","2024","COM","2022","10950","220","11170","2024-12-30"
"28230","2024","COM","2022","403","8","411","2024-12-30"
"28231","2024","COM","2022","152","4","156","2024-12-30"
"28232","2024","COM","2022","606","16","622","2024-12-30"
"28233","2024","COM","2022","1124","24","1148","2024-12-30"
"28234","2024","COM","2022","506","9","515","2024-12-30"
"28235","2024","COM","2022","408","8","416","2024-12-30"
"28236","2024","COM","2022","2209","39","2248","2024-12-30"
"28237","2024","COM","2022","207","5","212","2024-12-30"
"28239","2024","COM","2022","1027","26","1053","2024-12-30"
"28240","2024","COM","2022","499","9","508","2024-12-30"
"28242","2024","COM","2022","106","1","107","2024-12-30"
"28243","2024","COM","2022","215","6","221","2024-12-30"
"28245","2024","COM","2022","376","9","385","2024-12-30"
"28246","2024","COM","2022","516","14","530","2024-12-30"
"28247","2024","COM","2022","569","11","580","2024-12-30"
"28248","2024","COM","2022","337","5","342","2024-12-30"
"28249","2024","COM","2022","622","16","638","2024-12-30"
"28251","2024","COM","2022","1057","24","1081","2024-12-30"
"28252","2024","COM","2022","171","2","173","2024-12-30"
"28253","2024","COM","2022","1157","75","1232","2024-12-30"
"28254","2024","COM","2022","800","24","824","2024-12-30"
"28255","2024","COM","2022","160","2","162","2024-12-30"
"28256","2024","COM","2022","442","11","453","2024-12-30"
"28257","2024","COM","2022","93","4","97","2024-12-30"
"28259","2024","COM","2022","348","5","353","2024-12-30"
"28260","2024","COM","2022","103","1","104","2024-12-30"
"28261","2024","COM","2022","590","8","598","2024-12-30"
"28263","2024","COM","2022","272","6","278","2024-12-30"
"28264","2024","COM","2022","136","3","139","2024-12-30"
"28265","2024","COM","2022","254","2","256","2024-12-30"
"28267","2024","COM","2022","530","11","541","2024-12-30"
"28268","2024","COM","2022","17","0","17","2024-12-30"
"28269","2024","COM","2022","1927","60","1987","2024-12-30"
"28270","2024","COM","2022","223","4","227","2024-12-30"
"28271","2024","COM","2022","127","4","131","2024-12-30"
"28272","2024","COM","2022","152","3","155","2024-12-30"
"28273","2024","COM","2022","139","2","141","2024-12-30"
"28274","2024","COM","2022","243","7","250","2024-12-30"
"28275","2024","COM","2022","699","17","716","2024-12-30"
"28276","2024","COM","2022","218","8","226","2024-12-30"
"28277","2024","COM","2022","305","11","316","2024-12-30"
"28278","2024","COM","2022","1463","26","1489","2024-12-30"
"28279","2024","COM","2022","4023","70","4093","2024-12-30"
"28280","2024","COM","2022","9305","414","9719","2024-12-30"
"28281","2024","COM","2022","502","16","518","2024-12-30"
"28282","2024","COM","2022","431","10","441","2024-12-30"
"28283","2024","COM","2022","283","4","287","2024-12-30"
"28284","2024","COM","2022","277","6","283","2024-12-30"
"28285","2024","COM","2022","326","6","332","2024-12-30"
"28286","2024","COM","2022","626","13","639","2024-12-30"
"28287","2024","COM","2022","998","14","1012","2024-12-30"
"28289","2024","COM","2022","224","5","229","2024-12-30"
"28290","2024","COM","2022","282","9","291","2024-12-30"
"28291","2024","COM","2022","534","10","544","2024-12-30"
"28292","2024","COM","2022","785","16","801","2024-12-30"
"28293","2024","COM","2022","1221","28","1249","2024-12-30"
"28294","2024","COM","2022","526","13","539","2024-12-30"
"28296","2024","COM","2022","260","7","267","2024-12-30"
"28298","2024","COM","2022","2792","47","2839","2024-12-30"
"28299","2024","COM","2022","164","6","170","2024-12-30"
"28300","2024","COM","2022","173","6","179","2024-12-30"
"28301","2024","COM","2022","460","6","466","2024-12-30"
"28302","2024","COM","2022","1117","320","1437","2024-12-30"
"28303","2024","COM","2022","99","2","101","2024-12-30"
"28304","2024","COM","2022","449","7","456","2024-12-30"
"28305","2024","COM","2022","286","5","291","2024-12-30"
"28306","2024","COM","2022","176","2","178","2024-12-30"
"28308","2024","COM","2022","264","11","275","2024-12-30"
"28309","2024","COM","2022","1155","18","1173","2024-12-30"
"28310","2024","COM","2022","247","3","250","2024-12-30"
"28312","2024","COM","2022","133","0","133","2024-12-30"
"28313","2024","COM","2022","203","1","204","2024-12-30"
"28314","2024","COM","2022","153","4","157","2024-12-30"
"28315","2024","COM","2022","25","1","26","2024-12-30"
"28316","2024","COM","2022","131","3","134","2024-12-30"
"28317","2024","COM","2022","582","9","591","2024-12-30"
"28319","2024","COM","2022","345","10","355","2024-12-30"
"28321","2024","COM","2022","818","19","837","2024-12-30"
"28322","2024","COM","2022","469","9","478","2024-12-30"
"28323","2024","COM","2022","284","3","287","2024-12-30"
"28324","2024","COM","2022","895","25","920","2024-12-30"
"28325","2024","COM","2022","1127","19","1146","2024-12-30"
"28326","2024","COM","2022","347","9","356","2024-12-30"
"28327","2024","COM","2022","194","2","196","2024-12-30"
"28329","2024","COM","2022","148","0","148","2024-12-30"
"28330","2024","COM","2022","1300","33","1333","2024-12-30"
"28331","2024","COM","2022","934","24","958","2024-12-30"
"28332","2024","COM","2022","1158","22","1180","2024-12-30"
"28333","2024","COM","2022","150","7","157","2024-12-30"
"28334","2024","COM","2022","2095","52","2147","2024-12-30"
"28335","2024","COM","2022","833","13","846","2024-12-30"
"28336","2024","COM","2022","94","0","94","2024-12-30"
"28337","2024","COM","2022","2728","61","2789","2024-12-30"
"28339","2024","COM","2022","372","13","385","2024-12-30"
"28341","2024","COM","2022","243","9","252","2024-12-30"
"28342","2024","COM","2022","269","6","275","2024-12-30"
"28343","2024","COM","2022","463","5","468","2024-12-30"
"28344","2024","COM","2022","257","11","268","2024-12-30"
"28346","2024","COM","2022","55","0","55","2024-12-30"
"28347","2024","COM","2022","950","31","981","2024-12-30"
"28348","2024","COM","2022","4129","70","4199","2024-12-30"
"28349","2024","COM","2022","278","9","287","2024-12-30"
"28350","2024","COM","2022","994","23","1017","2024-12-30"
"28351","2024","COM","2022","410","10","420","2024-12-30"
"28352","2024","COM","2022","1581","46","1627","2024-12-30"
"28353","2024","COM","2022","405","5","410","2024-12-30"
"28354","2024","COM","2022","484","154","638","2024-12-30"
"28355","2024","COM","2022","293","6","299","2024-12-30"
"28357","2024","COM","2022","1121","31","1152","2024-12-30"
"28358","2024","COM","2022","2119","66","2185","2024-12-30"
"28359","2024","COM","2022","4065","48","4113","2024-12-30"
"28360","2024","COM","2022","927","20","947","2024-12-30"
"28362","2024","COM","2022","509","3","512","2024-12-30"
"28363","2024","COM","2022","1037","14","1051","2024-12-30"
"28364","2024","COM","2022","748","13","761","2024-12-30"
"28365","2024","COM","2022","419","6","425","2024-12-30"
"28366","2024","COM","2022","324","5","329","2024-12-30"
"28367","2024","COM","2022","306","0","306","2024-12-30"
"28368","2024","COM","2022","201","8","209","2024-12-30"
"28369","2024","COM","2022","772","13","785","2024-12-30"
"28370","2024","COM","2022","467","12","479","2024-12-30"
"28371","2024","COM","2022","1090","21","1111","2024-12-30"
"28372","2024","COM","2022","537","11","548","2024-12-30"
"28373","2024","COM","2022","3013","42","3055","2024-12-30"
"28374","2024","COM","2022","538","11","549","2024-12-30"
"28375","2024","COM","2022","362","10","372","2024-12-30"
"28377","2024","COM","2022","1782","45","1827","2024-12-30"
"28378","2024","COM","2022","496","17","513","2024-12-30"
"28379","2024","COM","2022","474","9","483","2024-12-30"
"28380","2024","COM","2022","1964","92","2056","2024-12-30"
"28382","2024","COM","2022","881","12","893","2024-12-30"
"28383","2024","COM","2022","728","7","735","2024-12-30"
"28385","2024","COM","2022","427","2","429","2024-12-30"
"28386","2024","COM","2022","1240","28","1268","2024-12-30"
"28387","2024","COM","2022","972","13","985","2024-12-30"
"28388","2024","COM","2022","1099","34","1133","2024-12-30"
"28389","2024","COM","2022","337","8","345","2024-12-30"
"28390","2024","COM","2022","313","10","323","2024-12-30"
"28391","2024","COM","2022","2620","29","2649","2024-12-30"
"28392","2024","COM","2022","169","2","171","2024-12-30"
"28393","2024","COM","2022","2208","65","2273","2024-12-30"
"28394","2024","COM","2022","1448","28","1476","2024-12-30"
"28395","2024","COM","2022","438","14","452","2024-12-30"
"28396","2024","COM","2022","318","2","320","2024-12-30"
"28397","2024","COM","2022","403","14","417","2024-12-30"
"28398","2024","COM","2022","1212","23","1235","2024-12-30"
"28400","2024","COM","2022","189","2","191","2024-12-30"
"28401","2024","COM","2022","461","11","472","2024-12-30"
"28403","2024","COM","2022","776","21","797","2024-12-30"
"28404","2024","COM","2022","12491","193","12684","2024-12-30"
"28405","2024","COM","2022","1119","23","1142","2024-12-30"
"28406","2024","COM","2022","1240","25","1265","2024-12-30"
"28407","2024","COM","2022","288","10","298","2024-12-30"
"28408","2024","COM","2022","110","3","113","2024-12-30"
"28409","2024","COM","2022","445","14","459","2024-12-30"
"28410","2024","COM","2022","298","1","299","2024-12-30"
"28411","2024","COM","2022","180","2","182","2024-12-30"
"28414","2024","COM","2022","56","5","61","2024-12-30"
"28415","2024","COM","2022","1808","36","1844","2024-12-30"
"28417","2024","COM","2022","1359","35","1394","2024-12-30"
"28418","2024","COM","2022","162","4","166","2024-12-30"
"28419","2024","COM","2022","353","8","361","2024-12-30"
"28421","2024","COM","2022","251","3","254","2024-12-30"
"28422","2024","COM","2022","3977","49","4026","2024-12-30"
"28423","2024","COM","2022","624","18","642","2024-12-30"
"28424","2024","COM","2022","1673","28","1701","2024-12-30"
"28425","2024","COM","2022","574","11","585","2024-12-30"
"28426","2024","COM","2022","481","11","492","2024-12-30"
"29001","2024","COM","2022","1043","20","1063","2024-12-30"
"29002","2024","COM","2022","1440","30","1470","2024-12-30"
"29003","2024","COM","2022","3708","55","3763","2024-12-30"
"29004","2024","COM","2022","5707","156","5863","2024-12-30"
"29005","2024","COM","2022","1363","35","1398","2024-12-30"
"29006","2024","COM","2022","3878","79","3957","2024-12-30"
"29007","2024","COM","2022","920","14","934","2024-12-30"
"29008","2024","COM","2022","1018","26","1044","2024-12-30"
"29010","2024","COM","2022","1700","34","1734","2024-12-30"
"29011","2024","COM","2022","3671","65","3736","2024-12-30"
"29012","2024","COM","2022","172","2","174","2024-12-30"
"29013","2024","COM","2022","227","3","230","2024-12-30"
"29014","2024","COM","2022","428","9","437","2024-12-30"
"29015","2024","COM","2022","3544","64","3608","2024-12-30"
"29016","2024","COM","2022","1055","16","1071","2024-12-30"
"29017","2024","COM","2022","867","27","894","2024-12-30"
"29018","2024","COM","2022","447","6","453","2024-12-30"
"29019","2024","COM","2022","140993","2537","143530","2024-12-30"
"29020","2024","COM","2022","5815","126","5941","2024-12-30"
"29021","2024","COM","2022","1955","53","2008","2024-12-30"
"29022","2024","COM","2022","2448","47","2495","2024-12-30"
"29023","2024","COM","2022","3261","99","3360","2024-12-30"
"29024","2024","COM","2022","7326","499","7825","2024-12-30"
"29025","2024","COM","2022","1557","44","1601","2024-12-30"
"29026","2024","COM","2022","5106","419","5525","2024-12-30"
"29027","2024","COM","2022","3646","85","3731","2024-12-30"
"29028","2024","COM","2022","912","20","932","2024-12-30"
"29029","2024","COM","2022","1135","19","1154","2024-12-30"
"29030","2024","COM","2022","3582","111","3693","2024-12-30"
"29031","2024","COM","2022","4701","119","4820","2024-12-30"
"29032","2024","COM","2022","2152","51","2203","2024-12-30"
"29033","2024","COM","2022","508","6","514","2024-12-30"
"29034","2024","COM","2022","644","12","656","2024-12-30"
"29035","2024","COM","2022","1135","17","1152","2024-12-30"
"29036","2024","COM","2022","592","9","601","2024-12-30"
"29037","2024","COM","2022","4271","130","4401","2024-12-30"
"29038","2024","COM","2022","994","22","1016","2024-12-30"
"29039","2024","COM","2022","20632","806","21438","2024-12-30"
"29040","2024","COM","2022","2814","78","2892","2024-12-30"
"29041","2024","COM","2022","1869","36","1905","2024-12-30"
"29042","2024","COM","2022","7410","170","7580","2024-12-30"
"29043","2024","COM","2022","1835","45","1880","2024-12-30"
"29044","2024","COM","2022","1858","37","1895","2024-12-30"
"29045","2024","COM","2022","2195","58","2253","2024-12-30"
"29046","2024","COM","2022","14188","407","14595","2024-12-30"
"29047","2024","COM","2022","1911","33","1944","2024-12-30"
"29048","2024","COM","2022","2199","57","2256","2024-12-30"
"29049","2024","COM","2022","3379","124","3503","2024-12-30"
"29051","2024","COM","2022","8576","197","8773","2024-12-30"
"29053","2024","COM","2022","1882","58","1940","2024-12-30"
"29054","2024","COM","2022","684","10","694","2024-12-30"
"29055","2024","COM","2022","3290","68","3358","2024-12-30"
"29056","2024","COM","2022","1999","53","2052","2024-12-30"
"29057","2024","COM","2022","3485","85","3570","2024-12-30"
"29058","2024","COM","2022","10204","506","10710","2024-12-30"
"29059","2024","COM","2022","1063","32","1095","2024-12-30"
"29060","2024","COM","2022","2765","80","2845","2024-12-30"
"29061","2024","COM","2022","6412","116","6528","2024-12-30"
"29062","2024","COM","2022","1115","25","1140","2024-12-30"
"29063","2024","COM","2022","440","8","448","2024-12-30"
"29064","2024","COM","2022","439","9","448","2024-12-30"
"29065","2024","COM","2022","950","12","962","2024-12-30"
"29066","2024","COM","2022","1836","28","1864","2024-12-30"
"29067","2024","COM","2022","1259","39","1298","2024-12-30"
"29068","2024","COM","2022","2564","41","2605","2024-12-30"
"29069","2024","COM","2022","8221","152","8373","2024-12-30"
"29070","2024","COM","2022","521","11","532","2024-12-30"
"29071","2024","COM","2022","804","16","820","2024-12-30"
"29072","2024","COM","2022","2677","48","2725","2024-12-30"
"29073","2024","COM","2022","966","26","992","2024-12-30"
"29074","2024","COM","2022","1000","19","1019","2024-12-30"
"29075","2024","COM","2022","15401","328","15729","2024-12-30"
"29076","2024","COM","2022","4733","67","4800","2024-12-30"
"29077","2024","COM","2022","1974","51","2025","2024-12-30"
"29078","2024","COM","2022","2035","43","2078","2024-12-30"
"29079","2024","COM","2022","1195","41","1236","2024-12-30"
"29080","2024","COM","2022","2220","69","2289","2024-12-30"
"29081","2024","COM","2022","1420","18","1438","2024-12-30"
"29082","2024","COM","2022","457","13","470","2024-12-30"
"29083","2024","COM","2022","280","2","282","2024-12-30"
"29084","2024","COM","2022","166","6","172","2024-12-30"
"29085","2024","COM","2022","745","19","764","2024-12-30"
"29086","2024","COM","2022","1427","30","1457","2024-12-30"
"29087","2024","COM","2022","753","22","775","2024-12-30"
"29089","2024","COM","2022","878","18","896","2024-12-30"
"29090","2024","COM","2022","798","24","822","2024-12-30"
"29091","2024","COM","2022","2028","35","2063","2024-12-30"
"29093","2024","COM","2022","1418","26","1444","2024-12-30"
"29094","2024","COM","2022","660","22","682","2024-12-30"
"29095","2024","COM","2022","1537","31","1568","2024-12-30"
"29097","2024","COM","2022","2004","49","2053","2024-12-30"
"29098","2024","COM","2022","2176","51","2227","2024-12-30"
"29099","2024","COM","2022","815","21","836","2024-12-30"
"29100","2024","COM","2022","406","12","418","2024-12-30"
"29101","2024","COM","2022","3695","97","3792","2024-12-30"
"29102","2024","COM","2022","982","12","994","2024-12-30"
"29103","2024","COM","2022","16327","609","16936","2024-12-30"
"29104","2024","COM","2022","335","7","342","2024-12-30"
"29105","2024","COM","2022","9197","317","9514","2024-12-30"
"29106","2024","COM","2022","1874","42","1916","2024-12-30"
"29107","2024","COM","2022","910","15","925","2024-12-30"
"29108","2024","COM","2022","1477","24","1501","2024-12-30"
"29109","2024","COM","2022","1548","32","1580","2024-12-30"
"29110","2024","COM","2022","839","14","853","2024-12-30"
"29111","2024","COM","2022","1294","32","1326","2024-12-30"
"29112","2024","COM","2022","987","24","1011","2024-12-30"
"29113","2024","COM","2022","2367","38","2405","2024-12-30"
"29114","2024","COM","2022","341","7","348","2024-12-30"
"29115","2024","COM","2022","321","8","329","2024-12-30"
"29116","2024","COM","2022","150","2","152","2024-12-30"
"29117","2024","COM","2022","5712","137","5849","2024-12-30"
"29119","2024","COM","2022","1539","17","1556","2024-12-30"
"29120","2024","COM","2022","1951","59","2010","2024-12-30"
"29122","2024","COM","2022","684","16","700","2024-12-30"
"29123","2024","COM","2022","801","21","822","2024-12-30"
"29124","2024","COM","2022","7471","207","7678","2024-12-30"
"29125","2024","COM","2022","836","11","847","2024-12-30"
"29126","2024","COM","2022","210","6","216","2024-12-30"
"29128","2024","COM","2022","378","5","383","2024-12-30"
"29130","2024","COM","2022","5160","130","5290","2024-12-30"
"29131","2024","COM","2022","476","12","488","2024-12-30"
"29132","2024","COM","2022","792","31","823","2024-12-30"
"29133","2024","COM","2022","1543","55","1598","2024-12-30"
"29134","2024","COM","2022","806","15","821","2024-12-30"
"29135","2024","COM","2022","4043","108","4151","2024-12-30"
"29136","2024","COM","2022","1166","27","1193","2024-12-30"
"29137","2024","COM","2022","2127","54","2181","2024-12-30"
"29139","2024","COM","2022","832","205","1037","2024-12-30"
"29140","2024","COM","2022","3952","95","4047","2024-12-30"
"29141","2024","COM","2022","338","5","343","2024-12-30"
"29142","2024","COM","2022","444","12","456","2024-12-30"
"29143","2024","COM","2022","1010","21","1031","2024-12-30"
"29144","2024","COM","2022","756","22","778","2024-12-30"
"29145","2024","COM","2022","860","27","887","2024-12-30"
"29146","2024","COM","2022","3388","68","3456","2024-12-30"
"29147","2024","COM","2022","3371","96","3467","2024-12-30"
"29148","2024","COM","2022","935","31","966","2024-12-30"
"29150","2024","COM","2022","6763","165","6928","2024-12-30"
"29151","2024","COM","2022","15220","479","15699","2024-12-30"
"29152","2024","COM","2022","679","15","694","2024-12-30"
"29153","2024","COM","2022","2721","58","2779","2024-12-30"
"29155","2024","COM","2022","854","13","867","2024-12-30"
"29156","2024","COM","2022","2229","49","2278","2024-12-30"
"29158","2024","COM","2022","5320","104","5424","2024-12-30"
"29159","2024","COM","2022","903","16","919","2024-12-30"
"29160","2024","COM","2022","8633","182","8815","2024-12-30"
"29161","2024","COM","2022","3298","88","3386","2024-12-30"
"29162","2024","COM","2022","3649","264","3913","2024-12-30"
"29163","2024","COM","2022","3175","71","3246","2024-12-30"
"29165","2024","COM","2022","3694","78","3772","2024-12-30"
"29166","2024","COM","2022","534","15","549","2024-12-30"
"29167","2024","COM","2022","2016","52","2068","2024-12-30"
"29168","2024","COM","2022","1166","17","1183","2024-12-30"
"29169","2024","COM","2022","3223","76","3299","2024-12-30"
"29170","2024","COM","2022","4216","165","4381","2024-12-30"
"29171","2024","COM","2022","3877","79","3956","2024-12-30"
"29172","2024","COM","2022","2254","66","2320","2024-12-30"
"29173","2024","COM","2022","2405","60","2465","2024-12-30"
"29174","2024","COM","2022","6403","191","6594","2024-12-30"
"29175","2024","COM","2022","2174","46","2220","2024-12-30"
"29176","2024","COM","2022","1783","32","1815","2024-12-30"
"29177","2024","COM","2022","3987","95","4082","2024-12-30"
"29178","2024","COM","2022","6440","134","6574","2024-12-30"
"29179","2024","COM","2022","3738","128","3866","2024-12-30"
"29180","2024","COM","2022","879","24","903","2024-12-30"
"29181","2024","COM","2022","3062","74","3136","2024-12-30"
"29182","2024","COM","2022","1058","23","1081","2024-12-30"
"29183","2024","COM","2022","720","14","734","2024-12-30"
"29184","2024","COM","2022","2588","51","2639","2024-12-30"
"29185","2024","COM","2022","3549","95","3644","2024-12-30"
"29186","2024","COM","2022","1640","60","1700","2024-12-30"
"29187","2024","COM","2022","790","25","815","2024-12-30"
"29188","2024","COM","2022","3035","109","3144","2024-12-30"
"29189","2024","COM","2022","13431","349","13780","2024-12-30"
"29190","2024","COM","2022","4520","103","4623","2024-12-30"
"29191","2024","COM","2022","3398","94","3492","2024-12-30"
"29192","2024","COM","2022","1761","37","1798","2024-12-30"
"29193","2024","COM","2022","1486","30","1516","2024-12-30"
"29195","2024","COM","2022","6719","141","6860","2024-12-30"
"29196","2024","COM","2022","2236","40","2276","2024-12-30"
"29197","2024","COM","2022","3923","67","3990","2024-12-30"
"29198","2024","COM","2022","1801","44","1845","2024-12-30"
"29199","2024","COM","2022","5039","184","5223","2024-12-30"
"29201","2024","COM","2022","2097","33","2130","2024-12-30"
"29202","2024","COM","2022","1298","33","1331","2024-12-30"
"29204","2024","COM","2022","2212","45","2257","2024-12-30"
"29205","2024","COM","2022","1153","24","1177","2024-12-30"
"29206","2024","COM","2022","2285","72","2357","2024-12-30"
"29207","2024","COM","2022","4529","252","4781","2024-12-30"
"29208","2024","COM","2022","1263","30","1293","2024-12-30"
"29209","2024","COM","2022","3930","76","4006","2024-12-30"
"29210","2024","COM","2022","2932","71","3003","2024-12-30"
"29211","2024","COM","2022","669","12","681","2024-12-30"
"29212","2024","COM","2022","13437","270","13707","2024-12-30"
"29213","2024","COM","2022","1856","37","1893","2024-12-30"
"29214","2024","COM","2022","682","19","701","2024-12-30"
"29215","2024","COM","2022","2963","75","3038","2024-12-30"
"29216","2024","COM","2022","4229","109","4338","2024-12-30"
"29217","2024","COM","2022","2796","58","2854","2024-12-30"
"29218","2024","COM","2022","1635","23","1658","2024-12-30"
"29220","2024","COM","2022","8403","393","8796","2024-12-30"
"29221","2024","COM","2022","1761","49","1810","2024-12-30"
"29222","2024","COM","2022","396","7","403","2024-12-30"
"29224","2024","COM","2022","1213","27","1240","2024-12-30"
"29225","2024","COM","2022","2128","42","2170","2024-12-30"
"29226","2024","COM","2022","1460","58","1518","2024-12-30"
"29227","2024","COM","2022","1466","33","1499","2024-12-30"
"29228","2024","COM","2022","641","15","656","2024-12-30"
"29229","2024","COM","2022","1116","34","1150","2024-12-30"
"29230","2024","COM","2022","1654","33","1687","2024-12-30"
"29232","2024","COM","2022","64530","2195","66725","2024-12-30"
"29233","2024","COM","2022","12444","478","12922","2024-12-30"
"29234","2024","COM","2022","2999","71","3070","2024-12-30"
"29235","2024","COM","2022","11837","224","12061","2024-12-30"
"29236","2024","COM","2022","4374","91","4465","2024-12-30"
"29237","2024","COM","2022","1865","33","1898","2024-12-30"
"29238","2024","COM","2022","825","27","852","2024-12-30"
"29239","2024","COM","2022","3318","81","3399","2024-12-30"
"29240","2024","COM","2022","993","24","1017","2024-12-30"
"29241","2024","COM","2022","7580","165","7745","2024-12-30"
"29243","2024","COM","2022","471","15","486","2024-12-30"
"29244","2024","COM","2022","846","14","860","2024-12-30"
"29245","2024","COM","2022","1602","21","1623","2024-12-30"
"29246","2024","COM","2022","221","4","225","2024-12-30"
"29247","2024","COM","2022","3491","114","3605","2024-12-30"
"29248","2024","COM","2022","870","7","877","2024-12-30"
"29249","2024","COM","2022","730","12","742","2024-12-30"
"29250","2024","COM","2022","735","17","752","2024-12-30"
"29251","2024","COM","2022","683","12","695","2024-12-30"
"29252","2024","COM","2022","973","21","994","2024-12-30"
"29254","2024","COM","2022","4792","119","4911","2024-12-30"
"29255","2024","COM","2022","941","20","961","2024-12-30"
"29256","2024","COM","2022","756","20","776","2024-12-30"
"29257","2024","COM","2022","2078","57","2135","2024-12-30"
"29259","2024","COM","2022","6841","213","7054","2024-12-30"
"29260","2024","COM","2022","8454","200","8654","2024-12-30"
"29261","2024","COM","2022","220","3","223","2024-12-30"
"29262","2024","COM","2022","827","17","844","2024-12-30"
"29263","2024","COM","2022","1183","19","1202","2024-12-30"
"29264","2024","COM","2022","789","14","803","2024-12-30"
"29265","2024","COM","2022","1060","31","1091","2024-12-30"
"29266","2024","COM","2022","3118","67","3185","2024-12-30"
"29267","2024","COM","2022","709","8","717","2024-12-30"
"29268","2024","COM","2022","1943","34","1977","2024-12-30"
"29269","2024","COM","2022","1005","13","1018","2024-12-30"
"29270","2024","COM","2022","1669","35","1704","2024-12-30"
"29271","2024","COM","2022","879","26","905","2024-12-30"
"29272","2024","COM","2022","3418","70","3488","2024-12-30"
"29273","2024","COM","2022","2435","80","2515","2024-12-30"
"29274","2024","COM","2022","5197","109","5306","2024-12-30"
"29275","2024","COM","2022","781","13","794","2024-12-30"
"29276","2024","COM","2022","1154","31","1185","2024-12-30"
"29277","2024","COM","2022","2334","82","2416","2024-12-30"
"29278","2024","COM","2022","1743","44","1787","2024-12-30"
"29279","2024","COM","2022","2883","71","2954","2024-12-30"
"29280","2024","COM","2022","2145","59","2204","2024-12-30"
"29281","2024","COM","2022","1004","28","1032","2024-12-30"
"29282","2024","COM","2022","365","9","374","2024-12-30"
"29284","2024","COM","2022","2438","98","2536","2024-12-30"
"29285","2024","COM","2022","523","7","530","2024-12-30"
"29286","2024","COM","2022","247","9","256","2024-12-30"
"29287","2024","COM","2022","984","14","998","2024-12-30"
"29288","2024","COM","2022","628","16","644","2024-12-30"
"29289","2024","COM","2022","127","4","131","2024-12-30"
"29290","2024","COM","2022","689","16","705","2024-12-30"
"29291","2024","COM","2022","952","10","962","2024-12-30"
"29292","2024","COM","2022","312","11","323","2024-12-30"
"29293","2024","COM","2022","7094","224","7318","2024-12-30"
"29294","2024","COM","2022","636","13","649","2024-12-30"
"29295","2024","COM","2022","492","20","512","2024-12-30"
"29296","2024","COM","2022","1506","44","1550","2024-12-30"
"29297","2024","COM","2022","2378","63","2441","2024-12-30"
"29298","2024","COM","2022","579","11","590","2024-12-30"
"29299","2024","COM","2022","325","3","328","2024-12-30"
"29300","2024","COM","2022","1611","52","1663","2024-12-30"
"29301","2024","COM","2022","403","9","412","2024-12-30"
"29302","2024","COM","2022","3571","138","3709","2024-12-30"
"2A001","2024","COM","2022","3350","61","3411","2024-12-30"
"2A004","2024","COM","2022","75343","821","76164","2024-12-30"
"2A006","2024","COM","2022","3645","73","3718","2024-12-30"
"2A008","2024","COM","2022","1780","26","1806","2024-12-30"
"2A011","2024","COM","2022","54","0","54","2024-12-30"
"2A014","2024","COM","2022","79","0","79","2024-12-30"
"2A017","2024","COM","2022","1751","38","1789","2024-12-30"
"2A018","2024","COM","2022","153","3","156","2024-12-30"
"2A019","2024","COM","2022","51","0","51","2024-12-30"
"2A021","2024","COM","2022","75","1","76","2024-12-30"
"2A022","2024","COM","2022","80","0","80","2024-12-30"
"2A024","2024","COM","2022","183","1","184","2024-12-30"
"2A026","2024","COM","2022","203","4","207","2024-12-30"
"2A027","2024","COM","2022","50","0","50","2024-12-30"
"2A028","2024","COM","2022","141","4","145","2024-12-30"
"2A031","2024","COM","2022","517","8","525","2024-12-30"
"2A032","2024","COM","2022","4258","110","4368","2024-12-30"
"2A035","2024","COM","2022","195","2","197","2024-12-30"
"2A038","2024","COM","2022","53","1","54","2024-12-30"
"2A040","2024","COM","2022","393","4","397","2024-12-30"
"2A041","2024","COM","2022","3269","60","3329","2024-12-30"
"2A048","2024","COM","2022","517","4","521","2024-12-30"
"2A056","2024","COM","2022","103","2","105","2024-12-30"
"2A060","2024","COM","2022","72","0","72","2024-12-30"
"2A061","2024","COM","2022","117","2","119","2024-12-30"
"2A062","2024","COM","2022","380","7","387","2024-12-30"
"2A064","2024","COM","2022","29","0","29","2024-12-30"
"2A065","2024","COM","2022","1193","20","1213","2024-12-30"
"2A066","2024","COM","2022","62","0","62","2024-12-30"
"2A070","2024","COM","2022","509","3","512","2024-12-30"
"2A071","2024","COM","2022","229","4","233","2024-12-30"
"2A085","2024","COM","2022","1483","25","1508","2024-12-30"
"2A089","2024","COM","2022","130","0","130","2024-12-30"
"2A090","2024","COM","2022","808","14","822","2024-12-30"
"2A091","2024","COM","2022","174","3","177","2024-12-30"
"2A092","2024","COM","2022","1167","19","1186","2024-12-30"
"2A094","2024","COM","2022","76","1","77","2024-12-30"
"2A098","2024","COM","2022","731","12","743","2024-12-30"
"2A099","2024","COM","2022","281","1","282","2024-12-30"
"2A100","2024","COM","2022","72","0","72","2024-12-30"
"2A103","2024","COM","2022","2044","28","2072","2024-12-30"
"2A104","2024","COM","2022","1369","37","1406","2024-12-30"
"2A108","2024","COM","2022","225","4","229","2024-12-30"
"2A114","2024","COM","2022","1742","33","1775","2024-12-30"
"2A115","2024","COM","2022","152","2","154","2024-12-30"
"2A117","2024","COM","2022","90","3","93","2024-12-30"
"2A118","2024","COM","2022","207","2","209","2024-12-30"
"2A119","2024","COM","2022","142","1","143","2024-12-30"
"2A127","2024","COM","2022","101","4","105","2024-12-30"
"2A128","2024","COM","2022","92","2","94","2024-12-30"
"2A129","2024","COM","2022","73","1","74","2024-12-30"
"2A130","2024","COM","2022","3331","51","3382","2024-12-30"
"2A131","2024","COM","2022","149","2","151","2024-12-30"
"2A132","2024","COM","2022","148","0","148","2024-12-30"
"2A133","2024","COM","2022","157","3","160","2024-12-30"
"2A139","2024","COM","2022","2020","31","2051","2024-12-30"
"2A141","2024","COM","2022","120","1","121","2024-12-30"
"2A142","2024","COM","2022","674","8","682","2024-12-30"
"2A144","2024","COM","2022","109","4","113","2024-12-30"
"2A146","2024","COM","2022","49","4","53","2024-12-30"
"2A154","2024","COM","2022","102","4","106","2024-12-30"
"2A158","2024","COM","2022","34","0","34","2024-12-30"
"2A160","2024","COM","2022","234","2","236","2024-12-30"
"2A163","2024","COM","2022","546","14","560","2024-12-30"
"2A174","2024","COM","2022","99","2","101","2024-12-30"
"2A181","2024","COM","2022","643","10","653","2024-12-30"
"2A186","2024","COM","2022","220","1","221","2024-12-30"
"2A189","2024","COM","2022","1265","26","1291","2024-12-30"
"2A191","2024","COM","2022","116","4","120","2024-12-30"
"2A196","2024","COM","2022","71","0","71","2024-12-30"
"2A197","2024","COM","2022","95","0","95","2024-12-30"
"2A198","2024","COM","2022","471","8","479","2024-12-30"
"2A200","2024","COM","2022","133","2","135","2024-12-30"
"2A203","2024","COM","2022","96","1","97","2024-12-30"
"2A204","2024","COM","2022","92","0","92","2024-12-30"
"2A209","2024","COM","2022","2042","45","2087","2024-12-30"
"2A211","2024","COM","2022","570","16","586","2024-12-30"
"2A212","2024","COM","2022","458","10","468","2024-12-30"
"2A215","2024","COM","2022","800","16","816","2024-12-30"
"2A228","2024","COM","2022","2042","20","2062","2024-12-30"
"2A232","2024","COM","2022","274","7","281","2024-12-30"
"2A240","2024","COM","2022","107","0","107","2024-12-30"
"2A247","2024","COM","2022","11536","173","11709","2024-12-30"
"2A249","2024","COM","2022","3864","34","3898","2024-12-30"
"2A253","2024","COM","2022","61","3","64","2024-12-30"
"2A254","2024","COM","2022","185","3","188","2024-12-30"
"2A258","2024","COM","2022","63","2","65","2024-12-30"
"2A259","2024","COM","2022","70","0","70","2024-12-30"
"2A262","2024","COM","2022","52","0","52","2024-12-30"
"2A266","2024","COM","2022","88","4","92","2024-12-30"
"2A268","2024","COM","2022","87","1","88","2024-12-30"
"2A269","2024","COM","2022","1447","21","1468","2024-12-30"
"2A270","2024","COM","2022","351","3","354","2024-12-30"
"2A271","2024","COM","2022","3250","50","3300","2024-12-30"
"2A272","2024","COM","2022","3732","84","3816","2024-12-30"
"2A276","2024","COM","2022","709","12","721","2024-12-30"
"2A278","2024","COM","2022","117","2","119","2024-12-30"
"2A279","2024","COM","2022","115","0","115","2024-12-30"
"2A282","2024","COM","2022","162","2","164","2024-12-30"
"2A284","2024","COM","2022","383","7","390","2024-12-30"
"2A285","2024","COM","2022","65","0","65","2024-12-30"
"2A288","2024","COM","2022","1866","27","1893","2024-12-30"
"2A295","2024","COM","2022","141","4","145","2024-12-30"
"2A300","2024","COM","2022","1162","24","1186","2024-12-30"
"2A308","2024","COM","2022","382","6","388","2024-12-30"
"2A310","2024","COM","2022","83","0","83","2024-12-30"
"2A312","2024","COM","2022","371","9","380","2024-12-30"
"2A322","2024","COM","2022","88","0","88","2024-12-30"
"2A323","2024","COM","2022","406","7","413","2024-12-30"
"2A324","2024","COM","2022","433","4","437","2024-12-30"
"2A326","2024","COM","2022","121","2","123","2024-12-30"
"2A330","2024","COM","2022","503","7","510","2024-12-30"
"2A331","2024","COM","2022","63","0","63","2024-12-30"
"2A336","2024","COM","2022","538","8","546","2024-12-30"
"2A345","2024","COM","2022","629","14","643","2024-12-30"
"2A348","2024","COM","2022","1007","16","1023","2024-12-30"
"2A349","2024","COM","2022","890","8","898","2024-12-30"
"2A351","2024","COM","2022","397","5","402","2024-12-30"
"2A357","2024","COM","2022","46","3","49","2024-12-30"
"2A358","2024","COM","2022","51","1","52","2024-12-30"
"2A359","2024","COM","2022","208","2","210","2024-12-30"
"2A360","2024","COM","2022","128","5","133","2024-12-30"
"2A362","2024","COM","2022","2869","35","2904","2024-12-30"
"2A363","2024","COM","2022","66","0","66","2024-12-30"
"2B002","2024","COM","2022","246","3","249","2024-12-30"
"2B003","2024","COM","2022","29","0","29","2024-12-30"
"2B005","2024","COM","2022","25","2","27","2024-12-30"
"2B007","2024","COM","2022","199","5","204","2024-12-30"
"2B009","2024","COM","2022","2239","30","2269","2024-12-30"
"2B010","2024","COM","2022","368","8","376","2024-12-30"
"2B012","2024","COM","2022","54","1","55","2024-12-30"
"2B013","2024","COM","2022","27","0","27","2024-12-30"
"2B015","2024","COM","2022","23","0","23","2024-12-30"
"2B016","2024","COM","2022","579","5","584","2024-12-30"
"2B020","2024","COM","2022","594","12","606","2024-12-30"
"2B023","2024","COM","2022","116","0","116","2024-12-30"
"2B025","2024","COM","2022","81","0","81","2024-12-30"
"2B029","2024","COM","2022","340","6","346","2024-12-30"
"2B030","2024","COM","2022","160","1","161","2024-12-30"
"2B033","2024","COM","2022","47459","582","48041","2024-12-30"
"2B034","2024","COM","2022","773","14","787","2024-12-30"
"2B036","2024","COM","2022","94","0","94","2024-12-30"
"2B037","2024","COM","2022","7638","139","7777","2024-12-30"
"2B039","2024","COM","2022","198","1","199","2024-12-30"
"2B042","2024","COM","2022","10102","196","10298","2024-12-30"
"2B043","2024","COM","2022","1558","37","1595","2024-12-30"
"2B045","2024","COM","2022","65","1","66","2024-12-30"
"2B046","2024","COM","2022","154","3","157","2024-12-30"
"2B047","2024","COM","2022","270","3","273","2024-12-30"
"2B049","2024","COM","2022","2571","30","2601","2024-12-30"
"2B050","2024","COM","2022","5720","84","5804","2024-12-30"
"2B051","2024","COM","2022","64","0","64","2024-12-30"
"2B052","2024","COM","2022","22","0","22","2024-12-30"
"2B053","2024","COM","2022","19","0","19","2024-12-30"
"2B054","2024","COM","2022","181","4","185","2024-12-30"
"2B055","2024","COM","2022","108","2","110","2024-12-30"
"2B057","2024","COM","2022","302","3","305","2024-12-30"
"2B058","2024","COM","2022","311","6","317","2024-12-30"
"2B059","2024","COM","2022","119","0","119","2024-12-30"
"2B063","2024","COM","2022","57","0","57","2024-12-30"
"2B067","2024","COM","2022","37","1","38","2024-12-30"
"2B068","2024","COM","2022","25","0","25","2024-12-30"
"2B069","2024","COM","2022","121","1","122","2024-12-30"
"2B072","2024","COM","2022","52","2","54","2024-12-30"
"2B073","2024","COM","2022","114","4","118","2024-12-30"
"2B074","2024","COM","2022","375","3","378","2024-12-30"
"2B075","2024","COM","2022","70","0","70","2024-12-30"
"2B077","2024","COM","2022","722","6","728","2024-12-30"
"2B078","2024","COM","2022","28","1","29","2024-12-30"
"2B079","2024","COM","2022","508","1","509","2024-12-30"
"2B080","2024","COM","2022","152","1","153","2024-12-30"
"2B081","2024","COM","2022","41","0","41","2024-12-30"
"2B082","2024","COM","2022","35","0","35","2024-12-30"
"2B083","2024","COM","2022","144","2","146","2024-12-30"
"2B084","2024","COM","2022","249","2","251","2024-12-30"
"2B086","2024","COM","2022","179","0","179","2024-12-30"
"2B087","2024","COM","2022","2161","21","2182","2024-12-30"
"2B088","2024","COM","2022","224","3","227","2024-12-30"
"2B093","2024","COM","2022","942","18","960","2024-12-30"
"2B095","2024","COM","2022","124","3","127","2024-12-30"
"2B096","2024","COM","2022","7737","108","7845","2024-12-30"
"2B097","2024","COM","2022","49","0","49","2024-12-30"
"2B101","2024","COM","2022","80","3","83","2024-12-30"
"2B102","2024","COM","2022","81","0","81","2024-12-30"
"2B105","2024","COM","2022","92","0","92","2024-12-30"
"2B106","2024","COM","2022","10","1","11","2024-12-30"
"2B107","2024","COM","2022","126","0","126","2024-12-30"
"2B109","2024","COM","2022","236","5","241","2024-12-30"
"2B110","2024","COM","2022","68","1","69","2024-12-30"
"2B111","2024","COM","2022","52","0","52","2024-12-30"
"2B112","2024","COM","2022","233","4","237","2024-12-30"
"2B113","2024","COM","2022","59","1","60","2024-12-30"
"2B116","2024","COM","2022","32","1","33","2024-12-30"
"2B120","2024","COM","2022","6308","107","6415","2024-12-30"
"2B121","2024","COM","2022","388","6","394","2024-12-30"
"2B122","2024","COM","2022","60","0","60","2024-12-30"
"2B123","2024","COM","2022","4246","57","4303","2024-12-30"
"2B124","2024","COM","2022","194","4","198","2024-12-30"
"2B125","2024","COM","2022","50","0","50","2024-12-30"
"2B126","2024","COM","2022","81","1","82","2024-12-30"
"2B134","2024","COM","2022","3213","65","3278","2024-12-30"
"2B135","2024","COM","2022","332","4","336","2024-12-30"
"2B136","2024","COM","2022","152","5","157","2024-12-30"
"2B137","2024","COM","2022","21","0","21","2024-12-30"
"2B138","2024","COM","2022","156","2","158","2024-12-30"
"2B140","2024","COM","2022","115","1","116","2024-12-30"
"2B143","2024","COM","2022","1134","4","1138","2024-12-30"
"2B145","2024","COM","2022","197","2","199","2024-12-30"
"2B147","2024","COM","2022","110","1","111","2024-12-30"
"2B148","2024","COM","2022","6354","54","6408","2024-12-30"
"2B149","2024","COM","2022","85","1","86","2024-12-30"
"2B150","2024","COM","2022","1189","36","1225","2024-12-30"
"2B152","2024","COM","2022","857","11","868","2024-12-30"
"2B153","2024","COM","2022","117","3","120","2024-12-30"
"2B155","2024","COM","2022","52","0","52","2024-12-30"
"2B156","2024","COM","2022","25","0","25","2024-12-30"
"2B157","2024","COM","2022","25","0","25","2024-12-30"
"2B159","2024","COM","2022","77","2","79","2024-12-30"
"2B161","2024","COM","2022","62","0","62","2024-12-30"
"2B162","2024","COM","2022","719","13","732","2024-12-30"
"2B164","2024","COM","2022","24","1","25","2024-12-30"
"2B165","2024","COM","2022","342","3","345","2024-12-30"
"2B166","2024","COM","2022","619","5","624","2024-12-30"
"2B167","2024","COM","2022","417","14","431","2024-12-30"
"2B168","2024","COM","2022","2057","46","2103","2024-12-30"
"2B169","2024","COM","2022","961","11","972","2024-12-30"
"2B170","2024","COM","2022","107","4","111","2024-12-30"
"2B171","2024","COM","2022","34","0","34","2024-12-30"
"2B172","2024","COM","2022","564","6","570","2024-12-30"
"2B173","2024","COM","2022","248","1","249","2024-12-30"
"2B175","2024","COM","2022","124","2","126","2024-12-30"
"2B176","2024","COM","2022","75","2","77","2024-12-30"
"2B177","2024","COM","2022","68","0","68","2024-12-30"
"2B178","2024","COM","2022","63","1","64","2024-12-30"
"2B179","2024","COM","2022","58","1","59","2024-12-30"
"2B180","2024","COM","2022","80","2","82","2024-12-30"
"2B182","2024","COM","2022","245","5","250","2024-12-30"
"2B183","2024","COM","2022","90","2","92","2024-12-30"
"2B184","2024","COM","2022","95","1","96","2024-12-30"
"2B185","2024","COM","2022","1816","17","1833","2024-12-30"
"2B187","2024","COM","2022","129","1","130","2024-12-30"
"2B188","2024","COM","2022","563","3","566","2024-12-30"
"2B190","2024","COM","2022","187","4","191","2024-12-30"
"2B192","2024","COM","2022","139","3","142","2024-12-30"
"2B193","2024","COM","2022","599","5","604","2024-12-30"
"2B194","2024","COM","2022","25","0","25","2024-12-30"
"2B195","2024","COM","2022","130","4","134","2024-12-30"
"2B199","2024","COM","2022","190","4","194","2024-12-30"
"2B201","2024","COM","2022","197","1","198","2024-12-30"
"2B202","2024","COM","2022","25","0","25","2024-12-30"
"2B205","2024","COM","2022","877","13","890","2024-12-30"
"2B206","2024","COM","2022","40","0","40","2024-12-30"
"2B207","2024","COM","2022","3523","38","3561","2024-12-30"
"2B208","2024","COM","2022","109","1","110","2024-12-30"
"2B210","2024","COM","2022","111","0","111","2024-12-30"
"2B213","2024","COM","2022","55","2","57","2024-12-30"
"2B214","2024","COM","2022","18","1","19","2024-12-30"
"2B216","2024","COM","2022","19","0","19","2024-12-30"
"2B217","2024","COM","2022","50","0","50","2024-12-30"
"2B218","2024","COM","2022","109","2","111","2024-12-30"
"2B219","2024","COM","2022","80","1","81","2024-12-30"
"2B220","2024","COM","2022","153","1","154","2024-12-30"
"2B221","2024","COM","2022","17","0","17","2024-12-30"
"2B222","2024","COM","2022","37","0","37","2024-12-30"
"2B223","2024","COM","2022","503","8","511","2024-12-30"
"2B224","2024","COM","2022","656","9","665","2024-12-30"
"2B225","2024","COM","2022","101","1","102","2024-12-30"
"2B226","2024","COM","2022","58","1","59","2024-12-30"
"2B227","2024","COM","2022","32","1","33","2024-12-30"
"2B229","2024","COM","2022","350","0","350","2024-12-30"
"2B230","2024","COM","2022","116","0","116","2024-12-30"
"2B231","2024","COM","2022","122","2","124","2024-12-30"
"2B233","2024","COM","2022","154","0","154","2024-12-30"
"2B234","2024","COM","2022","18","0","18","2024-12-30"
"2B235","2024","COM","2022","86","0","86","2024-12-30"
"2B236","2024","COM","2022","186","3","189","2024-12-30"
"2B238","2024","COM","2022","210","6","216","2024-12-30"
"2B239","2024","COM","2022","216","10","226","2024-12-30"
"2B241","2024","COM","2022","35","1","36","2024-12-30"
"2B242","2024","COM","2022","823","9","832","2024-12-30"
"2B243","2024","COM","2022","35","1","36","2024-12-30"
"2B244","2024","COM","2022","42","0","42","2024-12-30"
"2B245","2024","COM","2022","44","1","45","2024-12-30"
"2B246","2024","COM","2022","191","2","193","2024-12-30"
"2B248","2024","COM","2022","51","2","53","2024-12-30"
"2B250","2024","COM","2022","149","0","149","2024-12-30"
"2B251","2024","COM","2022","3736","41","3777","2024-12-30"
"2B252","2024","COM","2022","176","3","179","2024-12-30"
"2B255","2024","COM","2022","46","1","47","2024-12-30"
"2B256","2024","COM","2022","31","1","32","2024-12-30"
"2B257","2024","COM","2022","162","4","166","2024-12-30"
"2B260","2024","COM","2022","150","3","153","2024-12-30"
"2B261","2024","COM","2022","540","10","550","2024-12-30"
"2B263","2024","COM","2022","70","5","75","2024-12-30"
"2B264","2024","COM","2022","63","0","63","2024-12-30"
"2B265","2024","COM","2022","519","5","524","2024-12-30"
"2B267","2024","COM","2022","46","1","47","2024-12-30"
"2B273","2024","COM","2022","42","0","42","2024-12-30"
"2B274","2024","COM","2022","84","1","85","2024-12-30"
"2B275","2024","COM","2022","76","3","79","2024-12-30"
"2B277","2024","COM","2022","349","5","354","2024-12-30"
"2B280","2024","COM","2022","100","1","101","2024-12-30"
"2B281","2024","COM","2022","1172","11","1183","2024-12-30"
"2B283","2024","COM","2022","734","11","745","2024-12-30"
"2B286","2024","COM","2022","901","19","920","2024-12-30"
"2B287","2024","COM","2022","129","0","129","2024-12-30"
"2B289","2024","COM","2022","112","2","114","2024-12-30"
"2B290","2024","COM","2022","261","7","268","2024-12-30"
"2B291","2024","COM","2022","34","0","34","2024-12-30"
"2B292","2024","COM","2022","56","1","57","2024-12-30"
"2B293","2024","COM","2022","197","2","199","2024-12-30"
"2B296","2024","COM","2022","132","1","133","2024-12-30"
"2B297","2024","COM","2022","54","0","54","2024-12-30"
"2B298","2024","COM","2022","1685","18","1703","2024-12-30"
"2B299","2024","COM","2022","104","1","105","2024-12-30"
"2B301","2024","COM","2022","58","1","59","2024-12-30"
"2B302","2024","COM","2022","97","0","97","2024-12-30"
"2B303","2024","COM","2022","787","3","790","2024-12-30"
"2B304","2024","COM","2022","139","3","142","2024-12-30"
"2B305","2024","COM","2022","2996","32","3028","2024-12-30"
"2B306","2024","COM","2022","116","2","118","2024-12-30"
"2B307","2024","COM","2022","1517","29","1546","2024-12-30"
"2B309","2024","COM","2022","1970","103","2073","2024-12-30"
"2B311","2024","COM","2022","798","8","806","2024-12-30"
"2B313","2024","COM","2022","2048","22","2070","2024-12-30"
"2B314","2024","COM","2022","339","3","342","2024-12-30"
"2B315","2024","COM","2022","298","0","298","2024-12-30"
"2B316","2024","COM","2022","999","15","1014","2024-12-30"
"2B317","2024","COM","2022","56","0","56","2024-12-30"
"2B318","2024","COM","2022","609","7","616","2024-12-30"
"2B319","2024","COM","2022","842","6","848","2024-12-30"
"2B320","2024","COM","2022","281","4","285","2024-12-30"
"2B321","2024","COM","2022","16","0","16","2024-12-30"
"2B327","2024","COM","2022","179","3","182","2024-12-30"
"2B328","2024","COM","2022","99","0","99","2024-12-30"
"2B329","2024","COM","2022","115","2","117","2024-12-30"
"2B332","2024","COM","2022","259","5","264","2024-12-30"
"2B333","2024","COM","2022","163","6","169","2024-12-30"
"2B334","2024","COM","2022","118","0","118","2024-12-30"
"2B335","2024","COM","2022","341","6","347","2024-12-30"
"2B337","2024","COM","2022","168","2","170","2024-12-30"
"2B338","2024","COM","2022","26","0","26","2024-12-30"
"2B339","2024","COM","2022","28","0","28","2024-12-30"
"2B340","2024","COM","2022","105","2","107","2024-12-30"
"2B341","2024","COM","2022","643","6","649","2024-12-30"
"2B342","2024","COM","2022","2593","41","2634","2024-12-30"
"2B343","2024","COM","2022","1840","17","1857","2024-12-30"
"2B344","2024","COM","2022","43","2","45","2024-12-30"
"2B346","2024","COM","2022","3393","21","3414","2024-12-30"
"2B347","2024","COM","2022","269","1","270","2024-12-30"
"2B350","2024","COM","2022","221","4","225","2024-12-30"
"2B352","2024","COM","2022","206","6","212","2024-12-30"
"2B353","2024","COM","2022","3187","62","3249","2024-12-30"
"2B354","2024","COM","2022","429","6","435","2024-12-30"
"2B355","2024","COM","2022","382","2","384","2024-12-30"
"2B356","2024","COM","2022","151","3","154","2024-12-30"
"2B361","2024","COM","2022","314","3","317","2024-12-30"
"2B364","2024","COM","2022","37","0","37","2024-12-30"
"2B365","2024","COM","2022","100","1","101","2024-12-30"
"2B366","2024","COM","2022","106","1","107","2024-12-30"
"30001","2024","COM","2022","534","11","545","2024-12-30"
"30002","2024","COM","2022","777","16","793","2024-12-30"
"30003","2024","COM","2022","8707","88","8795","2024-12-30"
"30004","2024","COM","2022","3340","60","3400","2024-12-30"
"30005","2024","COM","2022","212","5","217","2024-12-30"
"30006","2024","COM","2022","5806","59","5865","2024-12-30"
"30007","2024","COM","2022","45025","527","45552","2024-12-30"
"30008","2024","COM","2022","1013","18","1031","2024-12-30"
"30009","2024","COM","2022","184","1","185","2024-12-30"
"30010","2024","COM","2022","3322","38","3360","2024-12-30"
"30011","2024","COM","2022","8694","155","8849","2024-12-30"
"30012","2024","COM","2022","4082","56","4138","2024-12-30"
"30013","2024","COM","2022","441","22","463","2024-12-30"
"30014","2024","COM","2022","1048","19","1067","2024-12-30"
"30015","2024","COM","2022","138","3","141","2024-12-30"
"30016","2024","COM","2022","258","11","269","2024-12-30"
"30017","2024","COM","2022","214","2","216","2024-12-30"
"30018","2024","COM","2022","553","13","566","2024-12-30"
"30019","2024","COM","2022","2938","48","2986","2024-12-30"
"30020","2024","COM","2022","2296","31","2327","2024-12-30"
"30021","2024","COM","2022","326","5","331","2024-12-30"
"30022","2024","COM","2022","157","5","162","2024-12-30"
"30023","2024","COM","2022","769","14","783","2024-12-30"
"30024","2024","COM","2022","445","6","451","2024-12-30"
"30025","2024","COM","2022","252","6","258","2024-12-30"
"30026","2024","COM","2022","1059","22","1081","2024-12-30"
"30027","2024","COM","2022","2595","62","2657","2024-12-30"
"30028","2024","COM","2022","18124","321","18445","2024-12-30"
"30029","2024","COM","2022","1606","32","1638","2024-12-30"
"30030","2024","COM","2022","338","10","348","2024-12-30"
"30031","2024","COM","2022","204","4","208","2024-12-30"
"30032","2024","COM","2022","15695","174","15869","2024-12-30"
"30033","2024","COM","2022","5823","61","5884","2024-12-30"
"30034","2024","COM","2022","7929","79","8008","2024-12-30"
"30035","2024","COM","2022","235","1","236","2024-12-30"
"30036","2024","COM","2022","3341","45","3386","2024-12-30"
"30037","2024","COM","2022","2624","23","2647","2024-12-30"
"30038","2024","COM","2022","330","9","339","2024-12-30"
"30039","2024","COM","2022","2341","27","2368","2024-12-30"
"30040","2024","COM","2022","133","3","136","2024-12-30"
"30041","2024","COM","2022","1228","21","1249","2024-12-30"
"30042","2024","COM","2022","2621","46","2667","2024-12-30"
"30043","2024","COM","2022","595","17","612","2024-12-30"
"30044","2024","COM","2022","77","3","80","2024-12-30"
"30045","2024","COM","2022","392","2","394","2024-12-30"
"30046","2024","COM","2022","995","10","1005","2024-12-30"
"30047","2024","COM","2022","6119","132","6251","2024-12-30"
"30048","2024","COM","2022","197","3","200","2024-12-30"
"30049","2024","COM","2022","364","17","381","2024-12-30"
"30050","2024","COM","2022","168","1","169","2024-12-30"
"30051","2024","COM","2022","1297","23","1320","2024-12-30"
"30052","2024","COM","2022","679","21","700","2024-12-30"
"30053","2024","COM","2022","713","11","724","2024-12-30"
"30054","2024","COM","2022","299","4","303","2024-12-30"
"30055","2024","COM","2022","681","12","693","2024-12-30"
"30056","2024","COM","2022","331","6","337","2024-12-30"
"30057","2024","COM","2022","1781","35","1816","2024-12-30"
"30058","2024","COM","2022","229","7","236","2024-12-30"
"30059","2024","COM","2022","2566","20","2586","2024-12-30"
"30060","2024","COM","2022","4077","82","4159","2024-12-30"
"30061","2024","COM","2022","2572","32","2604","2024-12-30"
"30062","2024","COM","2022","6295","89","6384","2024-12-30"
"30064","2024","COM","2022","153","1","154","2024-12-30"
"30065","2024","COM","2022","477","4","481","2024-12-30"
"30066","2024","COM","2022","610","13","623","2024-12-30"
"30067","2024","COM","2022","421","6","427","2024-12-30"
"30068","2024","COM","2022","922","14","936","2024-12-30"
"30069","2024","COM","2022","540","13","553","2024-12-30"
"30070","2024","COM","2022","790","25","815","2024-12-30"
"30071","2024","COM","2022","448","8","456","2024-12-30"
"30072","2024","COM","2022","482","13","495","2024-12-30"
"30073","2024","COM","2022","1681","89","1770","2024-12-30"
"30074","2024","COM","2022","25","0","25","2024-12-30"
"30075","2024","COM","2022","4328","117","4445","2024-12-30"
"30076","2024","COM","2022","847","23","870","2024-12-30"
"30077","2024","COM","2022","1612","26","1638","2024-12-30"
"30079","2024","COM","2022","262","3","265","2024-12-30"
"30080","2024","COM","2022","886","7","893","2024-12-30"
"30081","2024","COM","2022","975","24","999","2024-12-30"
"30082","2024","COM","2022","4257","100","4357","2024-12-30"
"30083","2024","COM","2022","2518","42","2560","2024-12-30"
"30084","2024","COM","2022","597","9","606","2024-12-30"
"30085","2024","COM","2022","1080","22","1102","2024-12-30"
"30086","2024","COM","2022","670","10","680","2024-12-30"
"30087","2024","COM","2022","202","1","203","2024-12-30"
"30088","2024","COM","2022","762","12","774","2024-12-30"
"30089","2024","COM","2022","1703","28","1731","2024-12-30"
"30090","2024","COM","2022","271","6","277","2024-12-30"
"30091","2024","COM","2022","1628","33","1661","2024-12-30"
"30092","2024","COM","2022","1702","46","1748","2024-12-30"
"30093","2024","COM","2022","115","0","115","2024-12-30"
"30094","2024","COM","2022","156","4","160","2024-12-30"
"30095","2024","COM","2022","620","12","632","2024-12-30"
"30096","2024","COM","2022","908","18","926","2024-12-30"
"30097","2024","COM","2022","283","3","286","2024-12-30"
"30098","2024","COM","2022","493","7","500","2024-12-30"
"30099","2024","COM","2022","256","5","261","2024-12-30"
"30100","2024","COM","2022","703","10","713","2024-12-30"
"30101","2024","COM","2022","644","13","657","2024-12-30"
"30102","2024","COM","2022","531","10","541","2024-12-30"
"30103","2024","COM","2022","966","11","977","2024-12-30"
"30104","2024","COM","2022","750","19","769","2024-12-30"
"30105","2024","COM","2022","157","2","159","2024-12-30"
"30106","2024","COM","2022","757","16","773","2024-12-30"
"30107","2024","COM","2022","605","13","618","2024-12-30"
"30108","2024","COM","2022","152","2","154","2024-12-30"
"30109","2024","COM","2022","491","9","500","2024-12-30"
"30110","2024","COM","2022","338","9","347","2024-12-30"
"30111","2024","COM","2022","449","8","457","2024-12-30"
"30112","2024","COM","2022","1734","19","1753","2024-12-30"
"30113","2024","COM","2022","228","4","232","2024-12-30"
"30114","2024","COM","2022","688","10","698","2024-12-30"
"30115","2024","COM","2022","255","8","263","2024-12-30"
"30116","2024","COM","2022","1058","14","1072","2024-12-30"
"30117","2024","COM","2022","2701","50","2751","2024-12-30"
"30119","2024","COM","2022","161","4","165","2024-12-30"
"30120","2024","COM","2022","1095","10","1105","2024-12-30"
"30121","2024","COM","2022","296","4","300","2024-12-30"
"30122","2024","COM","2022","747","12","759","2024-12-30"
"30123","2024","COM","2022","3615","116","3731","2024-12-30"
"30124","2024","COM","2022","255","5","260","2024-12-30"
"30125","2024","COM","2022","5244","63","5307","2024-12-30"
"30126","2024","COM","2022","762","17","779","2024-12-30"
"30127","2024","COM","2022","1069","26","1095","2024-12-30"
"30128","2024","COM","2022","4039","69","4108","2024-12-30"
"30129","2024","COM","2022","711","10","721","2024-12-30"
"30130","2024","COM","2022","820","8","828","2024-12-30"
"30131","2024","COM","2022","1118","33","1151","2024-12-30"
"30132","2024","COM","2022","4837","105","4942","2024-12-30"
"30133","2024","COM","2022","8513","77","8590","2024-12-30"
"30134","2024","COM","2022","320","4","324","2024-12-30"
"30135","2024","COM","2022","3886","37","3923","2024-12-30"
"30136","2024","COM","2022","1260","22","1282","2024-12-30"
"30137","2024","COM","2022","138","4","142","2024-12-30"
"30138","2024","COM","2022","2297","53","2350","2024-12-30"
"30139","2024","COM","2022","339","27","366","2024-12-30"
"30140","2024","COM","2022","1166","20","1186","2024-12-30"
"30141","2024","COM","2022","6673","119","6792","2024-12-30"
"30142","2024","COM","2022","1088","22","1110","2024-12-30"
"30143","2024","COM","2022","213","3","216","2024-12-30"
"30144","2024","COM","2022","473","9","482","2024-12-30"
"30145","2024","COM","2022","1676","25","1701","2024-12-30"
"30146","2024","COM","2022","1520","24","1544","2024-12-30"
"30147","2024","COM","2022","1580","26","1606","2024-12-30"
"30148","2024","COM","2022","330","7","337","2024-12-30"
"30149","2024","COM","2022","938","15","953","2024-12-30"
"30150","2024","COM","2022","263","6","269","2024-12-30"
"30151","2024","COM","2022","531","7","538","2024-12-30"
"30152","2024","COM","2022","2107","33","2140","2024-12-30"
"30153","2024","COM","2022","115","4","119","2024-12-30"
"30154","2024","COM","2022","370","9","379","2024-12-30"
"30155","2024","COM","2022","7087","82","7169","2024-12-30"
"30156","2024","COM","2022","8370","143","8513","2024-12-30"
"30158","2024","COM","2022","438","3","441","2024-12-30"
"30159","2024","COM","2022","739","11","750","2024-12-30"
"30160","2024","COM","2022","275","5","280","2024-12-30"
"30161","2024","COM","2022","195","2","197","2024-12-30"
"30162","2024","COM","2022","669","16","685","2024-12-30"
"30163","2024","COM","2022","177","6","183","2024-12-30"
"30164","2024","COM","2022","740","9","749","2024-12-30"
"30165","2024","COM","2022","1232","38","1270","2024-12-30"
"30166","2024","COM","2022","2576","153","2729","2024-12-30"
"30167","2024","COM","2022","783","17","800","2024-12-30"
"30168","2024","COM","2022","629","15","644","2024-12-30"
"30169","2024","COM","2022","6142","115","6257","2024-12-30"
"30170","2024","COM","2022","903","32","935","2024-12-30"
"30171","2024","COM","2022","1187","10","1197","2024-12-30"
"30172","2024","COM","2022","780","22","802","2024-12-30"
"30173","2024","COM","2022","1789","48","1837","2024-12-30"
"30174","2024","COM","2022","1390","37","1427","2024-12-30"
"30175","2024","COM","2022","177","1","178","2024-12-30"
"30176","2024","COM","2022","198","3","201","2024-12-30"
"30177","2024","COM","2022","677","13","690","2024-12-30"
"30178","2024","COM","2022","1525","41","1566","2024-12-30"
"30179","2024","COM","2022","3125","49","3174","2024-12-30"
"30180","2024","COM","2022","559","12","571","2024-12-30"
"30181","2024","COM","2022","478","6","484","2024-12-30"
"30182","2024","COM","2022","1398","26","1424","2024-12-30"
"30183","2024","COM","2022","640","9","649","2024-12-30"
"30184","2024","COM","2022","1564","17","1581","2024-12-30"
"30185","2024","COM","2022","1597","26","1623","2024-12-30"
"30186","2024","COM","2022","2160","47","2207","2024-12-30"
"30187","2024","COM","2022","307","9","316","2024-12-30"
"30188","2024","COM","2022","791","8","799","2024-12-30"
"30189","2024","COM","2022","150444","2168","152612","2024-12-30"
"30191","2024","COM","2022","1197","31","1228","2024-12-30"
"30192","2024","COM","2022","439","12","451","2024-12-30"
"30193","2024","COM","2022","656","12","668","2024-12-30"
"30194","2024","COM","2022","272","3","275","2024-12-30"
"30195","2024","COM","2022","31","0","31","2024-12-30"
"30196","2024","COM","2022","473","11","484","2024-12-30"
"30197","2024","COM","2022","291","8","299","2024-12-30"
"30198","2024","COM","2022","228","6","234","2024-12-30"
"30199","2024","COM","2022","57","1","58","2024-12-30"
"30200","2024","COM","2022","914","14","928","2024-12-30"
"30201","2024","COM","2022","368","10","378","2024-12-30"
"30202","2024","COM","2022","10759","177","10936","2024-12-30"
"30203","2024","COM","2022","324","3","327","2024-12-30"
"30204","2024","COM","2022","368","5","373","2024-12-30"
"30205","2024","COM","2022","263","3","266","2024-12-30"
"30206","2024","COM","2022","4265","130","4395","2024-12-30"
"30207","2024","COM","2022","750","15","765","2024-12-30"
"30208","2024","COM","2022","48","0","48","2024-12-30"
"30209","2024","COM","2022","3911","133","4044","2024-12-30"
"30210","2024","COM","2022","3449","49","3498","2024-12-30"
"30211","2024","COM","2022","4227","65","4292","2024-12-30"
"30212","2024","COM","2022","2268","35","2303","2024-12-30"
"30213","2024","COM","2022","31","0","31","2024-12-30"
"30214","2024","COM","2022","2055","43","2098","2024-12-30"
"30215","2024","COM","2022","424","4","428","2024-12-30"
"30216","2024","COM","2022","840","14","854","2024-12-30"
"30217","2024","COM","2022","8067","215","8282","2024-12-30"
"30218","2024","COM","2022","246","5","251","2024-12-30"
"30219","2024","COM","2022","91","1","92","2024-12-30"
"30220","2024","COM","2022","265","6","271","2024-12-30"
"30221","2024","COM","2022","5528","56","5584","2024-12-30"
"30222","2024","COM","2022","174","7","181","2024-12-30"
"30223","2024","COM","2022","4437","115","4552","2024-12-30"
"30224","2024","COM","2022","664","11","675","2024-12-30"
"30225","2024","COM","2022","1596","54","1650","2024-12-30"
"30226","2024","COM","2022","1250","33","1283","2024-12-30"
"30227","2024","COM","2022","3353","38","3391","2024-12-30"
"30228","2024","COM","2022","1744","33","1777","2024-12-30"
"30229","2024","COM","2022","600","9","609","2024-12-30"
"30230","2024","COM","2022","576","17","593","2024-12-30"
"30231","2024","COM","2022","360","5","365","2024-12-30"
"30232","2024","COM","2022","444","15","459","2024-12-30"
"30233","2024","COM","2022","681","10","691","2024-12-30"
"30234","2024","COM","2022","291","5","296","2024-12-30"
"30235","2024","COM","2022","816","13","829","2024-12-30"
"30236","2024","COM","2022","124","1","125","2024-12-30"
"30237","2024","COM","2022","684","9","693","2024-12-30"
"30238","2024","COM","2022","71","0","71","2024-12-30"
"30239","2024","COM","2022","528","6","534","2024-12-30"
"30240","2024","COM","2022","390","8","398","2024-12-30"
"30241","2024","COM","2022","2030","38","2068","2024-12-30"
"30242","2024","COM","2022","160","4","164","2024-12-30"
"30243","2024","COM","2022","7199","187","7386","2024-12-30"
"30244","2024","COM","2022","347","6","353","2024-12-30"
"30245","2024","COM","2022","797","13","810","2024-12-30"
"30246","2024","COM","2022","103","7","110","2024-12-30"
"30247","2024","COM","2022","292","9","301","2024-12-30"
"30248","2024","COM","2022","459","11","470","2024-12-30"
"30249","2024","COM","2022","1071","21","1092","2024-12-30"
"30250","2024","COM","2022","391","6","397","2024-12-30"
"30251","2024","COM","2022","537","10","547","2024-12-30"
"30252","2024","COM","2022","201","6","207","2024-12-30"
"30253","2024","COM","2022","1203","9","1212","2024-12-30"
"30254","2024","COM","2022","2013","35","2048","2024-12-30"
"30255","2024","COM","2022","3172","40","3212","2024-12-30"
"30256","2024","COM","2022","792","17","809","2024-12-30"
"30257","2024","COM","2022","1990","26","2016","2024-12-30"
"30258","2024","COM","2022","14427","132","14559","2024-12-30"
"30259","2024","COM","2022","4643","84","4727","2024-12-30"
"30260","2024","COM","2022","1115","24","1139","2024-12-30"
"30261","2024","COM","2022","272","3","275","2024-12-30"
"30262","2024","COM","2022","249","12","261","2024-12-30"
"30263","2024","COM","2022","3739","117","3856","2024-12-30"
"30264","2024","COM","2022","173","6","179","2024-12-30"
"30265","2024","COM","2022","254","2","256","2024-12-30"
"30266","2024","COM","2022","856","11","867","2024-12-30"
"30267","2024","COM","2022","536","7","543","2024-12-30"
"30268","2024","COM","2022","593","16","609","2024-12-30"
"30269","2024","COM","2022","2533","173","2706","2024-12-30"
"30270","2024","COM","2022","1531","33","1564","2024-12-30"
"30271","2024","COM","2022","730","8","738","2024-12-30"
"30272","2024","COM","2022","145","2","147","2024-12-30"
"30273","2024","COM","2022","1501","20","1521","2024-12-30"
"30274","2024","COM","2022","3492","67","3559","2024-12-30"
"30275","2024","COM","2022","326","5","331","2024-12-30"
"30276","2024","COM","2022","3651","39","3690","2024-12-30"
"30277","2024","COM","2022","535","9","544","2024-12-30"
"30278","2024","COM","2022","2984","69","3053","2024-12-30"
"30279","2024","COM","2022","707","17","724","2024-12-30"
"30280","2024","COM","2022","371","11","382","2024-12-30"
"30281","2024","COM","2022","1617","30","1647","2024-12-30"
"30282","2024","COM","2022","873","24","897","2024-12-30"
"30283","2024","COM","2022","182","3","185","2024-12-30"
"30284","2024","COM","2022","4721","51","4772","2024-12-30"
"30285","2024","COM","2022","761","21","782","2024-12-30"
"30286","2024","COM","2022","794","19","813","2024-12-30"
"30287","2024","COM","2022","719","7","726","2024-12-30"
"30288","2024","COM","2022","1297","19","1316","2024-12-30"
"30289","2024","COM","2022","81","0","81","2024-12-30"
"30290","2024","COM","2022","1894","65","1959","2024-12-30"
"30291","2024","COM","2022","327","7","334","2024-12-30"
"30292","2024","COM","2022","501","12","513","2024-12-30"
"30293","2024","COM","2022","336","5","341","2024-12-30"
"30294","2024","COM","2022","5592","109","5701","2024-12-30"
"30295","2024","COM","2022","3110","50","3160","2024-12-30"
"30296","2024","COM","2022","166","6","172","2024-12-30"
"30297","2024","COM","2022","212","11","223","2024-12-30"
"30298","2024","COM","2022","510","8","518","2024-12-30"
"30299","2024","COM","2022","1121","50","1171","2024-12-30"
"30300","2024","COM","2022","550","11","561","2024-12-30"
"30301","2024","COM","2022","308","3","311","2024-12-30"
"30302","2024","COM","2022","2222","50","2272","2024-12-30"
"30303","2024","COM","2022","827","13","840","2024-12-30"
"30304","2024","COM","2022","215","4","219","2024-12-30"
"30305","2024","COM","2022","3648","55","3703","2024-12-30"
"30306","2024","COM","2022","558","9","567","2024-12-30"
"30307","2024","COM","2022","2403","20","2423","2024-12-30"
"30308","2024","COM","2022","832","46","878","2024-12-30"
"30309","2024","COM","2022","352","1","353","2024-12-30"
"30310","2024","COM","2022","296","5","301","2024-12-30"
"30311","2024","COM","2022","1956","31","1987","2024-12-30"
"30312","2024","COM","2022","2013","44","2057","2024-12-30"
"30313","2024","COM","2022","827","9","836","2024-12-30"
"30314","2024","COM","2022","238","4","242","2024-12-30"
"30315","2024","COM","2022","2097","42","2139","2024-12-30"
"30316","2024","COM","2022","241","6","247","2024-12-30"
"30317","2024","COM","2022","1816","15","1831","2024-12-30"
"30318","2024","COM","2022","221","4","225","2024-12-30"
"30319","2024","COM","2022","609","13","622","2024-12-30"
"30320","2024","COM","2022","172","2","174","2024-12-30"
"30321","2024","COM","2022","5028","59","5087","2024-12-30"
"30322","2024","COM","2022","268","7","275","2024-12-30"
"30323","2024","COM","2022","120","2","122","2024-12-30"
"30324","2024","COM","2022","932","18","950","2024-12-30"
"30325","2024","COM","2022","1239","34","1273","2024-12-30"
"30326","2024","COM","2022","2032","47","2079","2024-12-30"
"30327","2024","COM","2022","47","1","48","2024-12-30"
"30328","2024","COM","2022","1070","13","1083","2024-12-30"
"30329","2024","COM","2022","447","8","455","2024-12-30"
"30330","2024","COM","2022","944","20","964","2024-12-30"
"30331","2024","COM","2022","1803","40","1843","2024-12-30"
"30332","2024","COM","2022","108","2","110","2024-12-30"
"30333","2024","COM","2022","4824","44","4868","2024-12-30"
"30334","2024","COM","2022","8360","332","8692","2024-12-30"
"30335","2024","COM","2022","140","2","142","2024-12-30"
"30336","2024","COM","2022","1376","15","1391","2024-12-30"
"30337","2024","COM","2022","415","6","421","2024-12-30"
"30338","2024","COM","2022","132","3","135","2024-12-30"
"30339","2024","COM","2022","1418","27","1445","2024-12-30"
"30340","2024","COM","2022","652","10","662","2024-12-30"
"30341","2024","COM","2022","11772","94","11866","2024-12-30"
"30342","2024","COM","2022","1262","37","1299","2024-12-30"
"30343","2024","COM","2022","594","15","609","2024-12-30"
"30344","2024","COM","2022","5778","74","5852","2024-12-30"
"30345","2024","COM","2022","357","3","360","2024-12-30"
"30346","2024","COM","2022","1758","34","1792","2024-12-30"
"30347","2024","COM","2022","1345","22","1367","2024-12-30"
"30348","2024","COM","2022","1839","126","1965","2024-12-30"
"30349","2024","COM","2022","582","3","585","2024-12-30"
"30350","2024","COM","2022","3786","101","3887","2024-12-30"
"30351","2024","COM","2022","12950","349","13299","2024-12-30"
"30352","2024","COM","2022","1874","36","1910","2024-12-30"
"30353","2024","COM","2022","68","0","68","2024-12-30"
"30354","2024","COM","2022","233","3","236","2024-12-30"
"30355","2024","COM","2022","1047","17","1064","2024-12-30"
"30356","2024","COM","2022","2810","166","2976","2024-12-30"
"31001","2024","COM","2022","117","2","119","2024-12-30"
"31002","2024","COM","2022","240","5","245","2024-12-30"
"31003","2024","COM","2022","1326","32","1358","2024-12-30"
"31004","2024","COM","2022","2807","69","2876","2024-12-30"
"31005","2024","COM","2022","289","6","295","2024-12-30"
"31006","2024","COM","2022","229","6","235","2024-12-30"
"31007","2024","COM","2022","59","0","59","2024-12-30"
"31008","2024","COM","2022","265","3","268","2024-12-30"
"31009","2024","COM","2022","171","2","173","2024-12-30"
"31010","2024","COM","2022","86","1","87","2024-12-30"
"31011","2024","COM","2022","285","9","294","2024-12-30"
"31012","2024","COM","2022","94","2","96","2024-12-30"
"31013","2024","COM","2022","372","13","385","2024-12-30"
"31014","2024","COM","2022","89","3","92","2024-12-30"
"31015","2024","COM","2022","22","0","22","2024-12-30"
"31017","2024","COM","2022","104","3","107","2024-12-30"
"31018","2024","COM","2022","231","5","236","2024-12-30"
"31019","2024","COM","2022","32","0","32","2024-12-30"
"31020","2024","COM","2022","914","53","967","2024-12-30"
"31021","2024","COM","2022","128","1","129","2024-12-30"
"31022","2024","COM","2022","9578","97","9675","2024-12-30"
"31023","2024","COM","2022","313","6","319","2024-12-30"
"31024","2024","COM","2022","466","12","478","2024-12-30"
"31025","2024","COM","2022","1022","32","1054","2024-12-30"
"31026","2024","COM","2022","1080","22","1102","2024-12-30"
"31027","2024","COM","2022","195","5","200","2024-12-30"
"31028","2024","COM","2022","1240","45","1285","2024-12-30"
"31029","2024","COM","2022","340","6","346","2024-12-30"
"31030","2024","COM","2022","87","1","88","2024-12-30"
"31031","2024","COM","2022","592","18","610","2024-12-30"
"31032","2024","COM","2022","7731","101","7832","2024-12-30"
"31033","2024","COM","2022","10291","136","10427","2024-12-30"
"31034","2024","COM","2022","222","9","231","2024-12-30"
"31035","2024","COM","2022","4451","270","4721","2024-12-30"
"31036","2024","COM","2022","1621","29","1650","2024-12-30"
"31037","2024","COM","2022","1600","35","1635","2024-12-30"
"31038","2024","COM","2022","670","11","681","2024-12-30"
"31039","2024","COM","2022","89","2","91","2024-12-30"
"31040","2024","COM","2022","33","1","34","2024-12-30"
"31041","2024","COM","2022","107","3","110","2024-12-30"
"31042","2024","COM","2022","2081","175","2256","2024-12-30"
"31043","2024","COM","2022","158","1","159","2024-12-30"
"31044","2024","COM","2022","17431","267","17698","2024-12-30"
"31045","2024","COM","2022","507","7","514","2024-12-30"
"31046","2024","COM","2022","11","1","12","2024-12-30"
"31047","2024","COM","2022","99","1","100","2024-12-30"
"31048","2024","COM","2022","3590","50","3640","2024-12-30"
"31049","2024","COM","2022","600","14","614","2024-12-30"
"31050","2024","COM","2022","659","7","666","2024-12-30"
"31051","2024","COM","2022","479","11","490","2024-12-30"
"31052","2024","COM","2022","1638","30","1668","2024-12-30"
"31053","2024","COM","2022","1225","29","1254","2024-12-30"
"31054","2024","COM","2022","199","1","200","2024-12-30"
"31055","2024","COM","2022","170","5","175","2024-12-30"
"31056","2024","COM","2022","8184","89","8273","2024-12-30"
"31057","2024","COM","2022","1528","55","1583","2024-12-30"
"31058","2024","COM","2022","127","1","128","2024-12-30"
"31059","2024","COM","2022","109","3","112","2024-12-30"
"31060","2024","COM","2022","112","3","115","2024-12-30"
"31061","2024","COM","2022","203","10","213","2024-12-30"
"31062","2024","COM","2022","110","4","114","2024-12-30"
"31063","2024","COM","2022","175","2","177","2024-12-30"
"31064","2024","COM","2022","29","0","29","2024-12-30"
"31065","2024","COM","2022","3079","68","3147","2024-12-30"
"31066","2024","COM","2022","4238","67","4305","2024-12-30"
"31067","2024","COM","2022","44","0","44","2024-12-30"
"31068","2024","COM","2022","34","0","34","2024-12-30"
"31069","2024","COM","2022","27314","484","27798","2024-12-30"
"31070","2024","COM","2022","433","7","440","2024-12-30"
"31071","2024","COM","2022","459","9","468","2024-12-30"
"31072","2024","COM","2022","68","2","70","2024-12-30"
"31073","2024","COM","2022","749","22","771","2024-12-30"
"31074","2024","COM","2022","295","8","303","2024-12-30"
"31075","2024","COM","2022","1247","34","1281","2024-12-30"
"31076","2024","COM","2022","460","14","474","2024-12-30"
"31077","2024","COM","2022","658","15","673","2024-12-30"
"31078","2024","COM","2022","149","2","151","2024-12-30"
"31079","2024","COM","2022","4655","79","4734","2024-12-30"
"31080","2024","COM","2022","1658","34","1692","2024-12-30"
"31081","2024","COM","2022","13","0","13","2024-12-30"
"31082","2024","COM","2022","1109","16","1125","2024-12-30"
"31083","2024","COM","2022","230","3","233","2024-12-30"
"31084","2024","COM","2022","1108","20","1128","2024-12-30"
"31085","2024","COM","2022","253","2","255","2024-12-30"
"31086","2024","COM","2022","81","4","85","2024-12-30"
"31087","2024","COM","2022","315","0","315","2024-12-30"
"31088","2024","COM","2022","2938","101","3039","2024-12-30"
"31089","2024","COM","2022","666","18","684","2024-12-30"
"31090","2024","COM","2022","367","5","372","2024-12-30"
"31091","2024","COM","2022","5908","103","6011","2024-12-30"
"31092","2024","COM","2022","122","1","123","2024-12-30"
"31093","2024","COM","2022","937","11","948","2024-12-30"
"31094","2024","COM","2022","2847","52","2899","2024-12-30"
"31095","2024","COM","2022","130","2","132","2024-12-30"
"31096","2024","COM","2022","187","5","192","2024-12-30"
"31097","2024","COM","2022","468","6","474","2024-12-30"
"31098","2024","COM","2022","1134","18","1152","2024-12-30"
"31099","2024","COM","2022","414","7","421","2024-12-30"
"31100","2024","COM","2022","2442","42","2484","2024-12-30"
"31101","2024","COM","2022","496","4","500","2024-12-30"
"31102","2024","COM","2022","228","3","231","2024-12-30"
"31103","2024","COM","2022","61","0","61","2024-12-30"
"31104","2024","COM","2022","650","11","661","2024-12-30"
"31105","2024","COM","2022","239","5","244","2024-12-30"
"31106","2024","COM","2022","2487","61","2548","2024-12-30"
"31107","2024","COM","2022","5650","119","5769","2024-12-30"
"31108","2024","COM","2022","258","7","265","2024-12-30"
"31109","2024","COM","2022","467","3","470","2024-12-30"
"31110","2024","COM","2022","644","14","658","2024-12-30"
"31111","2024","COM","2022","326","4","330","2024-12-30"
"31112","2024","COM","2022","178","5","183","2024-12-30"
"31113","2024","COM","2022","15264","236","15500","2024-12-30"
"31114","2024","COM","2022","243","2","245","2024-12-30"
"31115","2024","COM","2022","56","1","57","2024-12-30"
"31116","2024","COM","2022","11033","122","11155","2024-12-30"
"31117","2024","COM","2022","4491","106","4597","2024-12-30"
"31118","2024","COM","2022","6915","110","7025","2024-12-30"
"31119","2024","COM","2022","226","8","234","2024-12-30"
"31120","2024","COM","2022","797","18","815","2024-12-30"
"31121","2024","COM","2022","59","1","60","2024-12-30"
"31122","2024","COM","2022","95","1","96","2024-12-30"
"31123","2024","COM","2022","81","2","83","2024-12-30"
"31124","2024","COM","2022","399","9","408","2024-12-30"
"31125","2024","COM","2022","32","1","33","2024-12-30"
"31126","2024","COM","2022","440","11","451","2024-12-30"
"31127","2024","COM","2022","3","0","3","2024-12-30"
"31128","2024","COM","2022","864","24","888","2024-12-30"
"31129","2024","COM","2022","14","3","17","2024-12-30"
"31130","2024","COM","2022","85","0","85","2024-12-30"
"31131","2024","COM","2022","65","1","66","2024-12-30"
"31132","2024","COM","2022","61","1","62","2024-12-30"
"31133","2024","COM","2022","93","3","96","2024-12-30"
"31134","2024","COM","2022","90","0","90","2024-12-30"
"31135","2024","COM","2022","4818","73","4891","2024-12-30"
"31136","2024","COM","2022","2325","29","2354","2024-12-30"
"31137","2024","COM","2022","161","0","161","2024-12-30"
"31138","2024","COM","2022","253","5","258","2024-12-30"
"31139","2024","COM","2022","197","5","202","2024-12-30"
"31140","2024","COM","2022","207","4","211","2024-12-30"
"31141","2024","COM","2022","226","2","228","2024-12-30"
"31142","2024","COM","2022","228","6","234","2024-12-30"
"31143","2024","COM","2022","267","5","272","2024-12-30"
"31144","2024","COM","2022","696","12","708","2024-12-30"
"31145","2024","COM","2022","2994","65","3059","2024-12-30"
"31146","2024","COM","2022","11","0","11","2024-12-30"
"31147","2024","COM","2022","676","12","688","2024-12-30"
"31148","2024","COM","2022","526","15","541","2024-12-30"
"31149","2024","COM","2022","40916","475","41391","2024-12-30"
"31150","2024","COM","2022","8571","94","8665","2024-12-30"
"31151","2024","COM","2022","895","29","924","2024-12-30"
"31152","2024","COM","2022","90","0","90","2024-12-30"
"31153","2024","COM","2022","413","14","427","2024-12-30"
"31155","2024","COM","2022","229","3","232","2024-12-30"
"31156","2024","COM","2022","365","12","377","2024-12-30"
"31157","2024","COM","2022","20239","274","20513","2024-12-30"
"31158","2024","COM","2022","164","7","171","2024-12-30"
"31159","2024","COM","2022","479","4","483","2024-12-30"
"31160","2024","COM","2022","2575","46","2621","2024-12-30"
"31161","2024","COM","2022","1412","17","1429","2024-12-30"
"31162","2024","COM","2022","1138","87","1225","2024-12-30"
"31163","2024","COM","2022","2622","64","2686","2024-12-30"
"31164","2024","COM","2022","199","6","205","2024-12-30"
"31165","2024","COM","2022","6525","103","6628","2024-12-30"
"31166","2024","COM","2022","305","4","309","2024-12-30"
"31167","2024","COM","2022","673","15","688","2024-12-30"
"31168","2024","COM","2022","131","0","131","2024-12-30"
"31169","2024","COM","2022","6990","131","7121","2024-12-30"
"31170","2024","COM","2022","211","2","213","2024-12-30"
"31171","2024","COM","2022","278","9","287","2024-12-30"
"31172","2024","COM","2022","42","1","43","2024-12-30"
"31173","2024","COM","2022","281","8","289","2024-12-30"
"31174","2024","COM","2022","526","7","533","2024-12-30"
"31175","2024","COM","2022","615","10","625","2024-12-30"
"31176","2024","COM","2022","193","2","195","2024-12-30"
"31177","2024","COM","2022","137","2","139","2024-12-30"
"31178","2024","COM","2022","199","4","203","2024-12-30"
"31179","2024","COM","2022","301","19","320","2024-12-30"
"31180","2024","COM","2022","148","6","154","2024-12-30"
"31181","2024","COM","2022","2509","33","2542","2024-12-30"
"31182","2024","COM","2022","5727","54","5781","2024-12-30"
"31183","2024","COM","2022","313","7","320","2024-12-30"
"31184","2024","COM","2022","2073","37","2110","2024-12-30"
"31185","2024","COM","2022","117","4","121","2024-12-30"
"31186","2024","COM","2022","3086","23","3109","2024-12-30"
"31187","2024","COM","2022","13048","332","13380","2024-12-30"
"31188","2024","COM","2022","5869","162","6031","2024-12-30"
"31189","2024","COM","2022","217","8","225","2024-12-30"
"31190","2024","COM","2022","241","2","243","2024-12-30"
"31191","2024","COM","2022","109","1","110","2024-12-30"
"31192","2024","COM","2022","808","18","826","2024-12-30"
"31193","2024","COM","2022","1875","39","1914","2024-12-30"
"31194","2024","COM","2022","185","2","187","2024-12-30"
"31195","2024","COM","2022","28","0","28","2024-12-30"
"31196","2024","COM","2022","239","4","243","2024-12-30"
"31197","2024","COM","2022","328","9","337","2024-12-30"
"31198","2024","COM","2022","120","0","120","2024-12-30"
"31199","2024","COM","2022","188","8","196","2024-12-30"
"31200","2024","COM","2022","78","0","78","2024-12-30"
"31201","2024","COM","2022","67","2","69","2024-12-30"
"31202","2024","COM","2022","6664","130","6794","2024-12-30"
"31203","2024","COM","2022","9808","170","9978","2024-12-30"
"31204","2024","COM","2022","71","1","72","2024-12-30"
"31205","2024","COM","2022","3223","30","3253","2024-12-30"
"31206","2024","COM","2022","1331","14","1345","2024-12-30"
"31207","2024","COM","2022","86","5","91","2024-12-30"
"31208","2024","COM","2022","305","6","311","2024-12-30"
"31209","2024","COM","2022","167","6","173","2024-12-30"
"31210","2024","COM","2022","1360","33","1393","2024-12-30"
"31211","2024","COM","2022","758","9","767","2024-12-30"
"31212","2024","COM","2022","1899","26","1925","2024-12-30"
"31213","2024","COM","2022","150","1","151","2024-12-30"
"31215","2024","COM","2022","467","14","481","2024-12-30"
"31216","2024","COM","2022","415","9","424","2024-12-30"
"31217","2024","COM","2022","73","2","75","2024-12-30"
"31218","2024","COM","2022","97","1","98","2024-12-30"
"31219","2024","COM","2022","452","3","455","2024-12-30"
"31220","2024","COM","2022","388","5","393","2024-12-30"
"31221","2024","COM","2022","41","2","43","2024-12-30"
"31222","2024","COM","2022","43","1","44","2024-12-30"
"31223","2024","COM","2022","40","1","41","2024-12-30"
"31224","2024","COM","2022","1177","149","1326","2024-12-30"
"31225","2024","COM","2022","186","3","189","2024-12-30"
"31226","2024","COM","2022","81","5","86","2024-12-30"
"31227","2024","COM","2022","847","38","885","2024-12-30"
"31228","2024","COM","2022","2428","38","2466","2024-12-30"
"31229","2024","COM","2022","763","15","778","2024-12-30"
"31230","2024","COM","2022","4926","92","5018","2024-12-30"
"31231","2024","COM","2022","792","10","802","2024-12-30"
"31232","2024","COM","2022","9039","179","9218","2024-12-30"
"31233","2024","COM","2022","1009","32","1041","2024-12-30"
"31234","2024","COM","2022","464","11","475","2024-12-30"
"31235","2024","COM","2022","58","1","59","2024-12-30"
"31236","2024","COM","2022","72","1","73","2024-12-30"
"31237","2024","COM","2022","236","30","266","2024-12-30"
"31238","2024","COM","2022","492","12","504","2024-12-30"
"31239","2024","COM","2022","1622","25","1647","2024-12-30"
"31240","2024","COM","2022","657","8","665","2024-12-30"
"31241","2024","COM","2022","293","4","297","2024-12-30"
"31242","2024","COM","2022","20","2","22","2024-12-30"
"31243","2024","COM","2022","67","4","71","2024-12-30"
"31244","2024","COM","2022","372","18","390","2024-12-30"
"31245","2024","COM","2022","181","5","186","2024-12-30"
"31246","2024","COM","2022","872","16","888","2024-12-30"
"31247","2024","COM","2022","1287","30","1317","2024-12-30"
"31248","2024","COM","2022","6467","116","6583","2024-12-30"
"31249","2024","COM","2022","1229","26","1255","2024-12-30"
"31250","2024","COM","2022","682","17","699","2024-12-30"
"31251","2024","COM","2022","151","1","152","2024-12-30"
"31252","2024","COM","2022","1946","48","1994","2024-12-30"
"31253","2024","COM","2022","2946","42","2988","2024-12-30"
"31254","2024","COM","2022","4316","131","4447","2024-12-30"
"31255","2024","COM","2022","323","8","331","2024-12-30"
"31256","2024","COM","2022","305","2","307","2024-12-30"
"31258","2024","COM","2022","244","6","250","2024-12-30"
"31259","2024","COM","2022","2047","36","2083","2024-12-30"
"31260","2024","COM","2022","95","1","96","2024-12-30"
"31261","2024","COM","2022","1156","44","1200","2024-12-30"
"31262","2024","COM","2022","438","11","449","2024-12-30"
"31263","2024","COM","2022","3304","60","3364","2024-12-30"
"31264","2024","COM","2022","555","7","562","2024-12-30"
"31265","2024","COM","2022","283","7","290","2024-12-30"
"31266","2024","COM","2022","205","2","207","2024-12-30"
"31267","2024","COM","2022","53","4","57","2024-12-30"
"31268","2024","COM","2022","137","2","139","2024-12-30"
"31269","2024","COM","2022","1655","26","1681","2024-12-30"
"31270","2024","COM","2022","1028","28","1056","2024-12-30"
"31271","2024","COM","2022","2269","43","2312","2024-12-30"
"31272","2024","COM","2022","59","3","62","2024-12-30"
"31273","2024","COM","2022","2983","72","3055","2024-12-30"
"31274","2024","COM","2022","180","5","185","2024-12-30"
"31275","2024","COM","2022","159","5","164","2024-12-30"
"31276","2024","COM","2022","292","3","295","2024-12-30"
"31277","2024","COM","2022","1590","35","1625","2024-12-30"
"31278","2024","COM","2022","306","4","310","2024-12-30"
"31279","2024","COM","2022","80","1","81","2024-12-30"
"31280","2024","COM","2022","437","12","449","2024-12-30"
"31281","2024","COM","2022","1305","34","1339","2024-12-30"
"31282","2024","COM","2022","9216","79","9295","2024-12-30"
"31283","2024","COM","2022","247","3","250","2024-12-30"
"31284","2024","COM","2022","1606","46","1652","2024-12-30"
"31285","2024","COM","2022","798","14","812","2024-12-30"
"31286","2024","COM","2022","657","7","664","2024-12-30"
"31287","2024","COM","2022","3665","99","3764","2024-12-30"
"31288","2024","COM","2022","312","10","322","2024-12-30"
"31289","2024","COM","2022","260","3","263","2024-12-30"
"31290","2024","COM","2022","33","2","35","2024-12-30"
"31291","2024","COM","2022","9710","218","9928","2024-12-30"
"31292","2024","COM","2022","74","4","78","2024-12-30"
"31293","2024","COM","2022","3032","22","3054","2024-12-30"
"31294","2024","COM","2022","79","1","80","2024-12-30"
"31295","2024","COM","2022","79","0","79","2024-12-30"
"31296","2024","COM","2022","434","10","444","2024-12-30"
"31297","2024","COM","2022","2206","60","2266","2024-12-30"
"31299","2024","COM","2022","3849","71","3920","2024-12-30"
"31300","2024","COM","2022","126","3","129","2024-12-30"
"31301","2024","COM","2022","136","1","137","2024-12-30"
"31302","2024","COM","2022","303","6","309","2024-12-30"
"31303","2024","COM","2022","3336","61","3397","2024-12-30"
"31304","2024","COM","2022","454","12","466","2024-12-30"
"31305","2024","COM","2022","194","5","199","2024-12-30"
"31306","2024","COM","2022","113","1","114","2024-12-30"
"31308","2024","COM","2022","45","0","45","2024-12-30"
"31309","2024","COM","2022","238","2","240","2024-12-30"
"31310","2024","COM","2022","341","9","350","2024-12-30"
"31311","2024","COM","2022","1226","23","1249","2024-12-30"
"31312","2024","COM","2022","35","1","36","2024-12-30"
"31313","2024","COM","2022","111","3","114","2024-12-30"
"31314","2024","COM","2022","379","8","387","2024-12-30"
"31315","2024","COM","2022","961","46","1007","2024-12-30"
"31316","2024","COM","2022","488","6","494","2024-12-30"
"31317","2024","COM","2022","476","10","486","2024-12-30"
"31318","2024","COM","2022","199","5","204","2024-12-30"
"31319","2024","COM","2022","132","1","133","2024-12-30"
"31320","2024","COM","2022","976","23","999","2024-12-30"
"31321","2024","COM","2022","141","6","147","2024-12-30"
"31322","2024","COM","2022","66","2","68","2024-12-30"
"31323","2024","COM","2022","418","13","431","2024-12-30"
"31324","2024","COM","2022","2388","44","2432","2024-12-30"
"31325","2024","COM","2022","181","5","186","2024-12-30"
"31326","2024","COM","2022","121","2","123","2024-12-30"
"31327","2024","COM","2022","203","1","204","2024-12-30"
"31328","2024","COM","2022","333","13","346","2024-12-30"
"31329","2024","COM","2022","207","3","210","2024-12-30"
"31330","2024","COM","2022","498","12","510","2024-12-30"
"31331","2024","COM","2022","295","12","307","2024-12-30"
"31332","2024","COM","2022","221","4","225","2024-12-30"
"31333","2024","COM","2022","85","3","88","2024-12-30"
"31334","2024","COM","2022","1343","28","1371","2024-12-30"
"31335","2024","COM","2022","30","0","30","2024-12-30"
"31336","2024","COM","2022","631","14","645","2024-12-30"
"31337","2024","COM","2022","85","0","85","2024-12-30"
"31338","2024","COM","2022","799","23","822","2024-12-30"
"31339","2024","COM","2022","480","13","493","2024-12-30"
"31340","2024","COM","2022","299","7","306","2024-12-30"
"31341","2024","COM","2022","6640","93","6733","2024-12-30"
"31342","2024","COM","2022","191","3","194","2024-12-30"
"31343","2024","COM","2022","62","1","63","2024-12-30"
"31344","2024","COM","2022","743","13","756","2024-12-30"
"31345","2024","COM","2022","2787","43","2830","2024-12-30"
"31346","2024","COM","2022","1132","22","1154","2024-12-30"
"31347","2024","COM","2022","164","3","167","2024-12-30"
"31348","2024","COM","2022","36","0","36","2024-12-30"
"31349","2024","COM","2022","899","17","916","2024-12-30"
"31350","2024","COM","2022","81","0","81","2024-12-30"
"31351","2024","COM","2022","6003","110","6113","2024-12-30"
"31352","2024","COM","2022","213","11","224","2024-12-30"
"31353","2024","COM","2022","88","0","88","2024-12-30"
"31354","2024","COM","2022","53","1","54","2024-12-30"
"31355","2024","COM","2022","1851","44","1895","2024-12-30"
"31356","2024","COM","2022","1946","49","1995","2024-12-30"
"31357","2024","COM","2022","306","8","314","2024-12-30"
"31358","2024","COM","2022","3719","108","3827","2024-12-30"
"31359","2024","COM","2022","63","2","65","2024-12-30"
"31360","2024","COM","2022","506","13","519","2024-12-30"
"31361","2024","COM","2022","557","15","572","2024-12-30"
"31362","2024","COM","2022","195","6","201","2024-12-30"
"31363","2024","COM","2022","211","5","216","2024-12-30"
"31364","2024","COM","2022","3121","52","3173","2024-12-30"
"31365","2024","COM","2022","581","12","593","2024-12-30"
"31366","2024","COM","2022","711","24","735","2024-12-30"
"31367","2024","COM","2022","75","2","77","2024-12-30"
"31368","2024","COM","2022","245","13","258","2024-12-30"
"31369","2024","COM","2022","26","3","29","2024-12-30"
"31370","2024","COM","2022","128","0","128","2024-12-30"
"31371","2024","COM","2022","407","9","416","2024-12-30"
"31372","2024","COM","2022","466","10","476","2024-12-30"
"31373","2024","COM","2022","171","3","174","2024-12-30"
"31374","2024","COM","2022","1035","20","1055","2024-12-30"
"31375","2024","COM","2022","3083","47","3130","2024-12-30"
"31376","2024","COM","2022","106","3","109","2024-12-30"
"31377","2024","COM","2022","689","9","698","2024-12-30"
"31378","2024","COM","2022","67","3","70","2024-12-30"
"31379","2024","COM","2022","166","2","168","2024-12-30"
"31380","2024","COM","2022","555","19","574","2024-12-30"
"31381","2024","COM","2022","2586","51","2637","2024-12-30"
"31382","2024","COM","2022","115","3","118","2024-12-30"
"31383","2024","COM","2022","1262","25","1287","2024-12-30"
"31384","2024","COM","2022","1791","37","1828","2024-12-30"
"31385","2024","COM","2022","192","2","194","2024-12-30"
"31386","2024","COM","2022","223","6","229","2024-12-30"
"31387","2024","COM","2022","130","0","130","2024-12-30"
"31388","2024","COM","2022","341","12","353","2024-12-30"
"31389","2024","COM","2022","4322","56","4378","2024-12-30"
"31390","2024","COM","2022","2676","23","2699","2024-12-30"
"31391","2024","COM","2022","455","23","478","2024-12-30"
"31392","2024","COM","2022","80","4","84","2024-12-30"
"31393","2024","COM","2022","170","5","175","2024-12-30"
"31394","2024","COM","2022","127","4","131","2024-12-30"
"31395","2024","COM","2022","25653","570","26223","2024-12-30"
"31396","2024","COM","2022","4146","67","4213","2024-12-30"
"31397","2024","COM","2022","50","1","51","2024-12-30"
"31398","2024","COM","2022","100","0","100","2024-12-30"
"31399","2024","COM","2022","2979","63","3042","2024-12-30"
"31400","2024","COM","2022","98","0","98","2024-12-30"
"31401","2024","COM","2022","389","5","394","2024-12-30"
"31402","2024","COM","2022","920","31","951","2024-12-30"
"31403","2024","COM","2022","815","116","931","2024-12-30"
"31404","2024","COM","2022","103","4","107","2024-12-30"
"31405","2024","COM","2022","121","3","124","2024-12-30"
"31406","2024","COM","2022","772","14","786","2024-12-30"
"31407","2024","COM","2022","1250","30","1280","2024-12-30"
"31408","2024","COM","2022","81","1","82","2024-12-30"
"31409","2024","COM","2022","2465","59","2524","2024-12-30"
"31410","2024","COM","2022","4792","92","4884","2024-12-30"
"31411","2024","COM","2022","982","22","1004","2024-12-30"
"31412","2024","COM","2022","255","8","263","2024-12-30"
"31413","2024","COM","2022","542","18","560","2024-12-30"
"31414","2024","COM","2022","83","6","89","2024-12-30"
"31415","2024","COM","2022","81","1","82","2024-12-30"
"31416","2024","COM","2022","687","9","696","2024-12-30"
"31417","2024","COM","2022","8828","209","9037","2024-12-30"
"31418","2024","COM","2022","1029","36","1065","2024-12-30"
"31419","2024","COM","2022","166","6","172","2024-12-30"
"31420","2024","COM","2022","2779","40","2819","2024-12-30"
"31421","2024","COM","2022","4377","76","4453","2024-12-30"
"31422","2024","COM","2022","95","0","95","2024-12-30"
"31423","2024","COM","2022","333","5","338","2024-12-30"
"31424","2024","COM","2022","20471","355","20826","2024-12-30"
"31425","2024","COM","2022","434","9","443","2024-12-30"
"31426","2024","COM","2022","835","10","845","2024-12-30"
"31427","2024","COM","2022","920","19","939","2024-12-30"
"31428","2024","COM","2022","64","5","69","2024-12-30"
"31429","2024","COM","2022","2203","46","2249","2024-12-30"
"31430","2024","COM","2022","622","16","638","2024-12-30"
"31431","2024","COM","2022","62","0","62","2024-12-30"
"31432","2024","COM","2022","38","0","38","2024-12-30"
"31433","2024","COM","2022","9798","129","9927","2024-12-30"
"31434","2024","COM","2022","79","4","83","2024-12-30"
"31435","2024","COM","2022","968","14","982","2024-12-30"
"31436","2024","COM","2022","432","4","436","2024-12-30"
"31437","2024","COM","2022","87","4","91","2024-12-30"
"31439","2024","COM","2022","765","18","783","2024-12-30"
"31440","2024","COM","2022","64","0","64","2024-12-30"
"31441","2024","COM","2022","149","4","153","2024-12-30"
"31442","2024","COM","2022","573","10","583","2024-12-30"
"31443","2024","COM","2022","310","7","317","2024-12-30"
"31444","2024","COM","2022","138","4","142","2024-12-30"
"31445","2024","COM","2022","6059","90","6149","2024-12-30"
"31446","2024","COM","2022","15172","264","15436","2024-12-30"
"31447","2024","COM","2022","31","1","32","2024-12-30"
"31448","2024","COM","2022","493","7","500","2024-12-30"
"31449","2024","COM","2022","131","4","135","2024-12-30"
"31450","2024","COM","2022","539","13","552","2024-12-30"
"31451","2024","COM","2022","9686","295","9981","2024-12-30"
"31452","2024","COM","2022","55","1","56","2024-12-30"
"31453","2024","COM","2022","137","5","142","2024-12-30"
"31454","2024","COM","2022","3564","76","3640","2024-12-30"
"31455","2024","COM","2022","2625","52","2677","2024-12-30"
"31456","2024","COM","2022","55","1","56","2024-12-30"
"31457","2024","COM","2022","799","12","811","2024-12-30"
"31458","2024","COM","2022","5295","57","5352","2024-12-30"
"31459","2024","COM","2022","882","14","896","2024-12-30"
"31460","2024","COM","2022","4292","70","4362","2024-12-30"
"31461","2024","COM","2022","289","3","292","2024-12-30"
"31462","2024","COM","2022","2186","39","2225","2024-12-30"
"31463","2024","COM","2022","244","4","248","2024-12-30"
"31464","2024","COM","2022","333","8","341","2024-12-30"
"31465","2024","COM","2022","22","0","22","2024-12-30"
"31466","2024","COM","2022","798","17","815","2024-12-30"
"31467","2024","COM","2022","6447","52","6499","2024-12-30"
"31468","2024","COM","2022","241","6","247","2024-12-30"
"31469","2024","COM","2022","125","2","127","2024-12-30"
"31470","2024","COM","2022","63","1","64","2024-12-30"
"31471","2024","COM","2022","385","4","389","2024-12-30"
"31472","2024","COM","2022","233","6","239","2024-12-30"
"31473","2024","COM","2022","443","9","452","2024-12-30"
"31474","2024","COM","2022","236","4","240","2024-12-30"
"31475","2024","COM","2022","1664","33","1697","2024-12-30"
"31476","2024","COM","2022","927","21","948","2024-12-30"
"31477","2024","COM","2022","47","0","47","2024-12-30"
"31478","2024","COM","2022","1255","26","1281","2024-12-30"
"31479","2024","COM","2022","60","0","60","2024-12-30"
"31480","2024","COM","2022","2512","41","2553","2024-12-30"
"31481","2024","COM","2022","2093","46","2139","2024-12-30"
"31482","2024","COM","2022","205","3","208","2024-12-30"
"31483","2024","COM","2022","11869","514","12383","2024-12-30"
"31484","2024","COM","2022","2492","60","2552","2024-12-30"
"31485","2024","COM","2022","120","2","122","2024-12-30"
"31486","2024","COM","2022","1726","25","1751","2024-12-30"
"31487","2024","COM","2022","222","4","226","2024-12-30"
"31488","2024","COM","2022","11239","167","11406","2024-12-30"
"31489","2024","COM","2022","430","8","438","2024-12-30"
"31490","2024","COM","2022","7996","88","8084","2024-12-30"
"31491","2024","COM","2022","417","11","428","2024-12-30"
"31492","2024","COM","2022","552","6","558","2024-12-30"
"31493","2024","COM","2022","127","6","133","2024-12-30"
"31494","2024","COM","2022","177","3","180","2024-12-30"
"31495","2024","COM","2022","1284","29","1313","2024-12-30"
"31496","2024","COM","2022","256","6","262","2024-12-30"
"31497","2024","COM","2022","2343","51","2394","2024-12-30"
"31498","2024","COM","2022","38","0","38","2024-12-30"
"31499","2024","COM","2022","9776","188","9964","2024-12-30"
"31500","2024","COM","2022","552","17","569","2024-12-30"
"31501","2024","COM","2022","481","10","491","2024-12-30"
"31502","2024","COM","2022","370","8","378","2024-12-30"
"31503","2024","COM","2022","1039","16","1055","2024-12-30"
"31504","2024","COM","2022","224","13","237","2024-12-30"
"31505","2024","COM","2022","310","5","315","2024-12-30"
"31506","2024","COM","2022","14229","238","14467","2024-12-30"
"31507","2024","COM","2022","1749","19","1768","2024-12-30"
"31508","2024","COM","2022","42","1","43","2024-12-30"
"31509","2024","COM","2022","166","3","169","2024-12-30"
"31510","2024","COM","2022","144","1","145","2024-12-30"
"31511","2024","COM","2022","261","6","267","2024-12-30"
"31512","2024","COM","2022","887","28","915","2024-12-30"
"31513","2024","COM","2022","395","8","403","2024-12-30"
"31514","2024","COM","2022","58","1","59","2024-12-30"
"31515","2024","COM","2022","429","9","438","2024-12-30"
"31516","2024","COM","2022","2235","38","2273","2024-12-30"
"31517","2024","COM","2022","2288","63","2351","2024-12-30"
"31518","2024","COM","2022","614","12","626","2024-12-30"
"31519","2024","COM","2022","213","6","219","2024-12-30"
"31520","2024","COM","2022","105","3","108","2024-12-30"
"31521","2024","COM","2022","337","14","351","2024-12-30"
"31522","2024","COM","2022","64","1","65","2024-12-30"
"31523","2024","COM","2022","1737","100","1837","2024-12-30"
"31524","2024","COM","2022","127","2","129","2024-12-30"
"31525","2024","COM","2022","591","13","604","2024-12-30"
"31526","2024","COM","2022","8477","199","8676","2024-12-30"
"31527","2024","COM","2022","149","3","152","2024-12-30"
"31528","2024","COM","2022","145","1","146","2024-12-30"
"31529","2024","COM","2022","110","2","112","2024-12-30"
"31530","2024","COM","2022","239","9","248","2024-12-30"
"31531","2024","COM","2022","72","1","73","2024-12-30"
"31532","2024","COM","2022","90","0","90","2024-12-30"
"31533","2024","COM","2022","2351","58","2409","2024-12-30"
"31534","2024","COM","2022","215","2","217","2024-12-30"
"31535","2024","COM","2022","704","16","720","2024-12-30"
"31536","2024","COM","2022","241","8","249","2024-12-30"
"31537","2024","COM","2022","195","4","199","2024-12-30"
"31538","2024","COM","2022","213","1","214","2024-12-30"
"31539","2024","COM","2022","65","2","67","2024-12-30"
"31540","2024","COM","2022","336","10","346","2024-12-30"
"31541","2024","COM","2022","3311","78","3389","2024-12-30"
"31542","2024","COM","2022","209","8","217","2024-12-30"
"31543","2024","COM","2022","118","3","121","2024-12-30"
"31544","2024","COM","2022","225","2","227","2024-12-30"
"31545","2024","COM","2022","200","5","205","2024-12-30"
"31546","2024","COM","2022","127","2","129","2024-12-30"
"31547","2024","COM","2022","10167","108","10275","2024-12-30"
"31548","2024","COM","2022","41","0","41","2024-12-30"
"31549","2024","COM","2022","20","1","21","2024-12-30"
"31550","2024","COM","2022","517","15","532","2024-12-30"
"31551","2024","COM","2022","596","18","614","2024-12-30"
"31552","2024","COM","2022","139","3","142","2024-12-30"
"31553","2024","COM","2022","1121","23","1144","2024-12-30"
"31554","2024","COM","2022","248","6","254","2024-12-30"
"31555","2024","COM","2022","511684","5051","516735","2024-12-30"
"31556","2024","COM","2022","380","9","389","2024-12-30"
"31557","2024","COM","2022","29724","629","30353","2024-12-30"
"31558","2024","COM","2022","430","8","438","2024-12-30"
"31559","2024","COM","2022","8","0","8","2024-12-30"
"31560","2024","COM","2022","493","13","506","2024-12-30"
"31561","2024","COM","2022","12410","178","12588","2024-12-30"
"31562","2024","COM","2022","116","1","117","2024-12-30"
"31563","2024","COM","2022","1440","32","1472","2024-12-30"
"31564","2024","COM","2022","150","4","154","2024-12-30"
"31565","2024","COM","2022","875","14","889","2024-12-30"
"31566","2024","COM","2022","505","4","509","2024-12-30"
"31567","2024","COM","2022","439","6","445","2024-12-30"
"31568","2024","COM","2022","256","7","263","2024-12-30"
"31569","2024","COM","2022","385","10","395","2024-12-30"
"31570","2024","COM","2022","308","5","313","2024-12-30"
"31571","2024","COM","2022","276","10","286","2024-12-30"
"31572","2024","COM","2022","2898","80","2978","2024-12-30"
"31573","2024","COM","2022","3867","65","3932","2024-12-30"
"31574","2024","COM","2022","3294","52","3346","2024-12-30"
"31575","2024","COM","2022","1224","28","1252","2024-12-30"
"31576","2024","COM","2022","349","14","363","2024-12-30"
"31577","2024","COM","2022","157","5","162","2024-12-30"
"31578","2024","COM","2022","1021","34","1055","2024-12-30"
"31579","2024","COM","2022","879","14","893","2024-12-30"
"31580","2024","COM","2022","1187","18","1205","2024-12-30"
"31581","2024","COM","2022","1649","33","1682","2024-12-30"
"31582","2024","COM","2022","5054","73","5127","2024-12-30"
"31583","2024","COM","2022","1116","25","1141","2024-12-30"
"31584","2024","COM","2022","6235","79","6314","2024-12-30"
"31585","2024","COM","2022","1732","32","1764","2024-12-30"
"31586","2024","COM","2022","570","4","574","2024-12-30"
"31587","2024","COM","2022","1687","13","1700","2024-12-30"
"31588","2024","COM","2022","10704","121","10825","2024-12-30"
"31589","2024","COM","2022","1470","30","1500","2024-12-30"
"31590","2024","COM","2022","42","1","43","2024-12-30"
"31591","2024","COM","2022","77","1","78","2024-12-30"
"31592","2024","COM","2022","2249","40","2289","2024-12-30"
"31593","2024","COM","2022","78","1","79","2024-12-30"
"32001","2024","COM","2022","722","48","770","2024-12-30"
"32002","2024","COM","2022","74","5","79","2024-12-30"
"32003","2024","COM","2022","41","3","44","2024-12-30"
"32004","2024","COM","2022","131","3","134","2024-12-30"
"32005","2024","COM","2022","319","11","330","2024-12-30"
"32007","2024","COM","2022","219","5","224","2024-12-30"
"32008","2024","COM","2022","71","0","71","2024-12-30"
"32009","2024","COM","2022","95","1","96","2024-12-30"
"32010","2024","COM","2022","86","0","86","2024-12-30"
"32012","2024","COM","2022","1127","28","1155","2024-12-30"
"32013","2024","COM","2022","22825","1018","23843","2024-12-30"
"32014","2024","COM","2022","126","2","128","2024-12-30"
"32015","2024","COM","2022","90","1","91","2024-12-30"
"32016","2024","COM","2022","676","16","692","2024-12-30"
"32017","2024","COM","2022","132","4","136","2024-12-30"
"32018","2024","COM","2022","215","3","218","2024-12-30"
"32019","2024","COM","2022","530","16","546","2024-12-30"
"32020","2024","COM","2022","272","5","277","2024-12-30"
"32021","2024","COM","2022","73","0","73","2024-12-30"
"32022","2024","COM","2022","182","7","189","2024-12-30"
"32023","2024","COM","2022","87","2","89","2024-12-30"
"32024","2024","COM","2022","157","2","159","2024-12-30"
"32025","2024","COM","2022","159","2","161","2024-12-30"
"32026","2024","COM","2022","108","1","109","2024-12-30"
"32027","2024","COM","2022","1378","21","1399","2024-12-30"
"32028","2024","COM","2022","104","3","107","2024-12-30"
"32029","2024","COM","2022","673","14","687","2024-12-30"
"32030","2024","COM","2022","124","3","127","2024-12-30"
"32031","2024","COM","2022","171","2","173","2024-12-30"
"32032","2024","COM","2022","331","10","341","2024-12-30"
"32033","2024","COM","2022","103","1","104","2024-12-30"
"32034","2024","COM","2022","62","0","62","2024-12-30"
"32035","2024","COM","2022","246","1","247","2024-12-30"
"32036","2024","COM","2022","679","30","709","2024-12-30"
"32037","2024","COM","2022","125","7","132","2024-12-30"
"32038","2024","COM","2022","212","8","220","2024-12-30"
"32039","2024","COM","2022","122","3","125","2024-12-30"
"32040","2024","COM","2022","133","1","134","2024-12-30"
"32041","2024","COM","2022","159","4","163","2024-12-30"
"32042","2024","COM","2022","137","5","142","2024-12-30"
"32043","2024","COM","2022","150","1","151","2024-12-30"
"32044","2024","COM","2022","296","9","305","2024-12-30"
"32045","2024","COM","2022","421","12","433","2024-12-30"
"32046","2024","COM","2022","186","6","192","2024-12-30"
"32047","2024","COM","2022","114","1","115","2024-12-30"
"32048","2024","COM","2022","91","0","91","2024-12-30"
"32049","2024","COM","2022","72","3","75","2024-12-30"
"32050","2024","COM","2022","101","3","104","2024-12-30"
"32051","2024","COM","2022","106","6","112","2024-12-30"
"32052","2024","COM","2022","132","3","135","2024-12-30"
"32053","2024","COM","2022","185","0","185","2024-12-30"
"32054","2024","COM","2022","377","12","389","2024-12-30"
"32055","2024","COM","2022","119","2","121","2024-12-30"
"32056","2024","COM","2022","43","4","47","2024-12-30"
"32057","2024","COM","2022","128","2","130","2024-12-30"
"32058","2024","COM","2022","34","2","36","2024-12-30"
"32059","2024","COM","2022","116","0","116","2024-12-30"
"32060","2024","COM","2022","205","3","208","2024-12-30"
"32061","2024","COM","2022","179","3","182","2024-12-30"
"32062","2024","COM","2022","167","4","171","2024-12-30"
"32063","2024","COM","2022","163","8","171","2024-12-30"
"32064","2024","COM","2022","400","11","411","2024-12-30"
"32065","2024","COM","2022","236","5","241","2024-12-30"
"32066","2024","COM","2022","255","2","257","2024-12-30"
"32067","2024","COM","2022","48","1","49","2024-12-30"
"32068","2024","COM","2022","145","4","149","2024-12-30"
"32069","2024","COM","2022","78","0","78","2024-12-30"
"32070","2024","COM","2022","198","3","201","2024-12-30"
"32071","2024","COM","2022","166","8","174","2024-12-30"
"32072","2024","COM","2022","53","1","54","2024-12-30"
"32073","2024","COM","2022","212","4","216","2024-12-30"
"32075","2024","COM","2022","227","3","230","2024-12-30"
"32076","2024","COM","2022","579","13","592","2024-12-30"
"32077","2024","COM","2022","91","1","92","2024-12-30"
"32078","2024","COM","2022","226","9","235","2024-12-30"
"32079","2024","COM","2022","1185","22","1207","2024-12-30"
"32080","2024","COM","2022","147","2","149","2024-12-30"
"32081","2024","COM","2022","116","4","120","2024-12-30"
"32082","2024","COM","2022","337","11","348","2024-12-30"
"32083","2024","COM","2022","1042","23","1065","2024-12-30"
"32084","2024","COM","2022","52","2","54","2024-12-30"
"32085","2024","COM","2022","174","6","180","2024-12-30"
"32086","2024","COM","2022","76","0","76","2024-12-30"
"32087","2024","COM","2022","141","3","144","2024-12-30"
"32088","2024","COM","2022","333","1","334","2024-12-30"
"32089","2024","COM","2022","225","6","231","2024-12-30"
"32090","2024","COM","2022","335","8","343","2024-12-30"
"32091","2024","COM","2022","345","12","357","2024-12-30"
"32092","2024","COM","2022","105","1","106","2024-12-30"
"32093","2024","COM","2022","103","3","106","2024-12-30"
"32094","2024","COM","2022","446","11","457","2024-12-30"
"32095","2024","COM","2022","587","15","602","2024-12-30"
"32096","2024","COM","2022","1663","37","1700","2024-12-30"
"32097","2024","COM","2022","112","5","117","2024-12-30"
"32098","2024","COM","2022","329","14","343","2024-12-30"
"32099","2024","COM","2022","72","1","73","2024-12-30"
"32100","2024","COM","2022","170","5","175","2024-12-30"
"32101","2024","COM","2022","229","4","233","2024-12-30"
"32102","2024","COM","2022","203","4","207","2024-12-30"
"32103","2024","COM","2022","173","6","179","2024-12-30"
"32104","2024","COM","2022","159","3","162","2024-12-30"
"32105","2024","COM","2022","402","18","420","2024-12-30"
"32106","2024","COM","2022","920","67","987","2024-12-30"
"32107","2024","COM","2022","6454","184","6638","2024-12-30"
"32108","2024","COM","2022","156","4","160","2024-12-30"
"32109","2024","COM","2022","203","7","210","2024-12-30"
"32110","2024","COM","2022","394","6","400","2024-12-30"
"32111","2024","COM","2022","46","0","46","2024-12-30"
"32112","2024","COM","2022","261","4","265","2024-12-30"
"32113","2024","COM","2022","93","2","95","2024-12-30"
"32114","2024","COM","2022","125","2","127","2024-12-30"
"32115","2024","COM","2022","318","4","322","2024-12-30"
"32116","2024","COM","2022","131","5","136","2024-12-30"
"32117","2024","COM","2022","857","28","885","2024-12-30"
"32118","2024","COM","2022","136","4","140","2024-12-30"
"32119","2024","COM","2022","4060","69","4129","2024-12-30"
"32120","2024","COM","2022","444","7","451","2024-12-30"
"32121","2024","COM","2022","516","16","532","2024-12-30"
"32122","2024","COM","2022","345","13","358","2024-12-30"
"32123","2024","COM","2022","570","12","582","2024-12-30"
"32124","2024","COM","2022","186","6","192","2024-12-30"
"32125","2024","COM","2022","132","3","135","2024-12-30"
"32126","2024","COM","2022","162","1","163","2024-12-30"
"32127","2024","COM","2022","664","14","678","2024-12-30"
"32128","2024","COM","2022","206","5","211","2024-12-30"
"32129","2024","COM","2022","122","0","122","2024-12-30"
"32130","2024","COM","2022","215","2","217","2024-12-30"
"32131","2024","COM","2022","136","3","139","2024-12-30"
"32132","2024","COM","2022","6130","89","6219","2024-12-30"
"32133","2024","COM","2022","261","4","265","2024-12-30"
"32134","2024","COM","2022","359","4","363","2024-12-30"
"32135","2024","COM","2022","130","3","133","2024-12-30"
"32136","2024","COM","2022","184","4","188","2024-12-30"
"32138","2024","COM","2022","148","4","152","2024-12-30"
"32139","2024","COM","2022","106","1","107","2024-12-30"
"32140","2024","COM","2022","75","3","78","2024-12-30"
"32141","2024","COM","2022","119","0","119","2024-12-30"
"32142","2024","COM","2022","138","3","141","2024-12-30"
"32143","2024","COM","2022","245","10","255","2024-12-30"
"32144","2024","COM","2022","69","0","69","2024-12-30"
"32145","2024","COM","2022","44","2","46","2024-12-30"
"32146","2024","COM","2022","285","4","289","2024-12-30"
"32147","2024","COM","2022","3110","72","3182","2024-12-30"
"32148","2024","COM","2022","91","1","92","2024-12-30"
"32149","2024","COM","2022","1179","22","1201","2024-12-30"
"32150","2024","COM","2022","213","7","220","2024-12-30"
"32151","2024","COM","2022","63","2","65","2024-12-30"
"32152","2024","COM","2022","353","14","367","2024-12-30"
"32153","2024","COM","2022","152","6","158","2024-12-30"
"32154","2024","COM","2022","111","1","112","2024-12-30"
"32155","2024","COM","2022","1186","39","1225","2024-12-30"
"32156","2024","COM","2022","214","4","218","2024-12-30"
"32157","2024","COM","2022","187","3","190","2024-12-30"
"32158","2024","COM","2022","248","4","252","2024-12-30"
"32159","2024","COM","2022","543","15","558","2024-12-30"
"32160","2024","COM","2022","9499","234","9733","2024-12-30"
"32161","2024","COM","2022","86","3","89","2024-12-30"
"32162","2024","COM","2022","1182","37","1219","2024-12-30"
"32163","2024","COM","2022","283","8","291","2024-12-30"
"32164","2024","COM","2022","116","1","117","2024-12-30"
"32165","2024","COM","2022","229","4","233","2024-12-30"
"32166","2024","COM","2022","107","5","112","2024-12-30"
"32167","2024","COM","2022","318","5","323","2024-12-30"
"32169","2024","COM","2022","147","4","151","2024-12-30"
"32170","2024","COM","2022","146","3","149","2024-12-30"
"32171","2024","COM","2022","187","2","189","2024-12-30"
"32172","2024","COM","2022","291","9","300","2024-12-30"
"32173","2024","COM","2022","213","8","221","2024-12-30"
"32174","2024","COM","2022","220","4","224","2024-12-30"
"32175","2024","COM","2022","214","6","220","2024-12-30"
"32176","2024","COM","2022","123","7","130","2024-12-30"
"32177","2024","COM","2022","167","5","172","2024-12-30"
"32178","2024","COM","2022","78","2","80","2024-12-30"
"32180","2024","COM","2022","559","10","569","2024-12-30"
"32181","2024","COM","2022","248","2","250","2024-12-30"
"32182","2024","COM","2022","181","6","187","2024-12-30"
"32183","2024","COM","2022","233","13","246","2024-12-30"
"32184","2024","COM","2022","132","3","135","2024-12-30"
"32185","2024","COM","2022","149","2","151","2024-12-30"
"32186","2024","COM","2022","80","1","81","2024-12-30"
"32187","2024","COM","2022","130","3","133","2024-12-30"
"32188","2024","COM","2022","80","4","84","2024-12-30"
"32189","2024","COM","2022","105","3","108","2024-12-30"
"32190","2024","COM","2022","532","7","539","2024-12-30"
"32191","2024","COM","2022","145","0","145","2024-12-30"
"32192","2024","COM","2022","220","5","225","2024-12-30"
"32193","2024","COM","2022","237","9","246","2024-12-30"
"32194","2024","COM","2022","213","5","218","2024-12-30"
"32195","2024","COM","2022","45","1","46","2024-12-30"
"32196","2024","COM","2022","161","2","163","2024-12-30"
"32197","2024","COM","2022","218","7","225","2024-12-30"
"32198","2024","COM","2022","196","4","200","2024-12-30"
"32199","2024","COM","2022","180","5","185","2024-12-30"
"32200","2024","COM","2022","350","11","361","2024-12-30"
"32201","2024","COM","2022","336","15","351","2024-12-30"
"32202","2024","COM","2022","290","5","295","2024-12-30"
"32203","2024","COM","2022","247","3","250","2024-12-30"
"32204","2024","COM","2022","365","10","375","2024-12-30"
"32205","2024","COM","2022","102","1","103","2024-12-30"
"32206","2024","COM","2022","230","2","232","2024-12-30"
"32207","2024","COM","2022","344","12","356","2024-12-30"
"32208","2024","COM","2022","3685","337","4022","2024-12-30"
"32209","2024","COM","2022","276","8","284","2024-12-30"
"32210","2024","COM","2022","778","14","792","2024-12-30"
"32211","2024","COM","2022","202","3","205","2024-12-30"
"32212","2024","COM","2022","206","4","210","2024-12-30"
"32213","2024","COM","2022","2188","34","2222","2024-12-30"
"32214","2024","COM","2022","111","5","116","2024-12-30"
"32215","2024","COM","2022","161","6","167","2024-12-30"
"32216","2024","COM","2022","156","4","160","2024-12-30"
"32217","2024","COM","2022","61","3","64","2024-12-30"
"32218","2024","COM","2022","73","1","74","2024-12-30"
"32219","2024","COM","2022","310","11","321","2024-12-30"
"32220","2024","COM","2022","132","3","135","2024-12-30"
"32221","2024","COM","2022","226","10","236","2024-12-30"
"32222","2024","COM","2022","231","8","239","2024-12-30"
"32223","2024","COM","2022","58","33","91","2024-12-30"
"32224","2024","COM","2022","215","3","218","2024-12-30"
"32225","2024","COM","2022","97","5","102","2024-12-30"
"32226","2024","COM","2022","83","5","88","2024-12-30"
"32227","2024","COM","2022","761","19","780","2024-12-30"
"32228","2024","COM","2022","87","1","88","2024-12-30"
"32229","2024","COM","2022","58","7","65","2024-12-30"
"32230","2024","COM","2022","45","0","45","2024-12-30"
"32231","2024","COM","2022","424","9","433","2024-12-30"
"32232","2024","COM","2022","46","1","47","2024-12-30"
"32233","2024","COM","2022","1209","79","1288","2024-12-30"
"32234","2024","COM","2022","349","7","356","2024-12-30"
"32235","2024","COM","2022","159","6","165","2024-12-30"
"32236","2024","COM","2022","56","4","60","2024-12-30"
"32237","2024","COM","2022","464","9","473","2024-12-30"
"32238","2024","COM","2022","83","0","83","2024-12-30"
"32239","2024","COM","2022","442","11","453","2024-12-30"
"32240","2024","COM","2022","59","2","61","2024-12-30"
"32241","2024","COM","2022","169","6","175","2024-12-30"
"32242","2024","COM","2022","1525","398","1923","2024-12-30"
"32243","2024","COM","2022","266","3","269","2024-12-30"
"32244","2024","COM","2022","157","3","160","2024-12-30"
"32245","2024","COM","2022","143","1","144","2024-12-30"
"32246","2024","COM","2022","198","3","201","2024-12-30"
"32247","2024","COM","2022","302","15","317","2024-12-30"
"32248","2024","COM","2022","141","4","145","2024-12-30"
"32249","2024","COM","2022","2275","51","2326","2024-12-30"
"32250","2024","COM","2022","76","3","79","2024-12-30"
"32251","2024","COM","2022","68","0","68","2024-12-30"
"32252","2024","COM","2022","1132","15","1147","2024-12-30"
"32253","2024","COM","2022","532","12","544","2024-12-30"
"32254","2024","COM","2022","351","8","359","2024-12-30"
"32255","2024","COM","2022","144","5","149","2024-12-30"
"32256","2024","COM","2022","3442","287","3729","2024-12-30"
"32257","2024","COM","2022","64","2","66","2024-12-30"
"32258","2024","COM","2022","229","5","234","2024-12-30"
"32260","2024","COM","2022","69","5","74","2024-12-30"
"32261","2024","COM","2022","391","7","398","2024-12-30"
"32262","2024","COM","2022","405","20","425","2024-12-30"
"32263","2024","COM","2022","124","3","127","2024-12-30"
"32264","2024","COM","2022","225","4","229","2024-12-30"
"32265","2024","COM","2022","111","2","113","2024-12-30"
"32266","2024","COM","2022","147","1","148","2024-12-30"
"32267","2024","COM","2022","107","2","109","2024-12-30"
"32268","2024","COM","2022","802","19","821","2024-12-30"
"32269","2024","COM","2022","513","7","520","2024-12-30"
"32270","2024","COM","2022","90","1","91","2024-12-30"
"32271","2024","COM","2022","286","10","296","2024-12-30"
"32272","2024","COM","2022","162","3","165","2024-12-30"
"32273","2024","COM","2022","162","10","172","2024-12-30"
"32274","2024","COM","2022","188","1","189","2024-12-30"
"32275","2024","COM","2022","38","2","40","2024-12-30"
"32276","2024","COM","2022","66","1","67","2024-12-30"
"32277","2024","COM","2022","109","3","112","2024-12-30"
"32278","2024","COM","2022","123","2","125","2024-12-30"
"32279","2024","COM","2022","714","19","733","2024-12-30"
"32280","2024","COM","2022","91","1","92","2024-12-30"
"32281","2024","COM","2022","106","5","111","2024-12-30"
"32282","2024","COM","2022","588","19","607","2024-12-30"
"32283","2024","COM","2022","279","6","285","2024-12-30"
"32284","2024","COM","2022","69","1","70","2024-12-30"
"32285","2024","COM","2022","569","17","586","2024-12-30"
"32286","2024","COM","2022","700","14","714","2024-12-30"
"32287","2024","COM","2022","82","2","84","2024-12-30"
"32288","2024","COM","2022","138","1","139","2024-12-30"
"32289","2024","COM","2022","242","3","245","2024-12-30"
"32290","2024","COM","2022","1176","20","1196","2024-12-30"
"32291","2024","COM","2022","108","3","111","2024-12-30"
"32292","2024","COM","2022","385","9","394","2024-12-30"
"32293","2024","COM","2022","79","0","79","2024-12-30"
"32294","2024","COM","2022","70","3","73","2024-12-30"
"32295","2024","COM","2022","137","8","145","2024-12-30"
"32296","2024","COM","2022","2226","141","2367","2024-12-30"
"32297","2024","COM","2022","391","12","403","2024-12-30"
"32298","2024","COM","2022","385","8","393","2024-12-30"
"32299","2024","COM","2022","102","0","102","2024-12-30"
"32300","2024","COM","2022","270","4","274","2024-12-30"
"32301","2024","COM","2022","868","23","891","2024-12-30"
"32302","2024","COM","2022","206","7","213","2024-12-30"
"32303","2024","COM","2022","62","0","62","2024-12-30"
"32304","2024","COM","2022","285","8","293","2024-12-30"
"32305","2024","COM","2022","429","7","436","2024-12-30"
"32306","2024","COM","2022","601","42","643","2024-12-30"
"32307","2024","COM","2022","2540","123","2663","2024-12-30"
"32308","2024","COM","2022","100","0","100","2024-12-30"
"32309","2024","COM","2022","107","3","110","2024-12-30"
"32310","2024","COM","2022","105","2","107","2024-12-30"
"32311","2024","COM","2022","335","6","341","2024-12-30"
"32312","2024","COM","2022","659","13","672","2024-12-30"
"32313","2024","COM","2022","138","4","142","2024-12-30"
"32314","2024","COM","2022","70","5","75","2024-12-30"
"32315","2024","COM","2022","149","2","151","2024-12-30"
"32316","2024","COM","2022","114","5","119","2024-12-30"
"32317","2024","COM","2022","64","3","67","2024-12-30"
"32318","2024","COM","2022","95","3","98","2024-12-30"
"32319","2024","COM","2022","1426","26","1452","2024-12-30"
"32320","2024","COM","2022","159","7","166","2024-12-30"
"32321","2024","COM","2022","269","5","274","2024-12-30"
"32322","2024","COM","2022","207","6","213","2024-12-30"
"32323","2024","COM","2022","97","5","102","2024-12-30"
"32324","2024","COM","2022","73","2","75","2024-12-30"
"32325","2024","COM","2022","123","8","131","2024-12-30"
"32326","2024","COM","2022","147","3","150","2024-12-30"
"32327","2024","COM","2022","84","1","85","2024-12-30"
"32328","2024","COM","2022","115","2","117","2024-12-30"
"32329","2024","COM","2022","156","2","158","2024-12-30"
"32330","2024","COM","2022","195","4","199","2024-12-30"
"32331","2024","COM","2022","1217","34","1251","2024-12-30"
"32332","2024","COM","2022","119","1","120","2024-12-30"
"32333","2024","COM","2022","182","4","186","2024-12-30"
"32334","2024","COM","2022","1708","44","1752","2024-12-30"
"32335","2024","COM","2022","428","10","438","2024-12-30"
"32336","2024","COM","2022","159","7","166","2024-12-30"
"32337","2024","COM","2022","73","2","75","2024-12-30"
"32338","2024","COM","2022","185","4","189","2024-12-30"
"32339","2024","COM","2022","250","7","257","2024-12-30"
"32340","2024","COM","2022","290","2","292","2024-12-30"
"32341","2024","COM","2022","247","5","252","2024-12-30"
"32342","2024","COM","2022","47","2","49","2024-12-30"
"32343","2024","COM","2022","164","7","171","2024-12-30"
"32344","2024","COM","2022","1643","118","1761","2024-12-30"
"32345","2024","COM","2022","547","13","560","2024-12-30"
"32346","2024","COM","2022","208","5","213","2024-12-30"
"32347","2024","COM","2022","277","7","284","2024-12-30"
"32348","2024","COM","2022","577","24","601","2024-12-30"
"32349","2024","COM","2022","95","4","99","2024-12-30"
"32350","2024","COM","2022","36","1","37","2024-12-30"
"32351","2024","COM","2022","105","1","106","2024-12-30"
"32352","2024","COM","2022","113","4","117","2024-12-30"
"32353","2024","COM","2022","154","2","156","2024-12-30"
"32354","2024","COM","2022","127","4","131","2024-12-30"
"32355","2024","COM","2022","83","1","84","2024-12-30"
"32356","2024","COM","2022","126","2","128","2024-12-30"
"32357","2024","COM","2022","125","6","131","2024-12-30"
"32358","2024","COM","2022","192","4","196","2024-12-30"
"32359","2024","COM","2022","155","5","160","2024-12-30"
"32360","2024","COM","2022","137","3","140","2024-12-30"
"32361","2024","COM","2022","126","7","133","2024-12-30"
"32362","2024","COM","2022","148","3","151","2024-12-30"
"32363","2024","COM","2022","90","3","93","2024-12-30"
"32364","2024","COM","2022","97","3","100","2024-12-30"
"32365","2024","COM","2022","281","4","285","2024-12-30"
"32366","2024","COM","2022","71","1","72","2024-12-30"
"32367","2024","COM","2022","63","1","64","2024-12-30"
"32368","2024","COM","2022","542","17","559","2024-12-30"
"32369","2024","COM","2022","379","7","386","2024-12-30"
"32370","2024","COM","2022","1052","66","1118","2024-12-30"
"32371","2024","COM","2022","87","4","91","2024-12-30"
"32372","2024","COM","2022","290","9","299","2024-12-30"
"32373","2024","COM","2022","227","4","231","2024-12-30"
"32374","2024","COM","2022","184","5","189","2024-12-30"
"32375","2024","COM","2022","87","4","91","2024-12-30"
"32376","2024","COM","2022","118","4","122","2024-12-30"
"32377","2024","COM","2022","195","7","202","2024-12-30"
"32378","2024","COM","2022","509","6","515","2024-12-30"
"32379","2024","COM","2022","216","4","220","2024-12-30"
"32380","2024","COM","2022","141","9","150","2024-12-30"
"32381","2024","COM","2022","386","10","396","2024-12-30"
"32382","2024","COM","2022","310","14","324","2024-12-30"
"32383","2024","COM","2022","132","4","136","2024-12-30"
"32384","2024","COM","2022","274","8","282","2024-12-30"
"32385","2024","COM","2022","185","3","188","2024-12-30"
"32386","2024","COM","2022","148","1","149","2024-12-30"
"32387","2024","COM","2022","99","3","102","2024-12-30"
"32388","2024","COM","2022","391","11","402","2024-12-30"
"32389","2024","COM","2022","442","12","454","2024-12-30"
"32390","2024","COM","2022","231","4","235","2024-12-30"
"32391","2024","COM","2022","126","4","130","2024-12-30"
"32392","2024","COM","2022","84","1","85","2024-12-30"
"32393","2024","COM","2022","136","2","138","2024-12-30"
"32394","2024","COM","2022","345","5","350","2024-12-30"
"32395","2024","COM","2022","204","4","208","2024-12-30"
"32396","2024","COM","2022","247","3","250","2024-12-30"
"32397","2024","COM","2022","246","17","263","2024-12-30"
"32398","2024","COM","2022","313","8","321","2024-12-30"
"32399","2024","COM","2022","80","4","84","2024-12-30"
"32400","2024","COM","2022","178","9","187","2024-12-30"
"32401","2024","COM","2022","91","2","93","2024-12-30"
"32402","2024","COM","2022","108","1","109","2024-12-30"
"32403","2024","COM","2022","59","2","61","2024-12-30"
"32404","2024","COM","2022","587","17","604","2024-12-30"
"32405","2024","COM","2022","175","6","181","2024-12-30"
"32406","2024","COM","2022","353","10","363","2024-12-30"
"32407","2024","COM","2022","155","4","159","2024-12-30"
"32408","2024","COM","2022","123","2","125","2024-12-30"
"32409","2024","COM","2022","76","5","81","2024-12-30"
"32410","2024","COM","2022","2478","105","2583","2024-12-30"
"32411","2024","COM","2022","100","1","101","2024-12-30"
"32412","2024","COM","2022","863","11","874","2024-12-30"
"32413","2024","COM","2022","82","2","84","2024-12-30"
"32414","2024","COM","2022","220","5","225","2024-12-30"
"32415","2024","COM","2022","87","1","88","2024-12-30"
"32416","2024","COM","2022","361","9","370","2024-12-30"
"32417","2024","COM","2022","418","12","430","2024-12-30"
"32418","2024","COM","2022","281","4","285","2024-12-30"
"32419","2024","COM","2022","105","1","106","2024-12-30"
"32420","2024","COM","2022","66","3","69","2024-12-30"
"32421","2024","COM","2022","145","1","146","2024-12-30"
"32422","2024","COM","2022","42","1","43","2024-12-30"
"32423","2024","COM","2022","68","3","71","2024-12-30"
"32424","2024","COM","2022","248","5","253","2024-12-30"
"32425","2024","COM","2022","1174","22","1196","2024-12-30"
"32426","2024","COM","2022","1098","30","1128","2024-12-30"
"32427","2024","COM","2022","58","0","58","2024-12-30"
"32428","2024","COM","2022","54","2","56","2024-12-30"
"32429","2024","COM","2022","313","11","324","2024-12-30"
"32430","2024","COM","2022","77","0","77","2024-12-30"
"32431","2024","COM","2022","42","4","46","2024-12-30"
"32432","2024","COM","2022","245","9","254","2024-12-30"
"32433","2024","COM","2022","695","18","713","2024-12-30"
"32434","2024","COM","2022","96","3","99","2024-12-30"
"32435","2024","COM","2022","162","9","171","2024-12-30"
"32436","2024","COM","2022","499","8","507","2024-12-30"
"32437","2024","COM","2022","201","2","203","2024-12-30"
"32438","2024","COM","2022","112","0","112","2024-12-30"
"32439","2024","COM","2022","158","2","160","2024-12-30"
"32440","2024","COM","2022","245","6","251","2024-12-30"
"32441","2024","COM","2022","66","2","68","2024-12-30"
"32442","2024","COM","2022","361","7","368","2024-12-30"
"32443","2024","COM","2022","199","2","201","2024-12-30"
"32444","2024","COM","2022","261","7","268","2024-12-30"
"32445","2024","COM","2022","149","5","154","2024-12-30"
"32446","2024","COM","2022","278","8","286","2024-12-30"
"32447","2024","COM","2022","81","2","83","2024-12-30"
"32448","2024","COM","2022","501","19","520","2024-12-30"
"32449","2024","COM","2022","306","4","310","2024-12-30"
"32450","2024","COM","2022","126","1","127","2024-12-30"
"32451","2024","COM","2022","178","3","181","2024-12-30"
"32452","2024","COM","2022","262","7","269","2024-12-30"
"32453","2024","COM","2022","103","3","106","2024-12-30"
"32454","2024","COM","2022","71","2","73","2024-12-30"
"32455","2024","COM","2022","162","9","171","2024-12-30"
"32456","2024","COM","2022","56","0","56","2024-12-30"
"32457","2024","COM","2022","267","12","279","2024-12-30"
"32458","2024","COM","2022","239","5","244","2024-12-30"
"32459","2024","COM","2022","1137","22","1159","2024-12-30"
"32460","2024","COM","2022","316","6","322","2024-12-30"
"32461","2024","COM","2022","122","0","122","2024-12-30"
"32462","2024","COM","2022","3578","55","3633","2024-12-30"
"32463","2024","COM","2022","523","10","533","2024-12-30"
"32464","2024","COM","2022","833","17","850","2024-12-30"
"32465","2024","COM","2022","168","0","168","2024-12-30"
"32466","2024","COM","2022","94","1","95","2024-12-30"
"32467","2024","COM","2022","146","5","151","2024-12-30"
"32468","2024","COM","2022","64","0","64","2024-12-30"
"33001","2024","COM","2022","2030","31","2061","2024-12-30"
"33002","2024","COM","2022","804","16","820","2024-12-30"
"33003","2024","COM","2022","17298","156","17454","2024-12-30"
"33004","2024","COM","2022","3291","22","3313","2024-12-30"
"33005","2024","COM","2022","12614","297","12911","2024-12-30"
"33006","2024","COM","2022","896","12","908","2024-12-30"
"33007","2024","COM","2022","1355","13","1368","2024-12-30"
"33008","2024","COM","2022","505","8","513","2024-12-30"
"33009","2024","COM","2022","10895","311","11206","2024-12-30"
"33010","2024","COM","2022","544","7","551","2024-12-30"
"33011","2024","COM","2022","6477","125","6602","2024-12-30"
"33012","2024","COM","2022","4040","65","4105","2024-12-30"
"33013","2024","COM","2022","8623","78","8701","2024-12-30"
"33014","2024","COM","2022","1120","20","1140","2024-12-30"
"33015","2024","COM","2022","2058","37","2095","2024-12-30"
"33016","2024","COM","2022","436","7","443","2024-12-30"
"33017","2024","COM","2022","301","7","308","2024-12-30"
"33018","2024","COM","2022","3744","44","3788","2024-12-30"
"33019","2024","COM","2022","9550","142","9692","2024-12-30"
"33020","2024","COM","2022","137","6","143","2024-12-30"
"33021","2024","COM","2022","1046","19","1065","2024-12-30"
"33022","2024","COM","2022","3108","34","3142","2024-12-30"
"33023","2024","COM","2022","1402","17","1419","2024-12-30"
"33024","2024","COM","2022","287","6","293","2024-12-30"
"33025","2024","COM","2022","443","5","448","2024-12-30"
"33026","2024","COM","2022","520","7","527","2024-12-30"
"33027","2024","COM","2022","277","9","286","2024-12-30"
"33028","2024","COM","2022","1204","16","1220","2024-12-30"
"33029","2024","COM","2022","5713","83","5796","2024-12-30"
"33030","2024","COM","2022","2061","32","2093","2024-12-30"
"33031","2024","COM","2022","131","3","134","2024-12-30"
"33032","2024","COM","2022","8132","48","8180","2024-12-30"
"33033","2024","COM","2022","936","15","951","2024-12-30"
"33034","2024","COM","2022","455","6","461","2024-12-30"
"33035","2024","COM","2022","737","2","739","2024-12-30"
"33036","2024","COM","2022","4819","296","5115","2024-12-30"
"33037","2024","COM","2022","2466","42","2508","2024-12-30"
"33038","2024","COM","2022","897","10","907","2024-12-30"
"33039","2024","COM","2022","30968","345","31313","2024-12-30"
"33040","2024","COM","2022","1257","10","1267","2024-12-30"
"33042","2024","COM","2022","6205","109","6314","2024-12-30"
"33043","2024","COM","2022","326","4","330","2024-12-30"
"33044","2024","COM","2022","211","6","217","2024-12-30"
"33045","2024","COM","2022","330","6","336","2024-12-30"
"33046","2024","COM","2022","1134","32","1166","2024-12-30"
"33047","2024","COM","2022","1833","33","1866","2024-12-30"
"33048","2024","COM","2022","292","3","295","2024-12-30"
"33049","2024","COM","2022","2608","23","2631","2024-12-30"
"33050","2024","COM","2022","670","10","680","2024-12-30"
"33051","2024","COM","2022","11303","142","11445","2024-12-30"
"33052","2024","COM","2022","1163","38","1201","2024-12-30"
"33053","2024","COM","2022","236","6","242","2024-12-30"
"33054","2024","COM","2022","320","5","325","2024-12-30"
"33055","2024","COM","2022","449","9","458","2024-12-30"
"33056","2024","COM","2022","16786","633","17419","2024-12-30"
"33057","2024","COM","2022","955","20","975","2024-12-30"
"33058","2024","COM","2022","5017","120","5137","2024-12-30"
"33059","2024","COM","2022","311","5","316","2024-12-30"
"33060","2024","COM","2022","450","58","508","2024-12-30"
"33061","2024","COM","2022","1048","19","1067","2024-12-30"
"33062","2024","COM","2022","802","12","814","2024-12-30"
"33063","2024","COM","2022","265328","3494","268822","2024-12-30"
"33064","2024","COM","2022","45","2","47","2024-12-30"
"33065","2024","COM","2022","3806","71","3877","2024-12-30"
"33066","2024","COM","2022","99","1","100","2024-12-30"
"33067","2024","COM","2022","2264","30","2294","2024-12-30"
"33068","2024","COM","2022","100","4","104","2024-12-30"
"33069","2024","COM","2022","24262","319","24581","2024-12-30"
"33070","2024","COM","2022","881","14","895","2024-12-30"
"33071","2024","COM","2022","1302","17","1319","2024-12-30"
"33072","2024","COM","2022","259","6","265","2024-12-30"
"33073","2024","COM","2022","1524","31","1555","2024-12-30"
"33074","2024","COM","2022","199","9","208","2024-12-30"
"33075","2024","COM","2022","20382","220","20602","2024-12-30"
"33076","2024","COM","2022","826","17","843","2024-12-30"
"33077","2024","COM","2022","2400","40","2440","2024-12-30"
"33078","2024","COM","2022","512","12","524","2024-12-30"
"33079","2024","COM","2022","345","7","352","2024-12-30"
"33080","2024","COM","2022","6784","70","6854","2024-12-30"
"33081","2024","COM","2022","2727","27","2754","2024-12-30"
"33082","2024","COM","2022","1341","25","1366","2024-12-30"
"33083","2024","COM","2022","1034","20","1054","2024-12-30"
"33084","2024","COM","2022","1853","20","1873","2024-12-30"
"33085","2024","COM","2022","3145","151","3296","2024-12-30"
"33086","2024","COM","2022","351","0","351","2024-12-30"
"33087","2024","COM","2022","418","4","422","2024-12-30"
"33088","2024","COM","2022","620","11","631","2024-12-30"
"33089","2024","COM","2022","520","5","525","2024-12-30"
"33090","2024","COM","2022","5836","76","5912","2024-12-30"
"33093","2024","COM","2022","798","9","807","2024-12-30"
"33094","2024","COM","2022","243","4","247","2024-12-30"
"33095","2024","COM","2022","1382","14","1396","2024-12-30"
"33096","2024","COM","2022","8342","88","8430","2024-12-30"
"33097","2024","COM","2022","2415","38","2453","2024-12-30"
"33098","2024","COM","2022","511","5","516","2024-12-30"
"33099","2024","COM","2022","4312","47","4359","2024-12-30"
"33100","2024","COM","2022","1219","13","1232","2024-12-30"
"33101","2024","COM","2022","1297","23","1320","2024-12-30"
"33102","2024","COM","2022","369","5","374","2024-12-30"
"33103","2024","COM","2022","51","1","52","2024-12-30"
"33104","2024","COM","2022","4850","71","4921","2024-12-30"
"33105","2024","COM","2022","203","4","207","2024-12-30"
"33106","2024","COM","2022","1539","33","1572","2024-12-30"
"33108","2024","COM","2022","3320","24","3344","2024-12-30"
"33109","2024","COM","2022","2689","39","2728","2024-12-30"
"33111","2024","COM","2022","1096","13","1109","2024-12-30"
"33112","2024","COM","2022","134","2","136","2024-12-30"
"33113","2024","COM","2022","144","2","146","2024-12-30"
"33114","2024","COM","2022","2368","18","2386","2024-12-30"
"33115","2024","COM","2022","255","4","259","2024-12-30"
"33116","2024","COM","2022","402","6","408","2024-12-30"
"33117","2024","COM","2022","212","2","214","2024-12-30"
"33118","2024","COM","2022","2151","36","2187","2024-12-30"
"33119","2024","COM","2022","26784","231","27015","2024-12-30"
"33120","2024","COM","2022","2131","38","2169","2024-12-30"
"33121","2024","COM","2022","198","3","201","2024-12-30"
"33122","2024","COM","2022","16757","286","17043","2024-12-30"
"33123","2024","COM","2022","2740","34","2774","2024-12-30"
"33124","2024","COM","2022","733","17","750","2024-12-30"
"33125","2024","COM","2022","2310","29","2339","2024-12-30"
"33126","2024","COM","2022","791","17","808","2024-12-30"
"33127","2024","COM","2022","211","4","215","2024-12-30"
"33128","2024","COM","2022","636","14","650","2024-12-30"
"33129","2024","COM","2022","150","0","150","2024-12-30"
"33130","2024","COM","2022","1077","27","1104","2024-12-30"
"33131","2024","COM","2022","217","2","219","2024-12-30"
"33132","2024","COM","2022","538","7","545","2024-12-30"
"33133","2024","COM","2022","70","0","70","2024-12-30"
"33134","2024","COM","2022","268","5","273","2024-12-30"
"33135","2024","COM","2022","122","0","122","2024-12-30"
"33136","2024","COM","2022","243","4","247","2024-12-30"
"33137","2024","COM","2022","224","1","225","2024-12-30"
"33138","2024","COM","2022","8695","126","8821","2024-12-30"
"33139","2024","COM","2022","92","1","93","2024-12-30"
"33140","2024","COM","2022","4863","104","4967","2024-12-30"
"33141","2024","COM","2022","733","9","742","2024-12-30"
"33142","2024","COM","2022","1877","19","1896","2024-12-30"
"33143","2024","COM","2022","2637","36","2673","2024-12-30"
"33144","2024","COM","2022","790","130","920","2024-12-30"
"33145","2024","COM","2022","666","18","684","2024-12-30"
"33146","2024","COM","2022","2326","40","2366","2024-12-30"
"33147","2024","COM","2022","470","12","482","2024-12-30"
"33148","2024","COM","2022","92","3","95","2024-12-30"
"33149","2024","COM","2022","147","4","151","2024-12-30"
"33150","2024","COM","2022","335","7","342","2024-12-30"
"33151","2024","COM","2022","929","10","939","2024-12-30"
"33152","2024","COM","2022","123","5","128","2024-12-30"
"33153","2024","COM","2022","278","1","279","2024-12-30"
"33154","2024","COM","2022","2172","102","2274","2024-12-30"
"33155","2024","COM","2022","167","3","170","2024-12-30"
"33156","2024","COM","2022","276","4","280","2024-12-30"
"33157","2024","COM","2022","748","12","760","2024-12-30"
"33158","2024","COM","2022","245","7","252","2024-12-30"
"33159","2024","COM","2022","1598","12","1610","2024-12-30"
"33160","2024","COM","2022","591","16","607","2024-12-30"
"33161","2024","COM","2022","755","6","761","2024-12-30"
"33162","2024","COM","2022","24436","320","24756","2024-12-30"
"33163","2024","COM","2022","423","9","432","2024-12-30"
"33164","2024","COM","2022","1634","24","1658","2024-12-30"
"33165","2024","COM","2022","3504","26","3530","2024-12-30"
"33166","2024","COM","2022","501","6","507","2024-12-30"
"33167","2024","COM","2022","17939","129","18068","2024-12-30"
"33168","2024","COM","2022","598","10","608","2024-12-30"
"33169","2024","COM","2022","106","3","109","2024-12-30"
"33170","2024","COM","2022","746","17","763","2024-12-30"
"33171","2024","COM","2022","223","6","229","2024-12-30"
"33172","2024","COM","2022","265","11","276","2024-12-30"
"33173","2024","COM","2022","178","6","184","2024-12-30"
"33174","2024","COM","2022","1120","34","1154","2024-12-30"
"33175","2024","COM","2022","785","10","795","2024-12-30"
"33176","2024","COM","2022","363","7","370","2024-12-30"
"33177","2024","COM","2022","2376","42","2418","2024-12-30"
"33178","2024","COM","2022","370","6","376","2024-12-30"
"33179","2024","COM","2022","3109","49","3158","2024-12-30"
"33180","2024","COM","2022","202","7","209","2024-12-30"
"33181","2024","COM","2022","277","4","281","2024-12-30"
"33182","2024","COM","2022","737","15","752","2024-12-30"
"33183","2024","COM","2022","1537","17","1554","2024-12-30"
"33184","2024","COM","2022","551","16","567","2024-12-30"
"33185","2024","COM","2022","2026","38","2064","2024-12-30"
"33186","2024","COM","2022","679","12","691","2024-12-30"
"33187","2024","COM","2022","1340","21","1361","2024-12-30"
"33188","2024","COM","2022","184","3","187","2024-12-30"
"33189","2024","COM","2022","436","12","448","2024-12-30"
"33190","2024","COM","2022","107","0","107","2024-12-30"
"33191","2024","COM","2022","523","7","530","2024-12-30"
"33192","2024","COM","2022","26186","397","26583","2024-12-30"
"33193","2024","COM","2022","1545","23","1568","2024-12-30"
"33194","2024","COM","2022","688","13","701","2024-12-30"
"33195","2024","COM","2022","1209","16","1225","2024-12-30"
"33196","2024","COM","2022","173","4","177","2024-12-30"
"33197","2024","COM","2022","454","6","460","2024-12-30"
"33198","2024","COM","2022","1637","28","1665","2024-12-30"
"33199","2024","COM","2022","22643","417","23060","2024-12-30"
"33200","2024","COM","2022","11499","183","11682","2024-12-30"
"33201","2024","COM","2022","843","18","861","2024-12-30"
"33202","2024","COM","2022","1530","22","1552","2024-12-30"
"33203","2024","COM","2022","4028","81","4109","2024-12-30"
"33204","2024","COM","2022","565","7","572","2024-12-30"
"33205","2024","COM","2022","1403","23","1426","2024-12-30"
"33206","2024","COM","2022","516","3","519","2024-12-30"
"33207","2024","COM","2022","6347","80","6427","2024-12-30"
"33208","2024","COM","2022","982","9","991","2024-12-30"
"33209","2024","COM","2022","273","6","279","2024-12-30"
"33210","2024","COM","2022","218","9","227","2024-12-30"
"33211","2024","COM","2022","616","2","618","2024-12-30"
"33212","2024","COM","2022","134","4","138","2024-12-30"
"33213","2024","COM","2022","4423","518","4941","2024-12-30"
"33214","2024","COM","2022","5389","110","5499","2024-12-30"
"33215","2024","COM","2022","187","6","193","2024-12-30"
"33216","2024","COM","2022","178","3","181","2024-12-30"
"33218","2024","COM","2022","1591","23","1614","2024-12-30"
"33219","2024","COM","2022","2739","27","2766","2024-12-30"
"33220","2024","COM","2022","1335","13","1348","2024-12-30"
"33221","2024","COM","2022","1119","22","1141","2024-12-30"
"33222","2024","COM","2022","631","14","645","2024-12-30"
"33223","2024","COM","2022","228","4","232","2024-12-30"
"33224","2024","COM","2022","102","3","105","2024-12-30"
"33225","2024","COM","2022","2245","48","2293","2024-12-30"
"33226","2024","COM","2022","2210","37","2247","2024-12-30"
"33227","2024","COM","2022","7523","163","7686","2024-12-30"
"33228","2024","COM","2022","671","10","681","2024-12-30"
"33229","2024","COM","2022","7315","144","7459","2024-12-30"
"33230","2024","COM","2022","545","5","550","2024-12-30"
"33231","2024","COM","2022","288","3","291","2024-12-30"
"33232","2024","COM","2022","41","0","41","2024-12-30"
"33233","2024","COM","2022","2808","21","2829","2024-12-30"
"33234","2024","COM","2022","3699","136","3835","2024-12-30"
"33235","2024","COM","2022","229","3","232","2024-12-30"
"33236","2024","COM","2022","8051","136","8187","2024-12-30"
"33237","2024","COM","2022","880","14","894","2024-12-30"
"33238","2024","COM","2022","10723","178","10901","2024-12-30"
"33239","2024","COM","2022","491","8","499","2024-12-30"
"33240","2024","COM","2022","5862","101","5963","2024-12-30"
"33241","2024","COM","2022","590","9","599","2024-12-30"
"33242","2024","COM","2022","558","10","568","2024-12-30"
"33243","2024","COM","2022","24668","565","25233","2024-12-30"
"33244","2024","COM","2022","403","6","409","2024-12-30"
"33245","2024","COM","2022","834","16","850","2024-12-30"
"33246","2024","COM","2022","140","5","145","2024-12-30"
"33247","2024","COM","2022","137","3","140","2024-12-30"
"33248","2024","COM","2022","2801","42","2843","2024-12-30"
"33249","2024","COM","2022","24654","387","25041","2024-12-30"
"33250","2024","COM","2022","314","4","318","2024-12-30"
"33251","2024","COM","2022","697","13","710","2024-12-30"
"33252","2024","COM","2022","940","14","954","2024-12-30"
"33253","2024","COM","2022","1087","18","1105","2024-12-30"
"33254","2024","COM","2022","545","6","551","2024-12-30"
"33255","2024","COM","2022","244","3","247","2024-12-30"
"33256","2024","COM","2022","5466","49","5515","2024-12-30"
"33257","2024","COM","2022","433","13","446","2024-12-30"
"33258","2024","COM","2022","319","6","325","2024-12-30"
"33259","2024","COM","2022","1391","26","1417","2024-12-30"
"33260","2024","COM","2022","1137","18","1155","2024-12-30"
"33261","2024","COM","2022","1146","12","1158","2024-12-30"
"33262","2024","COM","2022","4575","27","4602","2024-12-30"
"33263","2024","COM","2022","297","4","301","2024-12-30"
"33264","2024","COM","2022","1059","13","1072","2024-12-30"
"33266","2024","COM","2022","839","18","857","2024-12-30"
"33268","2024","COM","2022","2844","32","2876","2024-12-30"
"33269","2024","COM","2022","373","24","397","2024-12-30"
"33270","2024","COM","2022","191","4","195","2024-12-30"
"33271","2024","COM","2022","211","3","214","2024-12-30"
"33272","2024","COM","2022","1237","23","1260","2024-12-30"
"33273","2024","COM","2022","7959","146","8105","2024-12-30"
"33274","2024","COM","2022","3581","38","3619","2024-12-30"
"33275","2024","COM","2022","99","2","101","2024-12-30"
"33276","2024","COM","2022","137","3","140","2024-12-30"
"33277","2024","COM","2022","217","4","221","2024-12-30"
"33278","2024","COM","2022","228","5","233","2024-12-30"
"33279","2024","COM","2022","781","21","802","2024-12-30"
"33280","2024","COM","2022","545","9","554","2024-12-30"
"33281","2024","COM","2022","77136","857","77993","2024-12-30"
"33282","2024","COM","2022","299","5","304","2024-12-30"
"33283","2024","COM","2022","223","1","224","2024-12-30"
"33284","2024","COM","2022","11756","190","11946","2024-12-30"
"33285","2024","COM","2022","465","15","480","2024-12-30"
"33287","2024","COM","2022","656","10","666","2024-12-30"
"33288","2024","COM","2022","278","4","282","2024-12-30"
"33289","2024","COM","2022","1585","66","1651","2024-12-30"
"33290","2024","COM","2022","1520","129","1649","2024-12-30"
"33291","2024","COM","2022","171","3","174","2024-12-30"
"33292","2024","COM","2022","134","7","141","2024-12-30"
"33293","2024","COM","2022","3506","55","3561","2024-12-30"
"33294","2024","COM","2022","531","5","536","2024-12-30"
"33295","2024","COM","2022","89","3","92","2024-12-30"
"33296","2024","COM","2022","1022","15","1037","2024-12-30"
"33297","2024","COM","2022","1917","34","1951","2024-12-30"
"33298","2024","COM","2022","1056","17","1073","2024-12-30"
"33299","2024","COM","2022","389","10","399","2024-12-30"
"33300","2024","COM","2022","1102","25","1127","2024-12-30"
"33301","2024","COM","2022","612","9","621","2024-12-30"
"33302","2024","COM","2022","324","9","333","2024-12-30"
"33303","2024","COM","2022","838","10","848","2024-12-30"
"33304","2024","COM","2022","147","8","155","2024-12-30"
"33305","2024","COM","2022","506","6","512","2024-12-30"
"33306","2024","COM","2022","559","7","566","2024-12-30"
"33307","2024","COM","2022","1698","39","1737","2024-12-30"
"33308","2024","COM","2022","289","4","293","2024-12-30"
"33309","2024","COM","2022","487","6","493","2024-12-30"
"33310","2024","COM","2022","188","3","191","2024-12-30"
"33311","2024","COM","2022","1192","13","1205","2024-12-30"
"33312","2024","COM","2022","10407","92","10499","2024-12-30"
"33314","2024","COM","2022","5165","88","5253","2024-12-30"
"33315","2024","COM","2022","1633","18","1651","2024-12-30"
"33316","2024","COM","2022","899","14","913","2024-12-30"
"33317","2024","COM","2022","1185","19","1204","2024-12-30"
"33318","2024","COM","2022","66874","796","67670","2024-12-30"
"33319","2024","COM","2022","446","3","449","2024-12-30"
"33320","2024","COM","2022","738","17","755","2024-12-30"
"33321","2024","COM","2022","2191","28","2219","2024-12-30"
"33322","2024","COM","2022","7198","153","7351","2024-12-30"
"33323","2024","COM","2022","967","20","987","2024-12-30"
"33324","2024","COM","2022","4447","123","4570","2024-12-30"
"33325","2024","COM","2022","942","18","960","2024-12-30"
"33326","2024","COM","2022","220","4","224","2024-12-30"
"33327","2024","COM","2022","3300","50","3350","2024-12-30"
"33328","2024","COM","2022","608","7","615","2024-12-30"
"33329","2024","COM","2022","275","3","278","2024-12-30"
"33330","2024","COM","2022","3485","39","3524","2024-12-30"
"33331","2024","COM","2022","456","4","460","2024-12-30"
"33332","2024","COM","2022","876","17","893","2024-12-30"
"33333","2024","COM","2022","3418","41","3459","2024-12-30"
"33334","2024","COM","2022","2638","34","2672","2024-12-30"
"33335","2024","COM","2022","617","7","624","2024-12-30"
"33336","2024","COM","2022","1059","20","1079","2024-12-30"
"33337","2024","COM","2022","2140","43","2183","2024-12-30"
"33339","2024","COM","2022","1457","22","1479","2024-12-30"
"33341","2024","COM","2022","2417","26","2443","2024-12-30"
"33342","2024","COM","2022","828","22","850","2024-12-30"
"33343","2024","COM","2022","924","17","941","2024-12-30"
"33344","2024","COM","2022","522","6","528","2024-12-30"
"33345","2024","COM","2022","394","12","406","2024-12-30"
"33346","2024","COM","2022","411","11","422","2024-12-30"
"33347","2024","COM","2022","309","5","314","2024-12-30"
"33348","2024","COM","2022","1357","19","1376","2024-12-30"
"33349","2024","COM","2022","2216","36","2252","2024-12-30"
"33350","2024","COM","2022","1253","27","1280","2024-12-30"
"33351","2024","COM","2022","1626","24","1650","2024-12-30"
"33352","2024","COM","2022","4441","85","4526","2024-12-30"
"33353","2024","COM","2022","196","2","198","2024-12-30"
"33354","2024","COM","2022","195","5","200","2024-12-30"
"33355","2024","COM","2022","1483","36","1519","2024-12-30"
"33356","2024","COM","2022","412","5","417","2024-12-30"
"33357","2024","COM","2022","1793","33","1826","2024-12-30"
"33358","2024","COM","2022","479","9","488","2024-12-30"
"33359","2024","COM","2022","281","6","287","2024-12-30"
"33360","2024","COM","2022","310","3","313","2024-12-30"
"33361","2024","COM","2022","544","9","553","2024-12-30"
"33362","2024","COM","2022","1315","15","1330","2024-12-30"
"33363","2024","COM","2022","4718","71","4789","2024-12-30"
"33364","2024","COM","2022","368","7","375","2024-12-30"
"33365","2024","COM","2022","195","5","200","2024-12-30"
"33366","2024","COM","2022","12786","170","12956","2024-12-30"
"33367","2024","COM","2022","438","3","441","2024-12-30"
"33369","2024","COM","2022","670","11","681","2024-12-30"
"33370","2024","COM","2022","582","9","591","2024-12-30"
"33372","2024","COM","2022","60","1","61","2024-12-30"
"33373","2024","COM","2022","581","8","589","2024-12-30"
"33374","2024","COM","2022","843","10","853","2024-12-30"
"33375","2024","COM","2022","380","8","388","2024-12-30"
"33376","2024","COM","2022","7764","221","7985","2024-12-30"
"33377","2024","COM","2022","81","2","83","2024-12-30"
"33378","2024","COM","2022","1484","20","1504","2024-12-30"
"33379","2024","COM","2022","314","1","315","2024-12-30"
"33380","2024","COM","2022","1800","23","1823","2024-12-30"
"33381","2024","COM","2022","3460","50","3510","2024-12-30"
"33382","2024","COM","2022","1889","31","1920","2024-12-30"
"33383","2024","COM","2022","286","5","291","2024-12-30"
"33384","2024","COM","2022","390","8","398","2024-12-30"
"33385","2024","COM","2022","601","5","606","2024-12-30"
"33386","2024","COM","2022","193","6","199","2024-12-30"
"33387","2024","COM","2022","1528","24","1552","2024-12-30"
"33388","2024","COM","2022","754","17","771","2024-12-30"
"33389","2024","COM","2022","3128","42","3170","2024-12-30"
"33390","2024","COM","2022","424","8","432","2024-12-30"
"33391","2024","COM","2022","326","8","334","2024-12-30"
"33392","2024","COM","2022","841","16","857","2024-12-30"
"33393","2024","COM","2022","5916","86","6002","2024-12-30"
"33394","2024","COM","2022","1689","47","1736","2024-12-30"
"33395","2024","COM","2022","1629","36","1665","2024-12-30"
"33396","2024","COM","2022","181","4","185","2024-12-30"
"33397","2024","COM","2022","4922","84","5006","2024-12-30"
"33398","2024","COM","2022","169","2","171","2024-12-30"
"33399","2024","COM","2022","291","7","298","2024-12-30"
"33400","2024","COM","2022","338","6","344","2024-12-30"
"33401","2024","COM","2022","146","3","149","2024-12-30"
"33402","2024","COM","2022","2561","11","2572","2024-12-30"
"33403","2024","COM","2022","138","3","141","2024-12-30"
"33404","2024","COM","2022","193","4","197","2024-12-30"
"33405","2024","COM","2022","495","16","511","2024-12-30"
"33406","2024","COM","2022","367","8","375","2024-12-30"
"33407","2024","COM","2022","970","19","989","2024-12-30"
"33408","2024","COM","2022","390","17","407","2024-12-30"
"33409","2024","COM","2022","86","1","87","2024-12-30"
"33411","2024","COM","2022","147","4","151","2024-12-30"
"33412","2024","COM","2022","1345","14","1359","2024-12-30"
"33413","2024","COM","2022","2290","52","2342","2024-12-30"
"33414","2024","COM","2022","398","3","401","2024-12-30"
"33415","2024","COM","2022","1981","20","2001","2024-12-30"
"33416","2024","COM","2022","966","8","974","2024-12-30"
"33417","2024","COM","2022","3068","66","3134","2024-12-30"
"33418","2024","COM","2022","380","6","386","2024-12-30"
"33419","2024","COM","2022","80","1","81","2024-12-30"
"33420","2024","COM","2022","124","1","125","2024-12-30"
"33421","2024","COM","2022","450","6","456","2024-12-30"
"33422","2024","COM","2022","9702","183","9885","2024-12-30"
"33423","2024","COM","2022","621","0","621","2024-12-30"
"33424","2024","COM","2022","4950","95","5045","2024-12-30"
"33425","2024","COM","2022","1553","30","1583","2024-12-30"
"33426","2024","COM","2022","229","4","233","2024-12-30"
"33427","2024","COM","2022","257","6","263","2024-12-30"
"33428","2024","COM","2022","82","0","82","2024-12-30"
"33429","2024","COM","2022","316","4","320","2024-12-30"
"33431","2024","COM","2022","298","9","307","2024-12-30"
"33432","2024","COM","2022","230","5","235","2024-12-30"
"33433","2024","COM","2022","10057","112","10169","2024-12-30"
"33434","2024","COM","2022","2097","16","2113","2024-12-30"
"33435","2024","COM","2022","2000","108","2108","2024-12-30"
"33436","2024","COM","2022","1235","13","1248","2024-12-30"
"33437","2024","COM","2022","2149","27","2176","2024-12-30"
"33438","2024","COM","2022","2046","40","2086","2024-12-30"
"33439","2024","COM","2022","1637","18","1655","2024-12-30"
"33440","2024","COM","2022","238","5","243","2024-12-30"
"33441","2024","COM","2022","1166","102","1268","2024-12-30"
"33442","2024","COM","2022","546","9","555","2024-12-30"
"33443","2024","COM","2022","160","3","163","2024-12-30"
"33444","2024","COM","2022","563","11","574","2024-12-30"
"33445","2024","COM","2022","845","19","864","2024-12-30"
"33446","2024","COM","2022","159","1","160","2024-12-30"
"33447","2024","COM","2022","2408","17","2425","2024-12-30"
"33448","2024","COM","2022","3361","43","3404","2024-12-30"
"33449","2024","COM","2022","32749","490","33239","2024-12-30"
"33450","2024","COM","2022","249","1","250","2024-12-30"
"33451","2024","COM","2022","515","13","528","2024-12-30"
"33452","2024","COM","2022","879","11","890","2024-12-30"
"33453","2024","COM","2022","212","5","217","2024-12-30"
"33454","2024","COM","2022","1817","44","1861","2024-12-30"
"33456","2024","COM","2022","512","10","522","2024-12-30"
"33457","2024","COM","2022","639","9","648","2024-12-30"
"33458","2024","COM","2022","1032","20","1052","2024-12-30"
"33459","2024","COM","2022","185","1","186","2024-12-30"
"33460","2024","COM","2022","595","12","607","2024-12-30"
"33461","2024","COM","2022","383","4","387","2024-12-30"
"33462","2024","COM","2022","498","9","507","2024-12-30"
"33463","2024","COM","2022","1277","25","1302","2024-12-30"
"33464","2024","COM","2022","282","9","291","2024-12-30"
"33465","2024","COM","2022","1218","23","1241","2024-12-30"
"33466","2024","COM","2022","2704","34","2738","2024-12-30"
"33467","2024","COM","2022","256","4","260","2024-12-30"
"33468","2024","COM","2022","427","10","437","2024-12-30"
"33470","2024","COM","2022","948","16","964","2024-12-30"
"33471","2024","COM","2022","1262","29","1291","2024-12-30"
"33472","2024","COM","2022","365","6","371","2024-12-30"
"33473","2024","COM","2022","3468","47","3515","2024-12-30"
"33474","2024","COM","2022","3668","52","3720","2024-12-30"
"33475","2024","COM","2022","419","6","425","2024-12-30"
"33476","2024","COM","2022","701","3","704","2024-12-30"
"33477","2024","COM","2022","773","12","785","2024-12-30"
"33478","2024","COM","2022","3161","23","3184","2024-12-30"
"33479","2024","COM","2022","251","4","255","2024-12-30"
"33480","2024","COM","2022","1331","26","1357","2024-12-30"
"33481","2024","COM","2022","234","8","242","2024-12-30"
"33482","2024","COM","2022","271","3","274","2024-12-30"
"33483","2024","COM","2022","4879","71","4950","2024-12-30"
"33484","2024","COM","2022","1825","35","1860","2024-12-30"
"33485","2024","COM","2022","1890","32","1922","2024-12-30"
"33486","2024","COM","2022","368","4","372","2024-12-30"
"33487","2024","COM","2022","1016","8","1024","2024-12-30"
"33488","2024","COM","2022","334","12","346","2024-12-30"
"33489","2024","COM","2022","359","12","371","2024-12-30"
"33490","2024","COM","2022","1822","20","1842","2024-12-30"
"33491","2024","COM","2022","402","5","407","2024-12-30"
"33492","2024","COM","2022","2577","31","2608","2024-12-30"
"33493","2024","COM","2022","344","25","369","2024-12-30"
"33494","2024","COM","2022","1244","13","1257","2024-12-30"
"33496","2024","COM","2022","2771","42","2813","2024-12-30"
"33498","2024","COM","2022","8128","126","8254","2024-12-30"
"33499","2024","COM","2022","321","8","329","2024-12-30"
"33500","2024","COM","2022","471","4","475","2024-12-30"
"33501","2024","COM","2022","3446","59","3505","2024-12-30"
"33502","2024","COM","2022","499","6","505","2024-12-30"
"33503","2024","COM","2022","549","14","563","2024-12-30"
"33504","2024","COM","2022","816","24","840","2024-12-30"
"33505","2024","COM","2022","1594","52","1646","2024-12-30"
"33506","2024","COM","2022","1874","21","1895","2024-12-30"
"33507","2024","COM","2022","330","8","338","2024-12-30"
"33508","2024","COM","2022","646","18","664","2024-12-30"
"33509","2024","COM","2022","603","1","604","2024-12-30"
"33510","2024","COM","2022","216","11","227","2024-12-30"
"33511","2024","COM","2022","347","6","353","2024-12-30"
"33512","2024","COM","2022","342","7","349","2024-12-30"
"33513","2024","COM","2022","119","0","119","2024-12-30"
"33514","2024","COM","2022","3011","35","3046","2024-12-30"
"33515","2024","COM","2022","414","6","420","2024-12-30"
"33516","2024","COM","2022","184","4","188","2024-12-30"
"33517","2024","COM","2022","1710","28","1738","2024-12-30"
"33518","2024","COM","2022","1074","23","1097","2024-12-30"
"33519","2024","COM","2022","10966","150","11116","2024-12-30"
"33520","2024","COM","2022","288","1","289","2024-12-30"
"33521","2024","COM","2022","756","14","770","2024-12-30"
"33522","2024","COM","2022","45869","1023","46892","2024-12-30"
"33523","2024","COM","2022","2045","23","2068","2024-12-30"
"33524","2024","COM","2022","298","4","302","2024-12-30"
"33525","2024","COM","2022","1330","31","1361","2024-12-30"
"33526","2024","COM","2022","127","2","129","2024-12-30"
"33527","2024","COM","2022","9213","200","9413","2024-12-30"
"33528","2024","COM","2022","648","7","655","2024-12-30"
"33529","2024","COM","2022","27141","345","27486","2024-12-30"
"33530","2024","COM","2022","882","13","895","2024-12-30"
"33531","2024","COM","2022","376","5","381","2024-12-30"
"33532","2024","COM","2022","475","4","479","2024-12-30"
"33533","2024","COM","2022","2860","38","2898","2024-12-30"
"33534","2024","COM","2022","836","10","846","2024-12-30"
"33535","2024","COM","2022","5188","61","5249","2024-12-30"
"33536","2024","COM","2022","257","5","262","2024-12-30"
"33537","2024","COM","2022","467","5","472","2024-12-30"
"33538","2024","COM","2022","544","14","558","2024-12-30"
"33539","2024","COM","2022","4414","50","4464","2024-12-30"
"33540","2024","COM","2022","2820","39","2859","2024-12-30"
"33541","2024","COM","2022","1146","11","1157","2024-12-30"
"33542","2024","COM","2022","907","14","921","2024-12-30"
"33543","2024","COM","2022","1042","11","1053","2024-12-30"
"33544","2024","COM","2022","1389","12","1401","2024-12-30"
"33545","2024","COM","2022","1308","22","1330","2024-12-30"
"33546","2024","COM","2022","483","12","495","2024-12-30"
"33547","2024","COM","2022","1140","26","1166","2024-12-30"
"33548","2024","COM","2022","1291","26","1317","2024-12-30"
"33549","2024","COM","2022","373","6","379","2024-12-30"
"33550","2024","COM","2022","42185","291","42476","2024-12-30"
"33551","2024","COM","2022","408","7","415","2024-12-30"
"33552","2024","COM","2022","1120","15","1135","2024-12-30"
"33553","2024","COM","2022","1283","12","1295","2024-12-30"
"33554","2024","COM","2022","2901","31","2932","2024-12-30"
"33555","2024","COM","2022","5637","103","5740","2024-12-30"
"34001","2024","COM","2022","1824","23","1847","2024-12-30"
"34002","2024","COM","2022","1347","24","1371","2024-12-30"
"34003","2024","COM","2022","29612","412","30024","2024-12-30"
"34004","2024","COM","2022","244","7","251","2024-12-30"
"34005","2024","COM","2022","312","8","320","2024-12-30"
"34006","2024","COM","2022","294","6","300","2024-12-30"
"34007","2024","COM","2022","472","5","477","2024-12-30"
"34008","2024","COM","2022","613","11","624","2024-12-30"
"34009","2024","COM","2022","1761","24","1785","2024-12-30"
"34010","2024","COM","2022","2956","65","3021","2024-12-30"
"34011","2024","COM","2022","104","4","108","2024-12-30"
"34012","2024","COM","2022","971","29","1000","2024-12-30"
"34013","2024","COM","2022","1682","23","1705","2024-12-30"
"34014","2024","COM","2022","1430","43","1473","2024-12-30"
"34015","2024","COM","2022","168","3","171","2024-12-30"
"34016","2024","COM","2022","582","20","602","2024-12-30"
"34017","2024","COM","2022","502","15","517","2024-12-30"
"34018","2024","COM","2022","962","20","982","2024-12-30"
"34019","2024","COM","2022","294","6","300","2024-12-30"
"34020","2024","COM","2022","353","12","365","2024-12-30"
"34021","2024","COM","2022","309","5","314","2024-12-30"
"34022","2024","COM","2022","7793","107","7900","2024-12-30"
"34023","2024","COM","2022","7136","102","7238","2024-12-30"
"34024","2024","COM","2022","2749","36","2785","2024-12-30"
"34025","2024","COM","2022","2353","33","2386","2024-12-30"
"34026","2024","COM","2022","215","2","217","2024-12-30"
"34027","2024","COM","2022","2239","34","2273","2024-12-30"
"34028","2024","COM","2022","5820","216","6036","2024-12-30"
"34029","2024","COM","2022","662","6","668","2024-12-30"
"34030","2024","COM","2022","222","0","222","2024-12-30"
"34031","2024","COM","2022","5705","76","5781","2024-12-30"
"34032","2024","COM","2022","80815","1079","81894","2024-12-30"
"34033","2024","COM","2022","2178","44","2222","2024-12-30"
"34034","2024","COM","2022","41","1","42","2024-12-30"
"34035","2024","COM","2022","1054","16","1070","2024-12-30"
"34036","2024","COM","2022","1406","21","1427","2024-12-30"
"34037","2024","COM","2022","3536","40","3576","2024-12-30"
"34038","2024","COM","2022","1594","17","1611","2024-12-30"
"34039","2024","COM","2022","1613","30","1643","2024-12-30"
"34040","2024","COM","2022","57","0","57","2024-12-30"
"34041","2024","COM","2022","971","22","993","2024-12-30"
"34042","2024","COM","2022","592","15","607","2024-12-30"
"34043","2024","COM","2022","373","8","381","2024-12-30"
"34044","2024","COM","2022","338","10","348","2024-12-30"
"34045","2024","COM","2022","556","20","576","2024-12-30"
"34046","2024","COM","2022","51","0","51","2024-12-30"
"34047","2024","COM","2022","719","12","731","2024-12-30"
"34048","2024","COM","2022","311","5","316","2024-12-30"
"34049","2024","COM","2022","217","6","223","2024-12-30"
"34050","2024","COM","2022","2102","17","2119","2024-12-30"
"34051","2024","COM","2022","3600","78","3678","2024-12-30"
"34052","2024","COM","2022","3413","63","3476","2024-12-30"
"34053","2024","COM","2022","115","1","116","2024-12-30"
"34054","2024","COM","2022","109","3","112","2024-12-30"
"34055","2024","COM","2022","224","3","227","2024-12-30"
"34056","2024","COM","2022","1199","17","1216","2024-12-30"
"34057","2024","COM","2022","25404","439","25843","2024-12-30"
"34058","2024","COM","2022","6722","97","6819","2024-12-30"
"34059","2024","COM","2022","320","6","326","2024-12-30"
"34060","2024","COM","2022","443","9","452","2024-12-30"
"34061","2024","COM","2022","620","9","629","2024-12-30"
"34062","2024","COM","2022","168","1","169","2024-12-30"
"34063","2024","COM","2022","2692","38","2730","2024-12-30"
"34064","2024","COM","2022","462","16","478","2024-12-30"
"34065","2024","COM","2022","640","13","653","2024-12-30"
"34066","2024","COM","2022","228","3","231","2024-12-30"
"34067","2024","COM","2022","1583","43","1626","2024-12-30"
"34068","2024","COM","2022","413","12","425","2024-12-30"
"34069","2024","COM","2022","5185","95","5280","2024-12-30"
"34070","2024","COM","2022","637","13","650","2024-12-30"
"34071","2024","COM","2022","247","5","252","2024-12-30"
"34072","2024","COM","2022","25","1","26","2024-12-30"
"34073","2024","COM","2022","2523","49","2572","2024-12-30"
"34074","2024","COM","2022","2390","51","2441","2024-12-30"
"34075","2024","COM","2022","432","8","440","2024-12-30"
"34076","2024","COM","2022","1389","28","1417","2024-12-30"
"34077","2024","COM","2022","6010","98","6108","2024-12-30"
"34078","2024","COM","2022","1697","39","1736","2024-12-30"
"34079","2024","COM","2022","9372","146","9518","2024-12-30"
"34080","2024","COM","2022","494","9","503","2024-12-30"
"34081","2024","COM","2022","2755","49","2804","2024-12-30"
"34082","2024","COM","2022","1961","46","2007","2024-12-30"
"34083","2024","COM","2022","321","2","323","2024-12-30"
"34084","2024","COM","2022","1632","28","1660","2024-12-30"
"34085","2024","COM","2022","371","9","380","2024-12-30"
"34086","2024","COM","2022","615","13","628","2024-12-30"
"34087","2024","COM","2022","3583","45","3628","2024-12-30"
"34088","2024","COM","2022","7019","66","7085","2024-12-30"
"34089","2024","COM","2022","1404","28","1432","2024-12-30"
"34090","2024","COM","2022","9267","142","9409","2024-12-30"
"34091","2024","COM","2022","57","0","57","2024-12-30"
"34092","2024","COM","2022","954","17","971","2024-12-30"
"34093","2024","COM","2022","150","4","154","2024-12-30"
"34094","2024","COM","2022","1176","24","1200","2024-12-30"
"34095","2024","COM","2022","7200","82","7282","2024-12-30"
"34096","2024","COM","2022","555","6","561","2024-12-30"
"34097","2024","COM","2022","505","8","513","2024-12-30"
"34098","2024","COM","2022","147","4","151","2024-12-30"
"34099","2024","COM","2022","46","1","47","2024-12-30"
"34100","2024","COM","2022","67","0","67","2024-12-30"
"34101","2024","COM","2022","5138","91","5229","2024-12-30"
"34102","2024","COM","2022","355","4","359","2024-12-30"
"34103","2024","COM","2022","1059","24","1083","2024-12-30"
"34104","2024","COM","2022","131","1","132","2024-12-30"
"34105","2024","COM","2022","247","7","254","2024-12-30"
"34106","2024","COM","2022","193","9","202","2024-12-30"
"34107","2024","COM","2022","337","3","340","2024-12-30"
"34108","2024","COM","2022","23788","255","24043","2024-12-30"
"34109","2024","COM","2022","864","13","877","2024-12-30"
"34110","2024","COM","2022","755","17","772","2024-12-30"
"34111","2024","COM","2022","3854","87","3941","2024-12-30"
"34112","2024","COM","2022","232","5","237","2024-12-30"
"34113","2024","COM","2022","6559","79","6638","2024-12-30"
"34114","2024","COM","2022","6713","112","6825","2024-12-30"
"34115","2024","COM","2022","107","0","107","2024-12-30"
"34116","2024","COM","2022","9060","96","9156","2024-12-30"
"34117","2024","COM","2022","569","8","577","2024-12-30"
"34118","2024","COM","2022","497","11","508","2024-12-30"
"34119","2024","COM","2022","1559","25","1584","2024-12-30"
"34120","2024","COM","2022","6964","110","7074","2024-12-30"
"34121","2024","COM","2022","261","15","276","2024-12-30"
"34122","2024","COM","2022","588","6","594","2024-12-30"
"34123","2024","COM","2022","13776","117","13893","2024-12-30"
"34124","2024","COM","2022","312","9","321","2024-12-30"
"34125","2024","COM","2022","110","4","114","2024-12-30"
"34126","2024","COM","2022","2421","23","2444","2024-12-30"
"34127","2024","COM","2022","3130","43","3173","2024-12-30"
"34128","2024","COM","2022","1670","39","1709","2024-12-30"
"34129","2024","COM","2022","17592","197","17789","2024-12-30"
"34130","2024","COM","2022","1794","23","1817","2024-12-30"
"34131","2024","COM","2022","621","21","642","2024-12-30"
"34132","2024","COM","2022","208","5","213","2024-12-30"
"34133","2024","COM","2022","55","0","55","2024-12-30"
"34134","2024","COM","2022","3298","57","3355","2024-12-30"
"34135","2024","COM","2022","3355","49","3404","2024-12-30"
"34136","2024","COM","2022","1569","30","1599","2024-12-30"
"34137","2024","COM","2022","153","6","159","2024-12-30"
"34138","2024","COM","2022","338","8","346","2024-12-30"
"34139","2024","COM","2022","1483","42","1525","2024-12-30"
"34140","2024","COM","2022","3227","47","3274","2024-12-30"
"34141","2024","COM","2022","526","5","531","2024-12-30"
"34142","2024","COM","2022","7202","232","7434","2024-12-30"
"34143","2024","COM","2022","2179","40","2219","2024-12-30"
"34144","2024","COM","2022","672","12","684","2024-12-30"
"34145","2024","COM","2022","26380","296","26676","2024-12-30"
"34146","2024","COM","2022","4497","29","4526","2024-12-30"
"34147","2024","COM","2022","3531","69","3600","2024-12-30"
"34148","2024","COM","2022","4693","78","4771","2024-12-30"
"34149","2024","COM","2022","775","3","778","2024-12-30"
"34150","2024","COM","2022","8047","79","8126","2024-12-30"
"34151","2024","COM","2022","6787","67","6854","2024-12-30"
"34152","2024","COM","2022","673","10","683","2024-12-30"
"34153","2024","COM","2022","2068","52","2120","2024-12-30"
"34154","2024","COM","2022","16417","184","16601","2024-12-30"
"34155","2024","COM","2022","2465","50","2515","2024-12-30"
"34156","2024","COM","2022","57","0","57","2024-12-30"
"34157","2024","COM","2022","12711","169","12880","2024-12-30"
"34158","2024","COM","2022","96","1","97","2024-12-30"
"34159","2024","COM","2022","3301","30","3331","2024-12-30"
"34160","2024","COM","2022","671","17","688","2024-12-30"
"34161","2024","COM","2022","4020","69","4089","2024-12-30"
"34162","2024","COM","2022","4465","58","4523","2024-12-30"
"34163","2024","COM","2022","4186","62","4248","2024-12-30"
"34164","2024","COM","2022","1024","11","1035","2024-12-30"
"34165","2024","COM","2022","2903","44","2947","2024-12-30"
"34166","2024","COM","2022","2896","46","2942","2024-12-30"
"34167","2024","COM","2022","243","4","247","2024-12-30"
"34168","2024","COM","2022","76","0","76","2024-12-30"
"34169","2024","COM","2022","4117","167","4284","2024-12-30"
"34170","2024","COM","2022","232","4","236","2024-12-30"
"34171","2024","COM","2022","183","33","216","2024-12-30"
"34172","2024","COM","2022","307101","3510","310611","2024-12-30"
"34173","2024","COM","2022","1418","32","1450","2024-12-30"
"34174","2024","COM","2022","855","25","880","2024-12-30"
"34175","2024","COM","2022","190","7","197","2024-12-30"
"34176","2024","COM","2022","2954","34","2988","2024-12-30"
"34177","2024","COM","2022","353","11","364","2024-12-30"
"34178","2024","COM","2022","3038","62","3100","2024-12-30"
"34179","2024","COM","2022","2002","33","2035","2024-12-30"
"34180","2024","COM","2022","1573","31","1604","2024-12-30"
"34181","2024","COM","2022","1018","23","1041","2024-12-30"
"34182","2024","COM","2022","1730","34","1764","2024-12-30"
"34183","2024","COM","2022","4077","75","4152","2024-12-30"
"34184","2024","COM","2022","661","14","675","2024-12-30"
"34185","2024","COM","2022","523","13","536","2024-12-30"
"34186","2024","COM","2022","520","13","533","2024-12-30"
"34187","2024","COM","2022","493","8","501","2024-12-30"
"34188","2024","COM","2022","166","2","168","2024-12-30"
"34189","2024","COM","2022","1683","21","1704","2024-12-30"
"34190","2024","COM","2022","276","6","282","2024-12-30"
"34191","2024","COM","2022","608","13","621","2024-12-30"
"34192","2024","COM","2022","6007","44","6051","2024-12-30"
"34193","2024","COM","2022","171","5","176","2024-12-30"
"34194","2024","COM","2022","4022","52","4074","2024-12-30"
"34195","2024","COM","2022","55","2","57","2024-12-30"
"34196","2024","COM","2022","152","4","156","2024-12-30"
"34197","2024","COM","2022","1131","17","1148","2024-12-30"
"34198","2024","COM","2022","9541","133","9674","2024-12-30"
"34199","2024","COM","2022","7789","249","8038","2024-12-30"
"34200","2024","COM","2022","236","8","244","2024-12-30"
"34201","2024","COM","2022","293","6","299","2024-12-30"
"34202","2024","COM","2022","8326","94","8420","2024-12-30"
"34203","2024","COM","2022","2012","26","2038","2024-12-30"
"34204","2024","COM","2022","1610","25","1635","2024-12-30"
"34205","2024","COM","2022","317","8","325","2024-12-30"
"34206","2024","COM","2022","534","11","545","2024-12-30"
"34207","2024","COM","2022","2255","45","2300","2024-12-30"
"34208","2024","COM","2022","368","9","377","2024-12-30"
"34209","2024","COM","2022","3388","61","3449","2024-12-30"
"34210","2024","COM","2022","2101","52","2153","2024-12-30"
"34211","2024","COM","2022","944","30","974","2024-12-30"
"34212","2024","COM","2022","183","5","188","2024-12-30"
"34213","2024","COM","2022","6540","88","6628","2024-12-30"
"34214","2024","COM","2022","1214","19","1233","2024-12-30"
"34215","2024","COM","2022","956","12","968","2024-12-30"
"34216","2024","COM","2022","325","6","331","2024-12-30"
"34217","2024","COM","2022","6207","106","6313","2024-12-30"
"34218","2024","COM","2022","369","7","376","2024-12-30"
"34219","2024","COM","2022","484","7","491","2024-12-30"
"34220","2024","COM","2022","260","8","268","2024-12-30"
"34221","2024","COM","2022","507","10","517","2024-12-30"
"34222","2024","COM","2022","644","14","658","2024-12-30"
"34223","2024","COM","2022","1218","21","1239","2024-12-30"
"34224","2024","COM","2022","1352","34","1386","2024-12-30"
"34225","2024","COM","2022","3034","52","3086","2024-12-30"
"34226","2024","COM","2022","1788","27","1815","2024-12-30"
"34227","2024","COM","2022","2573","38","2611","2024-12-30"
"34228","2024","COM","2022","82","5","87","2024-12-30"
"34229","2024","COM","2022","714","24","738","2024-12-30"
"34230","2024","COM","2022","151","5","156","2024-12-30"
"34231","2024","COM","2022","23","1","24","2024-12-30"
"34232","2024","COM","2022","603","16","619","2024-12-30"
"34233","2024","COM","2022","211","3","214","2024-12-30"
"34234","2024","COM","2022","111","3","114","2024-12-30"
"34235","2024","COM","2022","271","6","277","2024-12-30"
"34236","2024","COM","2022","69","0","69","2024-12-30"
"34237","2024","COM","2022","2297","43","2340","2024-12-30"
"34238","2024","COM","2022","47","0","47","2024-12-30"
"34239","2024","COM","2022","6364","112","6476","2024-12-30"
"34240","2024","COM","2022","4333","42","4375","2024-12-30"
"34241","2024","COM","2022","938","14","952","2024-12-30"
"34242","2024","COM","2022","1212","22","1234","2024-12-30"
"34243","2024","COM","2022","1839","28","1867","2024-12-30"
"34244","2024","COM","2022","3462","46","3508","2024-12-30"
"34245","2024","COM","2022","1775","27","1802","2024-12-30"
"34246","2024","COM","2022","2186","37","2223","2024-12-30"
"34247","2024","COM","2022","5140","194","5334","2024-12-30"
"34248","2024","COM","2022","970","19","989","2024-12-30"
"34249","2024","COM","2022","2952","67","3019","2024-12-30"
"34250","2024","COM","2022","301","6","307","2024-12-30"
"34251","2024","COM","2022","520","10","530","2024-12-30"
"34252","2024","COM","2022","257","3","260","2024-12-30"
"34253","2024","COM","2022","32","1","33","2024-12-30"
"34254","2024","COM","2022","1142","32","1174","2024-12-30"
"34255","2024","COM","2022","10530","275","10805","2024-12-30"
"34256","2024","COM","2022","2112","35","2147","2024-12-30"
"34257","2024","COM","2022","216","2","218","2024-12-30"
"34258","2024","COM","2022","1695","33","1728","2024-12-30"
"34259","2024","COM","2022","5707","73","5780","2024-12-30"
"34260","2024","COM","2022","839","13","852","2024-12-30"
"34261","2024","COM","2022","243","6","249","2024-12-30"
"34262","2024","COM","2022","273","1","274","2024-12-30"
"34263","2024","COM","2022","458","3","461","2024-12-30"
"34264","2024","COM","2022","211","0","211","2024-12-30"
"34265","2024","COM","2022","839","16","855","2024-12-30"
"34266","2024","COM","2022","532","7","539","2024-12-30"
"34267","2024","COM","2022","1743","32","1775","2024-12-30"
"34268","2024","COM","2022","695","19","714","2024-12-30"
"34269","2024","COM","2022","133","2","135","2024-12-30"
"34270","2024","COM","2022","13300","160","13460","2024-12-30"
"34271","2024","COM","2022","225","1","226","2024-12-30"
"34272","2024","COM","2022","3290","35","3325","2024-12-30"
"34273","2024","COM","2022","103","0","103","2024-12-30"
"34274","2024","COM","2022","2728","44","2772","2024-12-30"
"34276","2024","COM","2022","4869","102","4971","2024-12-30"
"34277","2024","COM","2022","184","5","189","2024-12-30"
"34278","2024","COM","2022","60","0","60","2024-12-30"
"34279","2024","COM","2022","321","3","324","2024-12-30"
"34280","2024","COM","2022","620","8","628","2024-12-30"
"34281","2024","COM","2022","2438","38","2476","2024-12-30"
"34282","2024","COM","2022","1367","23","1390","2024-12-30"
"34283","2024","COM","2022","123","2","125","2024-12-30"
"34284","2024","COM","2022","1718","188","1906","2024-12-30"
"34285","2024","COM","2022","641","10","651","2024-12-30"
"34286","2024","COM","2022","453","15","468","2024-12-30"
"34287","2024","COM","2022","289","7","296","2024-12-30"
"34288","2024","COM","2022","972","18","990","2024-12-30"
"34289","2024","COM","2022","3047","47","3094","2024-12-30"
"34290","2024","COM","2022","760","11","771","2024-12-30"
"34291","2024","COM","2022","354","5","359","2024-12-30"
"34292","2024","COM","2022","342","9","351","2024-12-30"
"34293","2024","COM","2022","1115","10","1125","2024-12-30"
"34294","2024","COM","2022","1021","23","1044","2024-12-30"
"34295","2024","COM","2022","1926","24","1950","2024-12-30"
"34296","2024","COM","2022","992","24","1016","2024-12-30"
"34297","2024","COM","2022","435","14","449","2024-12-30"
"34298","2024","COM","2022","5498","98","5596","2024-12-30"
"34299","2024","COM","2022","8437","184","8621","2024-12-30"
"34300","2024","COM","2022","5427","113","5540","2024-12-30"
"34301","2024","COM","2022","45090","586","45676","2024-12-30"
"34302","2024","COM","2022","751","13","764","2024-12-30"
"34303","2024","COM","2022","39","1","40","2024-12-30"
"34304","2024","COM","2022","954","31","985","2024-12-30"
"34305","2024","COM","2022","133","4","137","2024-12-30"
"34306","2024","COM","2022","243","0","243","2024-12-30"
"34307","2024","COM","2022","2817","56","2873","2024-12-30"
"34308","2024","COM","2022","462","12","474","2024-12-30"
"34309","2024","COM","2022","4729","85","4814","2024-12-30"
"34310","2024","COM","2022","3070","74","3144","2024-12-30"
"34311","2024","COM","2022","1875","168","2043","2024-12-30"
"34312","2024","COM","2022","1346","24","1370","2024-12-30"
"34313","2024","COM","2022","688","23","711","2024-12-30"
"34314","2024","COM","2022","692","14","706","2024-12-30"
"34315","2024","COM","2022","438","6","444","2024-12-30"
"34316","2024","COM","2022","248","2","250","2024-12-30"
"34317","2024","COM","2022","202","8","210","2024-12-30"
"34318","2024","COM","2022","757","13","770","2024-12-30"
"34319","2024","COM","2022","142","1","143","2024-12-30"
"34320","2024","COM","2022","2684","38","2722","2024-12-30"
"34321","2024","COM","2022","2173","24","2197","2024-12-30"
"34322","2024","COM","2022","793","14","807","2024-12-30"
"34323","2024","COM","2022","51","0","51","2024-12-30"
"34324","2024","COM","2022","4300","57","4357","2024-12-30"
"34325","2024","COM","2022","1665","28","1693","2024-12-30"
"34326","2024","COM","2022","102","0","102","2024-12-30"
"34327","2024","COM","2022","7157","81","7238","2024-12-30"
"34328","2024","COM","2022","1157","25","1182","2024-12-30"
"34329","2024","COM","2022","2671","72","2743","2024-12-30"
"34331","2024","COM","2022","88","1","89","2024-12-30"
"34332","2024","COM","2022","5960","73","6033","2024-12-30"
"34333","2024","COM","2022","3413","29","3442","2024-12-30"
"34334","2024","COM","2022","268","4","272","2024-12-30"
"34335","2024","COM","2022","420","11","431","2024-12-30"
"34336","2024","COM","2022","4283","58","4341","2024-12-30"
"34337","2024","COM","2022","10406","131","10537","2024-12-30"
"34338","2024","COM","2022","66","2","68","2024-12-30"
"34339","2024","COM","2022","186","5","191","2024-12-30"
"34340","2024","COM","2022","1698","36","1734","2024-12-30"
"34341","2024","COM","2022","3953","73","4026","2024-12-30"
"34342","2024","COM","2022","216","4","220","2024-12-30"
"34343","2024","COM","2022","1223","19","1242","2024-12-30"
"34344","2024","COM","2022","8508","88","8596","2024-12-30"
"35001","2024","COM","2022","6911","167","7078","2024-12-30"
"35002","2024","COM","2022","1765","45","1810","2024-12-30"
"35003","2024","COM","2022","1006","8","1014","2024-12-30"
"35004","2024","COM","2022","4084","91","4175","2024-12-30"
"35005","2024","COM","2022","270","6","276","2024-12-30"
"35006","2024","COM","2022","4591","112","4703","2024-12-30"
"35007","2024","COM","2022","465","9","474","2024-12-30"
"35008","2024","COM","2022","647","12","659","2024-12-30"
"35009","2024","COM","2022","1697","27","1724","2024-12-30"
"35010","2024","COM","2022","1764","29","1793","2024-12-30"
"35012","2024","COM","2022","7704","181","7885","2024-12-30"
"35013","2024","COM","2022","3521","163","3684","2024-12-30"
"35014","2024","COM","2022","2511","27","2538","2024-12-30"
"35015","2024","COM","2022","2181","47","2228","2024-12-30"
"35016","2024","COM","2022","2208","51","2259","2024-12-30"
"35017","2024","COM","2022","675","12","687","2024-12-30"
"35018","2024","COM","2022","1080","28","1108","2024-12-30"
"35019","2024","COM","2022","1865","26","1891","2024-12-30"
"35021","2024","COM","2022","1289","43","1332","2024-12-30"
"35022","2024","COM","2022","685","16","701","2024-12-30"
"35023","2024","COM","2022","4571","74","4645","2024-12-30"
"35024","2024","COM","2022","12775","293","13068","2024-12-30"
"35025","2024","COM","2022","1038","24","1062","2024-12-30"
"35026","2024","COM","2022","98","7","105","2024-12-30"
"35027","2024","COM","2022","1757","34","1791","2024-12-30"
"35028","2024","COM","2022","726","8","734","2024-12-30"
"35029","2024","COM","2022","1533","25","1558","2024-12-30"
"35030","2024","COM","2022","691","18","709","2024-12-30"
"35031","2024","COM","2022","4602","103","4705","2024-12-30"
"35032","2024","COM","2022","4692","94","4786","2024-12-30"
"35033","2024","COM","2022","3388","62","3450","2024-12-30"
"35034","2024","COM","2022","1250","18","1268","2024-12-30"
"35035","2024","COM","2022","600","19","619","2024-12-30"
"35037","2024","COM","2022","6430","100","6530","2024-12-30"
"35038","2024","COM","2022","614","21","635","2024-12-30"
"35039","2024","COM","2022","2185","48","2233","2024-12-30"
"35040","2024","COM","2022","3678","76","3754","2024-12-30"
"35041","2024","COM","2022","1014","19","1033","2024-12-30"
"35042","2024","COM","2022","679","14","693","2024-12-30"
"35044","2024","COM","2022","411","5","416","2024-12-30"
"35045","2024","COM","2022","856","15","871","2024-12-30"
"35046","2024","COM","2022","541","8","549","2024-12-30"
"35047","2024","COM","2022","19667","451","20118","2024-12-30"
"35049","2024","COM","2022","5554","95","5649","2024-12-30"
"35050","2024","COM","2022","598","12","610","2024-12-30"
"35051","2024","COM","2022","18076","513","18589","2024-12-30"
"35052","2024","COM","2022","504","10","514","2024-12-30"
"35054","2024","COM","2022","1881","47","1928","2024-12-30"
"35055","2024","COM","2022","10378","150","10528","2024-12-30"
"35056","2024","COM","2022","825","22","847","2024-12-30"
"35057","2024","COM","2022","1527","32","1559","2024-12-30"
"35058","2024","COM","2022","1299","23","1322","2024-12-30"
"35059","2024","COM","2022","4603","91","4694","2024-12-30"
"35060","2024","COM","2022","1037","11","1048","2024-12-30"
"35061","2024","COM","2022","723","12","735","2024-12-30"
"35062","2024","COM","2022","2430","53","2483","2024-12-30"
"35063","2024","COM","2022","468","11","479","2024-12-30"
"35064","2024","COM","2022","1107","13","1120","2024-12-30"
"35065","2024","COM","2022","2266","40","2306","2024-12-30"
"35066","2024","COM","2022","8678","131","8809","2024-12-30"
"35067","2024","COM","2022","1702","28","1730","2024-12-30"
"35068","2024","COM","2022","7523","148","7671","2024-12-30"
"35069","2024","COM","2022","10688","250","10938","2024-12-30"
"35070","2024","COM","2022","1679","21","1700","2024-12-30"
"35071","2024","COM","2022","427","8","435","2024-12-30"
"35072","2024","COM","2022","1738","34","1772","2024-12-30"
"35075","2024","COM","2022","807","23","830","2024-12-30"
"35076","2024","COM","2022","4562","64","4626","2024-12-30"
"35077","2024","COM","2022","354","5","359","2024-12-30"
"35078","2024","COM","2022","1106","13","1119","2024-12-30"
"35079","2024","COM","2022","2396","50","2446","2024-12-30"
"35080","2024","COM","2022","2614","69","2683","2024-12-30"
"35081","2024","COM","2022","941","32","973","2024-12-30"
"35082","2024","COM","2022","1435","21","1456","2024-12-30"
"35084","2024","COM","2022","677","9","686","2024-12-30"
"35085","2024","COM","2022","6324","123","6447","2024-12-30"
"35086","2024","COM","2022","608","14","622","2024-12-30"
"35087","2024","COM","2022","967","29","996","2024-12-30"
"35088","2024","COM","2022","3555","79","3634","2024-12-30"
"35089","2024","COM","2022","447","5","452","2024-12-30"
"35090","2024","COM","2022","2790","53","2843","2024-12-30"
"35091","2024","COM","2022","591","8","599","2024-12-30"
"35092","2024","COM","2022","830","12","842","2024-12-30"
"35093","2024","COM","2022","10407","516","10923","2024-12-30"
"35094","2024","COM","2022","1690","28","1718","2024-12-30"
"35095","2024","COM","2022","5786","347","6133","2024-12-30"
"35096","2024","COM","2022","2439","55","2494","2024-12-30"
"35097","2024","COM","2022","2050","46","2096","2024-12-30"
"35098","2024","COM","2022","1414","25","1439","2024-12-30"
"35099","2024","COM","2022","3839","66","3905","2024-12-30"
"35101","2024","COM","2022","1225","22","1247","2024-12-30"
"35102","2024","COM","2022","503","11","514","2024-12-30"
"35103","2024","COM","2022","430","8","438","2024-12-30"
"35104","2024","COM","2022","1423","28","1451","2024-12-30"
"35105","2024","COM","2022","1713","43","1756","2024-12-30"
"35106","2024","COM","2022","1568","22","1590","2024-12-30"
"35107","2024","COM","2022","2010","38","2048","2024-12-30"
"35108","2024","COM","2022","1028","20","1048","2024-12-30"
"35109","2024","COM","2022","2670","69","2739","2024-12-30"
"35110","2024","COM","2022","1066","16","1082","2024-12-30"
"35111","2024","COM","2022","727","7","734","2024-12-30"
"35114","2024","COM","2022","265","3","268","2024-12-30"
"35115","2024","COM","2022","20602","619","21221","2024-12-30"
"35116","2024","COM","2022","2508","50","2558","2024-12-30"
"35117","2024","COM","2022","1617","31","1648","2024-12-30"
"35118","2024","COM","2022","1523","35","1558","2024-12-30"
"35119","2024","COM","2022","943","19","962","2024-12-30"
"35120","2024","COM","2022","5987","113","6100","2024-12-30"
"35121","2024","COM","2022","2098","33","2131","2024-12-30"
"35122","2024","COM","2022","2000","47","2047","2024-12-30"
"35123","2024","COM","2022","4326","110","4436","2024-12-30"
"35124","2024","COM","2022","2523","40","2563","2024-12-30"
"35125","2024","COM","2022","4450","112","4562","2024-12-30"
"35126","2024","COM","2022","9203","180","9383","2024-12-30"
"35127","2024","COM","2022","4149","97","4246","2024-12-30"
"35128","2024","COM","2022","1735","27","1762","2024-12-30"
"35130","2024","COM","2022","2273","46","2319","2024-12-30"
"35131","2024","COM","2022","4683","72","4755","2024-12-30"
"35132","2024","COM","2022","1384","28","1412","2024-12-30"
"35133","2024","COM","2022","4603","95","4698","2024-12-30"
"35134","2024","COM","2022","274","9","283","2024-12-30"
"35135","2024","COM","2022","2308","33","2341","2024-12-30"
"35136","2024","COM","2022","8618","189","8807","2024-12-30"
"35137","2024","COM","2022","2185","56","2241","2024-12-30"
"35138","2024","COM","2022","1217","36","1253","2024-12-30"
"35139","2024","COM","2022","5154","146","5300","2024-12-30"
"35140","2024","COM","2022","581","5","586","2024-12-30"
"35141","2024","COM","2022","682","18","700","2024-12-30"
"35142","2024","COM","2022","1225","27","1252","2024-12-30"
"35143","2024","COM","2022","930","18","948","2024-12-30"
"35144","2024","COM","2022","1090","19","1109","2024-12-30"
"35145","2024","COM","2022","1393","25","1418","2024-12-30"
"35146","2024","COM","2022","610","10","620","2024-12-30"
"35148","2024","COM","2022","144","2","146","2024-12-30"
"35149","2024","COM","2022","1817","42","1859","2024-12-30"
"35150","2024","COM","2022","3423","103","3526","2024-12-30"
"35151","2024","COM","2022","802","17","819","2024-12-30"
"35152","2024","COM","2022","8987","147","9134","2024-12-30"
"35153","2024","COM","2022","383","9","392","2024-12-30"
"35154","2024","COM","2022","1737","41","1778","2024-12-30"
"35155","2024","COM","2022","700","13","713","2024-12-30"
"35156","2024","COM","2022","598","12","610","2024-12-30"
"35157","2024","COM","2022","618","18","636","2024-12-30"
"35159","2024","COM","2022","335","7","342","2024-12-30"
"35160","2024","COM","2022","235","6","241","2024-12-30"
"35161","2024","COM","2022","1874","37","1911","2024-12-30"
"35162","2024","COM","2022","3352","79","3431","2024-12-30"
"35163","2024","COM","2022","1844","36","1880","2024-12-30"
"35164","2024","COM","2022","737","17","754","2024-12-30"
"35165","2024","COM","2022","994","18","1012","2024-12-30"
"35166","2024","COM","2022","1013","25","1038","2024-12-30"
"35167","2024","COM","2022","2632","56","2688","2024-12-30"
"35168","2024","COM","2022","3925","79","4004","2024-12-30"
"35169","2024","COM","2022","1457","28","1485","2024-12-30"
"35170","2024","COM","2022","613","12","625","2024-12-30"
"35171","2024","COM","2022","1845","36","1881","2024-12-30"
"35172","2024","COM","2022","1975","21","1996","2024-12-30"
"35173","2024","COM","2022","7400","111","7511","2024-12-30"
"35174","2024","COM","2022","648","12","660","2024-12-30"
"35175","2024","COM","2022","1017","11","1028","2024-12-30"
"35176","2024","COM","2022","7243","135","7378","2024-12-30"
"35177","2024","COM","2022","4935","114","5049","2024-12-30"
"35178","2024","COM","2022","1735","17","1752","2024-12-30"
"35179","2024","COM","2022","4379","86","4465","2024-12-30"
"35180","2024","COM","2022","788","19","807","2024-12-30"
"35181","2024","COM","2022","1499","40","1539","2024-12-30"
"35183","2024","COM","2022","806","22","828","2024-12-30"
"35184","2024","COM","2022","6574","202","6776","2024-12-30"
"35185","2024","COM","2022","268","1","269","2024-12-30"
"35186","2024","COM","2022","1076","18","1094","2024-12-30"
"35187","2024","COM","2022","1352","47","1399","2024-12-30"
"35188","2024","COM","2022","6767","185","6952","2024-12-30"
"35189","2024","COM","2022","3777","72","3849","2024-12-30"
"35190","2024","COM","2022","250","8","258","2024-12-30"
"35191","2024","COM","2022","2235","41","2276","2024-12-30"
"35192","2024","COM","2022","235","4","239","2024-12-30"
"35193","2024","COM","2022","2048","42","2090","2024-12-30"
"35194","2024","COM","2022","1041","43","1084","2024-12-30"
"35195","2024","COM","2022","2419","39","2458","2024-12-30"
"35196","2024","COM","2022","7831","127","7958","2024-12-30"
"35197","2024","COM","2022","1728","26","1754","2024-12-30"
"35198","2024","COM","2022","716","27","743","2024-12-30"
"35199","2024","COM","2022","310","11","321","2024-12-30"
"35200","2024","COM","2022","905","26","931","2024-12-30"
"35201","2024","COM","2022","912","16","928","2024-12-30"
"35202","2024","COM","2022","1007","19","1026","2024-12-30"
"35203","2024","COM","2022","357","6","363","2024-12-30"
"35204","2024","COM","2022","3732","59","3791","2024-12-30"
"35205","2024","COM","2022","382","8","390","2024-12-30"
"35206","2024","COM","2022","7995","89","8084","2024-12-30"
"35207","2024","COM","2022","6250","148","6398","2024-12-30"
"35208","2024","COM","2022","5602","65","5667","2024-12-30"
"35210","2024","COM","2022","11815","340","12155","2024-12-30"
"35211","2024","COM","2022","1778","41","1819","2024-12-30"
"35212","2024","COM","2022","1171","24","1195","2024-12-30"
"35214","2024","COM","2022","652","11","663","2024-12-30"
"35215","2024","COM","2022","1301","29","1330","2024-12-30"
"35216","2024","COM","2022","1802","27","1829","2024-12-30"
"35217","2024","COM","2022","1372","25","1397","2024-12-30"
"35218","2024","COM","2022","886","16","902","2024-12-30"
"35219","2024","COM","2022","3871","77","3948","2024-12-30"
"35220","2024","COM","2022","3177","54","3231","2024-12-30"
"35221","2024","COM","2022","2796","56","2852","2024-12-30"
"35222","2024","COM","2022","1978","30","2008","2024-12-30"
"35223","2024","COM","2022","4063","76","4139","2024-12-30"
"35224","2024","COM","2022","2871","37","2908","2024-12-30"
"35225","2024","COM","2022","778","15","793","2024-12-30"
"35226","2024","COM","2022","2063","37","2100","2024-12-30"
"35227","2024","COM","2022","3535","64","3599","2024-12-30"
"35228","2024","COM","2022","7064","135","7199","2024-12-30"
"35229","2024","COM","2022","1317","35","1352","2024-12-30"
"35230","2024","COM","2022","380","6","386","2024-12-30"
"35231","2024","COM","2022","1245","34","1279","2024-12-30"
"35232","2024","COM","2022","398","6","404","2024-12-30"
"35233","2024","COM","2022","1590","34","1624","2024-12-30"
"35234","2024","COM","2022","1272","27","1299","2024-12-30"
"35235","2024","COM","2022","1081","23","1104","2024-12-30"
"35236","2024","COM","2022","9336","750","10086","2024-12-30"
"35237","2024","COM","2022","1032","22","1054","2024-12-30"
"35238","2024","COM","2022","227830","4155","231985","2024-12-30"
"35239","2024","COM","2022","4553","88","4641","2024-12-30"
"35240","2024","COM","2022","9823","233","10056","2024-12-30"
"35241","2024","COM","2022","2624","97","2721","2024-12-30"
"35242","2024","COM","2022","350","4","354","2024-12-30"
"35243","2024","COM","2022","2434","54","2488","2024-12-30"
"35244","2024","COM","2022","275","5","280","2024-12-30"
"35245","2024","COM","2022","4154","82","4236","2024-12-30"
"35246","2024","COM","2022","1376","23","1399","2024-12-30"
"35247","2024","COM","2022","1036","17","1053","2024-12-30"
"35248","2024","COM","2022","457","8","465","2024-12-30"
"35249","2024","COM","2022","1032","23","1055","2024-12-30"
"35250","2024","COM","2022","2344","46","2390","2024-12-30"
"35251","2024","COM","2022","4231","90","4321","2024-12-30"
"35252","2024","COM","2022","923","34","957","2024-12-30"
"35253","2024","COM","2022","4145","206","4351","2024-12-30"
"35255","2024","COM","2022","966","27","993","2024-12-30"
"35256","2024","COM","2022","2228","68","2296","2024-12-30"
"35257","2024","COM","2022","5093","99","5192","2024-12-30"
"35258","2024","COM","2022","323","9","332","2024-12-30"
"35259","2024","COM","2022","1166","20","1186","2024-12-30"
"35260","2024","COM","2022","562","6","568","2024-12-30"
"35261","2024","COM","2022","230","2","232","2024-12-30"
"35262","2024","COM","2022","364","8","372","2024-12-30"
"35263","2024","COM","2022","2970","73","3043","2024-12-30"
"35264","2024","COM","2022","2030","47","2077","2024-12-30"
"35265","2024","COM","2022","2587","51","2638","2024-12-30"
"35266","2024","COM","2022","3615","79","3694","2024-12-30"
"35268","2024","COM","2022","414","10","424","2024-12-30"
"35270","2024","COM","2022","377","4","381","2024-12-30"
"35271","2024","COM","2022","1524","25","1549","2024-12-30"
"35272","2024","COM","2022","1007","19","1026","2024-12-30"
"35273","2024","COM","2022","2091","42","2133","2024-12-30"
"35274","2024","COM","2022","1023","17","1040","2024-12-30"
"35275","2024","COM","2022","5489","76","5565","2024-12-30"
"35276","2024","COM","2022","629","9","638","2024-12-30"
"35277","2024","COM","2022","381","4","385","2024-12-30"
"35278","2024","COM","2022","9992","378","10370","2024-12-30"
"35279","2024","COM","2022","1247","27","1274","2024-12-30"
"35280","2024","COM","2022","1032","19","1051","2024-12-30"
"35281","2024","COM","2022","13593","110","13703","2024-12-30"
"35282","2024","COM","2022","2919","54","2973","2024-12-30"
"35283","2024","COM","2022","1376","24","1400","2024-12-30"
"35284","2024","COM","2022","2816","58","2874","2024-12-30"
"35285","2024","COM","2022","1103","24","1127","2024-12-30"
"35286","2024","COM","2022","295","10","305","2024-12-30"
"35287","2024","COM","2022","2647","70","2717","2024-12-30"
"35288","2024","COM","2022","47255","1258","48513","2024-12-30"
"35289","2024","COM","2022","1074","26","1100","2024-12-30"
"35290","2024","COM","2022","613","10","623","2024-12-30"
"35291","2024","COM","2022","432","8","440","2024-12-30"
"35292","2024","COM","2022","1567","41","1608","2024-12-30"
"35294","2024","COM","2022","2249","66","2315","2024-12-30"
"35295","2024","COM","2022","518","20","538","2024-12-30"
"35296","2024","COM","2022","1350","18","1368","2024-12-30"
"35297","2024","COM","2022","4642","155","4797","2024-12-30"
"35299","2024","COM","2022","4666","105","4771","2024-12-30"
"35300","2024","COM","2022","1357","26","1383","2024-12-30"
"35302","2024","COM","2022","1121","22","1143","2024-12-30"
"35304","2024","COM","2022","1308","26","1334","2024-12-30"
"35305","2024","COM","2022","415","8","423","2024-12-30"
"35306","2024","COM","2022","2399","164","2563","2024-12-30"
"35307","2024","COM","2022","1003","25","1028","2024-12-30"
"35308","2024","COM","2022","4457","86","4543","2024-12-30"
"35309","2024","COM","2022","808","11","819","2024-12-30"
"35310","2024","COM","2022","1565","29","1594","2024-12-30"
"35311","2024","COM","2022","600","8","608","2024-12-30"
"35312","2024","COM","2022","1836","43","1879","2024-12-30"
"35314","2024","COM","2022","977","52","1029","2024-12-30"
"35315","2024","COM","2022","1557","40","1597","2024-12-30"
"35316","2024","COM","2022","827","12","839","2024-12-30"
"35317","2024","COM","2022","613","70","683","2024-12-30"
"35318","2024","COM","2022","999","22","1021","2024-12-30"
"35319","2024","COM","2022","2165","39","2204","2024-12-30"
"35320","2024","COM","2022","512","11","523","2024-12-30"
"35321","2024","COM","2022","798","15","813","2024-12-30"
"35322","2024","COM","2022","1102","29","1131","2024-12-30"
"35324","2024","COM","2022","618","18","636","2024-12-30"
"35325","2024","COM","2022","153","7","160","2024-12-30"
"35326","2024","COM","2022","2620","44","2664","2024-12-30"
"35327","2024","COM","2022","4032","94","4126","2024-12-30"
"35328","2024","COM","2022","2222","41","2263","2024-12-30"
"35329","2024","COM","2022","544","8","552","2024-12-30"
"35330","2024","COM","2022","1036","21","1057","2024-12-30"
"35331","2024","COM","2022","2530","65","2595","2024-12-30"
"35332","2024","COM","2022","1103","23","1126","2024-12-30"
"35333","2024","COM","2022","1720","33","1753","2024-12-30"
"35334","2024","COM","2022","8631","203","8834","2024-12-30"
"35335","2024","COM","2022","857","21","878","2024-12-30"
"35336","2024","COM","2022","194","4","198","2024-12-30"
"35337","2024","COM","2022","3877","223","4100","2024-12-30"
"35338","2024","COM","2022","1270","29","1299","2024-12-30"
"35339","2024","COM","2022","638","11","649","2024-12-30"
"35340","2024","COM","2022","1327","27","1354","2024-12-30"
"35342","2024","COM","2022","349","12","361","2024-12-30"
"35343","2024","COM","2022","1235","32","1267","2024-12-30"
"35345","2024","COM","2022","918","13","931","2024-12-30"
"35346","2024","COM","2022","205","4","209","2024-12-30"
"35347","2024","COM","2022","2601","58","2659","2024-12-30"
"35350","2024","COM","2022","804","17","821","2024-12-30"
"35351","2024","COM","2022","1404","25","1429","2024-12-30"
"35352","2024","COM","2022","8272","155","8427","2024-12-30"
"35353","2024","COM","2022","6441","79","6520","2024-12-30"
"35354","2024","COM","2022","328","2","330","2024-12-30"
"35355","2024","COM","2022","1280","23","1303","2024-12-30"
"35356","2024","COM","2022","2290","36","2326","2024-12-30"
"35357","2024","COM","2022","291","5","296","2024-12-30"
"35358","2024","COM","2022","1226","30","1256","2024-12-30"
"35359","2024","COM","2022","868","9","877","2024-12-30"
"35360","2024","COM","2022","18892","547","19439","2024-12-30"
"35361","2024","COM","2022","1062","8","1070","2024-12-30"
"35362","2024","COM","2022","1204","16","1220","2024-12-30"
"35363","2024","COM","2022","4289","106","4395","2024-12-30"
"36001","2024","COM","2022","1329","19","1348","2024-12-30"
"36002","2024","COM","2022","116","2","118","2024-12-30"
"36003","2024","COM","2022","887","19","906","2024-12-30"
"36004","2024","COM","2022","315","9","324","2024-12-30"
"36005","2024","COM","2022","3747","94","3841","2024-12-30"
"36006","2024","COM","2022","4817","225","5042","2024-12-30"
"36007","2024","COM","2022","574","10","584","2024-12-30"
"36008","2024","COM","2022","238","6","244","2024-12-30"
"36009","2024","COM","2022","1216","43","1259","2024-12-30"
"36010","2024","COM","2022","835","18","853","2024-12-30"
"36011","2024","COM","2022","173","3","176","2024-12-30"
"36012","2024","COM","2022","357","6","363","2024-12-30"
"36013","2024","COM","2022","400","8","408","2024-12-30"
"36014","2024","COM","2022","213","3","216","2024-12-30"
"36015","2024","COM","2022","51","1","52","2024-12-30"
"36016","2024","COM","2022","926","18","944","2024-12-30"
"36017","2024","COM","2022","361","6","367","2024-12-30"
"36018","2024","COM","2022","6188","226","6414","2024-12-30"
"36019","2024","COM","2022","320","4","324","2024-12-30"
"36020","2024","COM","2022","75","0","75","2024-12-30"
"36021","2024","COM","2022","824","22","846","2024-12-30"
"36022","2024","COM","2022","388","11","399","2024-12-30"
"36023","2024","COM","2022","264","5","269","2024-12-30"
"36024","2024","COM","2022","122","1","123","2024-12-30"
"36025","2024","COM","2022","596","13","609","2024-12-30"
"36026","2024","COM","2022","595","13","608","2024-12-30"
"36027","2024","COM","2022","239","6","245","2024-12-30"
"36028","2024","COM","2022","111","3","114","2024-12-30"
"36029","2024","COM","2022","221","4","225","2024-12-30"
"36030","2024","COM","2022","243","2","245","2024-12-30"
"36031","2024","COM","2022","4431","90","4521","2024-12-30"
"36032","2024","COM","2022","673","15","688","2024-12-30"
"36033","2024","COM","2022","383","3","386","2024-12-30"
"36034","2024","COM","2022","2762","43","2805","2024-12-30"
"36035","2024","COM","2022","1031","13","1044","2024-12-30"
"36036","2024","COM","2022","151","2","153","2024-12-30"
"36037","2024","COM","2022","305","6","311","2024-12-30"
"36038","2024","COM","2022","126","2","128","2024-12-30"
"36040","2024","COM","2022","100","0","100","2024-12-30"
"36041","2024","COM","2022","136","1","137","2024-12-30"
"36042","2024","COM","2022","710","9","719","2024-12-30"
"36043","2024","COM","2022","533","13","546","2024-12-30"
"36044","2024","COM","2022","43079","1585","44664","2024-12-30"
"36045","2024","COM","2022","2296","32","2328","2024-12-30"
"36046","2024","COM","2022","4038","126","4164","2024-12-30"
"36047","2024","COM","2022","503","6","509","2024-12-30"
"36048","2024","COM","2022","270","6","276","2024-12-30"
"36049","2024","COM","2022","124","2","126","2024-12-30"
"36050","2024","COM","2022","451","9","460","2024-12-30"
"36051","2024","COM","2022","173","2","175","2024-12-30"
"36052","2024","COM","2022","145","4","149","2024-12-30"
"36053","2024","COM","2022","523","13","536","2024-12-30"
"36054","2024","COM","2022","234","8","242","2024-12-30"
"36055","2024","COM","2022","1007","15","1022","2024-12-30"
"36056","2024","COM","2022","979","17","996","2024-12-30"
"36057","2024","COM","2022","903","16","919","2024-12-30"
"36058","2024","COM","2022","595","16","611","2024-12-30"
"36059","2024","COM","2022","227","3","230","2024-12-30"
"36060","2024","COM","2022","706","16","722","2024-12-30"
"36061","2024","COM","2022","331","9","340","2024-12-30"
"36062","2024","COM","2022","474","7","481","2024-12-30"
"36063","2024","COM","2022","7618","152","7770","2024-12-30"
"36064","2024","COM","2022","755","18","773","2024-12-30"
"36065","2024","COM","2022","259","4","263","2024-12-30"
"36066","2024","COM","2022","473","14","487","2024-12-30"
"36067","2024","COM","2022","103","1","104","2024-12-30"
"36068","2024","COM","2022","437","7","444","2024-12-30"
"36069","2024","COM","2022","1189","23","1212","2024-12-30"
"36070","2024","COM","2022","1314","37","1351","2024-12-30"
"36071","2024","COM","2022","1002","19","1021","2024-12-30"
"36073","2024","COM","2022","208","5","213","2024-12-30"
"36074","2024","COM","2022","549","9","558","2024-12-30"
"36075","2024","COM","2022","77","0","77","2024-12-30"
"36076","2024","COM","2022","262","6","268","2024-12-30"
"36077","2024","COM","2022","252","3","255","2024-12-30"
"36078","2024","COM","2022","352","9","361","2024-12-30"
"36079","2024","COM","2022","76","2","78","2024-12-30"
"36080","2024","COM","2022","76","1","77","2024-12-30"
"36081","2024","COM","2022","267","5","272","2024-12-30"
"36082","2024","COM","2022","254","4","258","2024-12-30"
"36083","2024","COM","2022","121","2","123","2024-12-30"
"36084","2024","COM","2022","280","6","286","2024-12-30"
"36085","2024","COM","2022","239","5","244","2024-12-30"
"36086","2024","COM","2022","385","4","389","2024-12-30"
"36087","2024","COM","2022","299","5","304","2024-12-30"
"36088","2024","COM","2022","10953","253","11206","2024-12-30"
"36089","2024","COM","2022","405","4","409","2024-12-30"
"36090","2024","COM","2022","119","2","121","2024-12-30"
"36091","2024","COM","2022","655","18","673","2024-12-30"
"36092","2024","COM","2022","260","7","267","2024-12-30"
"36093","2024","COM","2022","2802","26","2828","2024-12-30"
"36094","2024","COM","2022","459","16","475","2024-12-30"
"36095","2024","COM","2022","115","2","117","2024-12-30"
"36096","2024","COM","2022","203","3","206","2024-12-30"
"36097","2024","COM","2022","324","8","332","2024-12-30"
"36098","2024","COM","2022","83","2","85","2024-12-30"
"36099","2024","COM","2022","303","6","309","2024-12-30"
"36100","2024","COM","2022","250","6","256","2024-12-30"
"36101","2024","COM","2022","1584","28","1612","2024-12-30"
"36102","2024","COM","2022","105","2","107","2024-12-30"
"36103","2024","COM","2022","1315","20","1335","2024-12-30"
"36104","2024","COM","2022","227","2","229","2024-12-30"
"36105","2024","COM","2022","274","1","275","2024-12-30"
"36106","2024","COM","2022","155","1","156","2024-12-30"
"36107","2024","COM","2022","757","13","770","2024-12-30"
"36108","2024","COM","2022","200","2","202","2024-12-30"
"36109","2024","COM","2022","1015","19","1034","2024-12-30"
"36110","2024","COM","2022","242","3","245","2024-12-30"
"36111","2024","COM","2022","189","3","192","2024-12-30"
"36112","2024","COM","2022","736","12","748","2024-12-30"
"36113","2024","COM","2022","950","9","959","2024-12-30"
"36114","2024","COM","2022","307","3","310","2024-12-30"
"36115","2024","COM","2022","143","3","146","2024-12-30"
"36116","2024","COM","2022","117","4","121","2024-12-30"
"36117","2024","COM","2022","412","11","423","2024-12-30"
"36118","2024","COM","2022","366","4","370","2024-12-30"
"36119","2024","COM","2022","544","14","558","2024-12-30"
"36120","2024","COM","2022","664","16","680","2024-12-30"
"36121","2024","COM","2022","168","7","175","2024-12-30"
"36122","2024","COM","2022","196","5","201","2024-12-30"
"36123","2024","COM","2022","956","12","968","2024-12-30"
"36124","2024","COM","2022","228","5","233","2024-12-30"
"36125","2024","COM","2022","110","5","115","2024-12-30"
"36126","2024","COM","2022","448","4","452","2024-12-30"
"36127","2024","COM","2022","1557","26","1583","2024-12-30"
"36128","2024","COM","2022","1637","171","1808","2024-12-30"
"36129","2024","COM","2022","611","14","625","2024-12-30"
"36130","2024","COM","2022","106","2","108","2024-12-30"
"36131","2024","COM","2022","463","7","470","2024-12-30"
"36132","2024","COM","2022","74","0","74","2024-12-30"
"36133","2024","COM","2022","205","6","211","2024-12-30"
"36134","2024","COM","2022","411","12","423","2024-12-30"
"36135","2024","COM","2022","277","4","281","2024-12-30"
"36136","2024","COM","2022","122","3","125","2024-12-30"
"36137","2024","COM","2022","355","5","360","2024-12-30"
"36138","2024","COM","2022","188","4","192","2024-12-30"
"36139","2024","COM","2022","659","13","672","2024-12-30"
"36140","2024","COM","2022","1161","19","1180","2024-12-30"
"36141","2024","COM","2022","1657","33","1690","2024-12-30"
"36142","2024","COM","2022","1457","31","1488","2024-12-30"
"36143","2024","COM","2022","451","13","464","2024-12-30"
"36144","2024","COM","2022","293","6","299","2024-12-30"
"36145","2024","COM","2022","225","3","228","2024-12-30"
"36146","2024","COM","2022","705","9","714","2024-12-30"
"36147","2024","COM","2022","141","3","144","2024-12-30"
"36148","2024","COM","2022","420","3","423","2024-12-30"
"36149","2024","COM","2022","789","12","801","2024-12-30"
"36150","2024","COM","2022","511","7","518","2024-12-30"
"36152","2024","COM","2022","437","7","444","2024-12-30"
"36153","2024","COM","2022","349","9","358","2024-12-30"
"36154","2024","COM","2022","1781","46","1827","2024-12-30"
"36155","2024","COM","2022","794","55","849","2024-12-30"
"36156","2024","COM","2022","415","6","421","2024-12-30"
"36157","2024","COM","2022","435","16","451","2024-12-30"
"36158","2024","COM","2022","761","12","773","2024-12-30"
"36159","2024","COM","2022","5848","156","6004","2024-12-30"
"36160","2024","COM","2022","228","4","232","2024-12-30"
"36161","2024","COM","2022","934","18","952","2024-12-30"
"36162","2024","COM","2022","816","15","831","2024-12-30"
"36163","2024","COM","2022","641","11","652","2024-12-30"
"36164","2024","COM","2022","232","2","234","2024-12-30"
"36165","2024","COM","2022","1032","33","1065","2024-12-30"
"36166","2024","COM","2022","172","6","178","2024-12-30"
"36167","2024","COM","2022","151","3","154","2024-12-30"
"36168","2024","COM","2022","577","10","587","2024-12-30"
"36169","2024","COM","2022","497","10","507","2024-12-30"
"36170","2024","COM","2022","104","0","104","2024-12-30"
"36171","2024","COM","2022","2009","32","2041","2024-12-30"
"36172","2024","COM","2022","491","10","501","2024-12-30"
"36173","2024","COM","2022","522","8","530","2024-12-30"
"36174","2024","COM","2022","358","6","364","2024-12-30"
"36175","2024","COM","2022","278","2","280","2024-12-30"
"36176","2024","COM","2022","569","7","576","2024-12-30"
"36177","2024","COM","2022","308","6","314","2024-12-30"
"36178","2024","COM","2022","272","13","285","2024-12-30"
"36179","2024","COM","2022","211","7","218","2024-12-30"
"36180","2024","COM","2022","817","16","833","2024-12-30"
"36181","2024","COM","2022","151","2","153","2024-12-30"
"36182","2024","COM","2022","510","7","517","2024-12-30"
"36184","2024","COM","2022","465","4","469","2024-12-30"
"36185","2024","COM","2022","353","9","362","2024-12-30"
"36186","2024","COM","2022","234","2","236","2024-12-30"
"36187","2024","COM","2022","138","1","139","2024-12-30"
"36188","2024","COM","2022","171","144","315","2024-12-30"
"36189","2024","COM","2022","969","14","983","2024-12-30"
"36190","2024","COM","2022","260","1","261","2024-12-30"
"36191","2024","COM","2022","508","8","516","2024-12-30"
"36192","2024","COM","2022","1714","22","1736","2024-12-30"
"36193","2024","COM","2022","257","7","264","2024-12-30"
"36194","2024","COM","2022","939","18","957","2024-12-30"
"36195","2024","COM","2022","554","8","562","2024-12-30"
"36196","2024","COM","2022","92","3","95","2024-12-30"
"36197","2024","COM","2022","314","4","318","2024-12-30"
"36198","2024","COM","2022","410","15","425","2024-12-30"
"36199","2024","COM","2022","1109","22","1131","2024-12-30"
"36200","2024","COM","2022","1510","34","1544","2024-12-30"
"36202","2024","COM","2022","3589","67","3656","2024-12-30"
"36203","2024","COM","2022","61","0","61","2024-12-30"
"36204","2024","COM","2022","318","4","322","2024-12-30"
"36205","2024","COM","2022","98","3","101","2024-12-30"
"36207","2024","COM","2022","602","7","609","2024-12-30"
"36208","2024","COM","2022","775","4","779","2024-12-30"
"36209","2024","COM","2022","263","12","275","2024-12-30"
"36210","2024","COM","2022","300","6","306","2024-12-30"
"36211","2024","COM","2022","447","8","455","2024-12-30"
"36212","2024","COM","2022","164","5","169","2024-12-30"
"36213","2024","COM","2022","256","4","260","2024-12-30"
"36214","2024","COM","2022","296","11","307","2024-12-30"
"36215","2024","COM","2022","487","11","498","2024-12-30"
"36216","2024","COM","2022","62","0","62","2024-12-30"
"36217","2024","COM","2022","101","2","103","2024-12-30"
"36218","2024","COM","2022","146","5","151","2024-12-30"
"36219","2024","COM","2022","654","20","674","2024-12-30"
"36220","2024","COM","2022","897","19","916","2024-12-30"
"36221","2024","COM","2022","395","8","403","2024-12-30"
"36222","2024","COM","2022","229","6","235","2024-12-30"
"36223","2024","COM","2022","138","5","143","2024-12-30"
"36224","2024","COM","2022","1120","25","1145","2024-12-30"
"36225","2024","COM","2022","171","5","176","2024-12-30"
"36226","2024","COM","2022","347","11","358","2024-12-30"
"36227","2024","COM","2022","239","5","244","2024-12-30"
"36228","2024","COM","2022","2239","44","2283","2024-12-30"
"36229","2024","COM","2022","944","15","959","2024-12-30"
"36230","2024","COM","2022","1959","34","1993","2024-12-30"
"36231","2024","COM","2022","979","19","998","2024-12-30"
"36232","2024","COM","2022","1094","25","1119","2024-12-30"
"36233","2024","COM","2022","799","11","810","2024-12-30"
"36234","2024","COM","2022","343","8","351","2024-12-30"
"36235","2024","COM","2022","378","7","385","2024-12-30"
"36236","2024","COM","2022","321","8","329","2024-12-30"
"36237","2024","COM","2022","681","18","699","2024-12-30"
"36238","2024","COM","2022","99","1","100","2024-12-30"
"36239","2024","COM","2022","469","11","480","2024-12-30"
"36240","2024","COM","2022","289","4","293","2024-12-30"
"36241","2024","COM","2022","2615","41","2656","2024-12-30"
"36242","2024","COM","2022","103","1","104","2024-12-30"
"36243","2024","COM","2022","321","2","323","2024-12-30"
"36244","2024","COM","2022","880","11","891","2024-12-30"
"36246","2024","COM","2022","174","1","175","2024-12-30"
"36247","2024","COM","2022","1245","25","1270","2024-12-30"
"36248","2024","COM","2022","224","4","228","2024-12-30"
"37001","2024","COM","2022","1125","15","1140","2024-12-30"
"37002","2024","COM","2022","1748","25","1773","2024-12-30"
"37003","2024","COM","2022","13132","393","13525","2024-12-30"
"37004","2024","COM","2022","429","7","436","2024-12-30"
"37005","2024","COM","2022","492","11","503","2024-12-30"
"37006","2024","COM","2022","2782","55","2837","2024-12-30"
"37007","2024","COM","2022","173","8","181","2024-12-30"
"37008","2024","COM","2022","2848","32","2880","2024-12-30"
"37009","2024","COM","2022","419","10","429","2024-12-30"
"37010","2024","COM","2022","2172","56","2228","2024-12-30"
"37011","2024","COM","2022","1994","42","2036","2024-12-30"
"37012","2024","COM","2022","539","8","547","2024-12-30"
"37013","2024","COM","2022","475","10","485","2024-12-30"
"37014","2024","COM","2022","3415","91","3506","2024-12-30"
"37015","2024","COM","2022","3127","65","3192","2024-12-30"
"37016","2024","COM","2022","363","13","376","2024-12-30"
"37018","2024","COM","2022","8347","172","8519","2024-12-30"
"37019","2024","COM","2022","480","11","491","2024-12-30"
"37020","2024","COM","2022","1746","30","1776","2024-12-30"
"37021","2024","COM","2022","1788","36","1824","2024-12-30"
"37022","2024","COM","2022","2719","87","2806","2024-12-30"
"37023","2024","COM","2022","240","9","249","2024-12-30"
"37024","2024","COM","2022","948","17","965","2024-12-30"
"37025","2024","COM","2022","699","12","711","2024-12-30"
"37026","2024","COM","2022","508","4","512","2024-12-30"
"37027","2024","COM","2022","5340","64","5404","2024-12-30"
"37028","2024","COM","2022","729","19","748","2024-12-30"
"37029","2024","COM","2022","325","4","329","2024-12-30"
"37030","2024","COM","2022","813","16","829","2024-12-30"
"37031","2024","COM","2022","3648","106","3754","2024-12-30"
"37032","2024","COM","2022","282","7","289","2024-12-30"
"37033","2024","COM","2022","226","3","229","2024-12-30"
"37034","2024","COM","2022","320","9","329","2024-12-30"
"37035","2024","COM","2022","281","4","285","2024-12-30"
"37036","2024","COM","2022","201","1","202","2024-12-30"
"37037","2024","COM","2022","222","6","228","2024-12-30"
"37038","2024","COM","2022","728","8","736","2024-12-30"
"37039","2024","COM","2022","489","12","501","2024-12-30"
"37040","2024","COM","2022","253","9","262","2024-12-30"
"37041","2024","COM","2022","325","3","328","2024-12-30"
"37042","2024","COM","2022","182","0","182","2024-12-30"
"37043","2024","COM","2022","1030","25","1055","2024-12-30"
"37044","2024","COM","2022","381","5","386","2024-12-30"
"37045","2024","COM","2022","1059","10","1069","2024-12-30"
"37046","2024","COM","2022","424","9","433","2024-12-30"
"37047","2024","COM","2022","1247","27","1274","2024-12-30"
"37048","2024","COM","2022","317","8","325","2024-12-30"
"37049","2024","COM","2022","1235","24","1259","2024-12-30"
"37050","2024","COM","2022","11877","210","12087","2024-12-30"
"37051","2024","COM","2022","813","12","825","2024-12-30"
"37052","2024","COM","2022","1123","26","1149","2024-12-30"
"37053","2024","COM","2022","113","7","120","2024-12-30"
"37054","2024","COM","2022","3509","64","3573","2024-12-30"
"37055","2024","COM","2022","809","17","826","2024-12-30"
"37056","2024","COM","2022","558","12","570","2024-12-30"
"37057","2024","COM","2022","691","14","705","2024-12-30"
"37058","2024","COM","2022","1472","24","1496","2024-12-30"
"37059","2024","COM","2022","1385","34","1419","2024-12-30"
"37060","2024","COM","2022","1352","20","1372","2024-12-30"
"37061","2024","COM","2022","468","15","483","2024-12-30"
"37062","2024","COM","2022","1734","18","1752","2024-12-30"
"37063","2024","COM","2022","4560","72","4632","2024-12-30"
"37064","2024","COM","2022","204","8","212","2024-12-30"
"37065","2024","COM","2022","562","6","568","2024-12-30"
"37066","2024","COM","2022","560","7","567","2024-12-30"
"37067","2024","COM","2022","1859","41","1900","2024-12-30"
"37068","2024","COM","2022","707","13","720","2024-12-30"
"37069","2024","COM","2022","230","7","237","2024-12-30"
"37070","2024","COM","2022","334","12","346","2024-12-30"
"37071","2024","COM","2022","130","1","131","2024-12-30"
"37072","2024","COM","2022","8121","293","8414","2024-12-30"
"37073","2024","COM","2022","590","11","601","2024-12-30"
"37074","2024","COM","2022","2150","24","2174","2024-12-30"
"37075","2024","COM","2022","462","10","472","2024-12-30"
"37076","2024","COM","2022","378","10","388","2024-12-30"
"37077","2024","COM","2022","3943","57","4000","2024-12-30"
"37078","2024","COM","2022","428","11","439","2024-12-30"
"37079","2024","COM","2022","1828","58","1886","2024-12-30"
"37080","2024","COM","2022","213","4","217","2024-12-30"
"37081","2024","COM","2022","1398","22","1420","2024-12-30"
"37082","2024","COM","2022","467","2","469","2024-12-30"
"37083","2024","COM","2022","1860","37","1897","2024-12-30"
"37084","2024","COM","2022","556","7","563","2024-12-30"
"37085","2024","COM","2022","796","19","815","2024-12-30"
"37086","2024","COM","2022","480","10","490","2024-12-30"
"37087","2024","COM","2022","237","5","242","2024-12-30"
"37088","2024","COM","2022","117","1","118","2024-12-30"
"37089","2024","COM","2022","680","12","692","2024-12-30"
"37090","2024","COM","2022","113","2","115","2024-12-30"
"37091","2024","COM","2022","2484","69","2553","2024-12-30"
"37092","2024","COM","2022","651","15","666","2024-12-30"
"37093","2024","COM","2022","530","7","537","2024-12-30"
"37094","2024","COM","2022","567","9","576","2024-12-30"
"37095","2024","COM","2022","338","8","346","2024-12-30"
"37096","2024","COM","2022","637","12","649","2024-12-30"
"37097","2024","COM","2022","657","16","673","2024-12-30"
"37098","2024","COM","2022","700","16","716","2024-12-30"
"37099","2024","COM","2022","999","16","1015","2024-12-30"
"37100","2024","COM","2022","400","2","402","2024-12-30"
"37101","2024","COM","2022","159","1","160","2024-12-30"
"37103","2024","COM","2022","154","3","157","2024-12-30"
"37104","2024","COM","2022","6264","110","6374","2024-12-30"
"37105","2024","COM","2022","272","5","277","2024-12-30"
"37106","2024","COM","2022","312","5","317","2024-12-30"
"37107","2024","COM","2022","239","3","242","2024-12-30"
"37108","2024","COM","2022","707","14","721","2024-12-30"
"37109","2024","COM","2022","10917","455","11372","2024-12-30"
"37110","2024","COM","2022","1453","35","1488","2024-12-30"
"37111","2024","COM","2022","1508","36","1544","2024-12-30"
"37112","2024","COM","2022","377","1","378","2024-12-30"
"37113","2024","COM","2022","879","21","900","2024-12-30"
"37114","2024","COM","2022","175","6","181","2024-12-30"
"37115","2024","COM","2022","3289","52","3341","2024-12-30"
"37116","2024","COM","2022","573","10","583","2024-12-30"
"37117","2024","COM","2022","867","9","876","2024-12-30"
"37118","2024","COM","2022","1446","35","1481","2024-12-30"
"37119","2024","COM","2022","1590","30","1620","2024-12-30"
"37121","2024","COM","2022","244","5","249","2024-12-30"
"37122","2024","COM","2022","38432","410","38842","2024-12-30"
"37123","2024","COM","2022","4370","60","4430","2024-12-30"
"37124","2024","COM","2022","2577","46","2623","2024-12-30"
"37125","2024","COM","2022","414","5","419","2024-12-30"
"37126","2024","COM","2022","347","7","354","2024-12-30"
"37127","2024","COM","2022","326","7","333","2024-12-30"
"37128","2024","COM","2022","1319","25","1344","2024-12-30"
"37129","2024","COM","2022","1070","16","1086","2024-12-30"
"37130","2024","COM","2022","2113","32","2145","2024-12-30"
"37131","2024","COM","2022","1261","22","1283","2024-12-30"
"37132","2024","COM","2022","6233","525","6758","2024-12-30"
"37133","2024","COM","2022","472","9","481","2024-12-30"
"37134","2024","COM","2022","713","14","727","2024-12-30"
"37136","2024","COM","2022","531","10","541","2024-12-30"
"37137","2024","COM","2022","140","4","144","2024-12-30"
"37138","2024","COM","2022","890","17","907","2024-12-30"
"37139","2024","COM","2022","5081","145","5226","2024-12-30"
"37140","2024","COM","2022","274","5","279","2024-12-30"
"37141","2024","COM","2022","983","17","1000","2024-12-30"
"37142","2024","COM","2022","559","8","567","2024-12-30"
"37143","2024","COM","2022","1377","28","1405","2024-12-30"
"37144","2024","COM","2022","487","5","492","2024-12-30"
"37145","2024","COM","2022","251","2","253","2024-12-30"
"37146","2024","COM","2022","216","3","219","2024-12-30"
"37147","2024","COM","2022","556","11","567","2024-12-30"
"37148","2024","COM","2022","605","13","618","2024-12-30"
"37149","2024","COM","2022","489","13","502","2024-12-30"
"37150","2024","COM","2022","1463","11","1474","2024-12-30"
"37151","2024","COM","2022","3270","60","3330","2024-12-30"
"37152","2024","COM","2022","2079","69","2148","2024-12-30"
"37153","2024","COM","2022","4785","72","4857","2024-12-30"
"37154","2024","COM","2022","4839","98","4937","2024-12-30"
"37155","2024","COM","2022","643","19","662","2024-12-30"
"37156","2024","COM","2022","11261","169","11430","2024-12-30"
"37157","2024","COM","2022","313","5","318","2024-12-30"
"37158","2024","COM","2022","750","12","762","2024-12-30"
"37159","2024","COM","2022","8031","146","8177","2024-12-30"
"37160","2024","COM","2022","348","9","357","2024-12-30"
"37161","2024","COM","2022","815","18","833","2024-12-30"
"37162","2024","COM","2022","462","11","473","2024-12-30"
"37163","2024","COM","2022","3682","59","3741","2024-12-30"
"37165","2024","COM","2022","424","10","434","2024-12-30"
"37166","2024","COM","2022","763","14","777","2024-12-30"
"37167","2024","COM","2022","2238","22","2260","2024-12-30"
"37168","2024","COM","2022","287","10","297","2024-12-30"
"37169","2024","COM","2022","890","16","906","2024-12-30"
"37170","2024","COM","2022","1061","67","1128","2024-12-30"
"37171","2024","COM","2022","1142","23","1165","2024-12-30"
"37172","2024","COM","2022","4358","81","4439","2024-12-30"
"37173","2024","COM","2022","669","10","679","2024-12-30"
"37174","2024","COM","2022","798","12","810","2024-12-30"
"37175","2024","COM","2022","1236","26","1262","2024-12-30"
"37176","2024","COM","2022","1170","50","1220","2024-12-30"
"37177","2024","COM","2022","711","16","727","2024-12-30"
"37178","2024","COM","2022","599","10","609","2024-12-30"
"37179","2024","COM","2022","2574","34","2608","2024-12-30"
"37180","2024","COM","2022","621","20","641","2024-12-30"
"37181","2024","COM","2022","238","2","240","2024-12-30"
"37182","2024","COM","2022","1556","17","1573","2024-12-30"
"37183","2024","COM","2022","1417","23","1440","2024-12-30"
"37184","2024","COM","2022","307","6","313","2024-12-30"
"37185","2024","COM","2022","1760","77","1837","2024-12-30"
"37186","2024","COM","2022","1214","17","1231","2024-12-30"
"37187","2024","COM","2022","353","3","356","2024-12-30"
"37188","2024","COM","2022","881","9","890","2024-12-30"
"37189","2024","COM","2022","1027","19","1046","2024-12-30"
"37190","2024","COM","2022","160","1","161","2024-12-30"
"37191","2024","COM","2022","221","3","224","2024-12-30"
"37192","2024","COM","2022","1309","21","1330","2024-12-30"
"37193","2024","COM","2022","1121","28","1149","2024-12-30"
"37194","2024","COM","2022","1764","42","1806","2024-12-30"
"37195","2024","COM","2022","10349","103","10452","2024-12-30"
"37196","2024","COM","2022","1620","18","1638","2024-12-30"
"37197","2024","COM","2022","526","12","538","2024-12-30"
"37198","2024","COM","2022","314","1","315","2024-12-30"
"37199","2024","COM","2022","462","6","468","2024-12-30"
"37200","2024","COM","2022","988","17","1005","2024-12-30"
"37201","2024","COM","2022","700","17","717","2024-12-30"
"37202","2024","COM","2022","546","11","557","2024-12-30"
"37203","2024","COM","2022","3220","81","3301","2024-12-30"
"37204","2024","COM","2022","1355","20","1375","2024-12-30"
"37205","2024","COM","2022","1405","16","1421","2024-12-30"
"37206","2024","COM","2022","1786","37","1823","2024-12-30"
"37207","2024","COM","2022","351","2","353","2024-12-30"
"37208","2024","COM","2022","15075","343","15418","2024-12-30"
"37210","2024","COM","2022","848","17","865","2024-12-30"
"37211","2024","COM","2022","2632","51","2683","2024-12-30"
"37212","2024","COM","2022","760","12","772","2024-12-30"
"37213","2024","COM","2022","1077","19","1096","2024-12-30"
"37214","2024","COM","2022","16766","317","17083","2024-12-30"
"37216","2024","COM","2022","1486","32","1518","2024-12-30"
"37217","2024","COM","2022","1595","22","1617","2024-12-30"
"37218","2024","COM","2022","577","12","589","2024-12-30"
"37219","2024","COM","2022","1022","12","1034","2024-12-30"
"37220","2024","COM","2022","358","4","362","2024-12-30"
"37221","2024","COM","2022","620","8","628","2024-12-30"
"37222","2024","COM","2022","746","17","763","2024-12-30"
"37223","2024","COM","2022","344","6","350","2024-12-30"
"37224","2024","COM","2022","873","20","893","2024-12-30"
"37225","2024","COM","2022","3193","49","3242","2024-12-30"
"37226","2024","COM","2022","4118","47","4165","2024-12-30"
"37228","2024","COM","2022","1118","24","1142","2024-12-30"
"37229","2024","COM","2022","241","8","249","2024-12-30"
"37230","2024","COM","2022","975","20","995","2024-12-30"
"37231","2024","COM","2022","1697","31","1728","2024-12-30"
"37232","2024","COM","2022","1872","36","1908","2024-12-30"
"37233","2024","COM","2022","15698","235","15933","2024-12-30"
"37234","2024","COM","2022","492","15","507","2024-12-30"
"37236","2024","COM","2022","626","11","637","2024-12-30"
"37237","2024","COM","2022","1335","30","1365","2024-12-30"
"37238","2024","COM","2022","520","8","528","2024-12-30"
"37240","2024","COM","2022","643","13","656","2024-12-30"
"37241","2024","COM","2022","1314","18","1332","2024-12-30"
"37242","2024","COM","2022","1539","32","1571","2024-12-30"
"37243","2024","COM","2022","3346","61","3407","2024-12-30"
"37244","2024","COM","2022","269","4","273","2024-12-30"
"37245","2024","COM","2022","2170","46","2216","2024-12-30"
"37246","2024","COM","2022","217","2","219","2024-12-30"
"37247","2024","COM","2022","605","9","614","2024-12-30"
"37248","2024","COM","2022","392","22","414","2024-12-30"
"37249","2024","COM","2022","1414","34","1448","2024-12-30"
"37250","2024","COM","2022","2877","106","2983","2024-12-30"
"37251","2024","COM","2022","932","10","942","2024-12-30"
"37252","2024","COM","2022","391","6","397","2024-12-30"
"37253","2024","COM","2022","176","6","182","2024-12-30"
"37254","2024","COM","2022","1683","37","1720","2024-12-30"
"37255","2024","COM","2022","267","2","269","2024-12-30"
"37256","2024","COM","2022","289","4","293","2024-12-30"
"37257","2024","COM","2022","1798","28","1826","2024-12-30"
"37258","2024","COM","2022","302","4","306","2024-12-30"
"37259","2024","COM","2022","437","10","447","2024-12-30"
"37260","2024","COM","2022","502","11","513","2024-12-30"
"37261","2024","COM","2022","138668","2465","141133","2024-12-30"
"37262","2024","COM","2022","289","2","291","2024-12-30"
"37263","2024","COM","2022","2430","31","2461","2024-12-30"
"37264","2024","COM","2022","1339","20","1359","2024-12-30"
"37265","2024","COM","2022","254","6","260","2024-12-30"
"37266","2024","COM","2022","6734","120","6854","2024-12-30"
"37267","2024","COM","2022","4682","91","4773","2024-12-30"
"37268","2024","COM","2022","125","0","125","2024-12-30"
"37269","2024","COM","2022","467","12","479","2024-12-30"
"37270","2024","COM","2022","2871","59","2930","2024-12-30"
"37271","2024","COM","2022","1043","11","1054","2024-12-30"
"37272","2024","COM","2022","1138","35","1173","2024-12-30"
"37273","2024","COM","2022","5575","73","5648","2024-12-30"
"37274","2024","COM","2022","304","2","306","2024-12-30"
"37275","2024","COM","2022","127","1","128","2024-12-30"
"37276","2024","COM","2022","1299","26","1325","2024-12-30"
"37277","2024","COM","2022","584","5","589","2024-12-30"
"37278","2024","COM","2022","1110","11","1121","2024-12-30"
"37279","2024","COM","2022","735","10","745","2024-12-30"
"37280","2024","COM","2022","245","6","251","2024-12-30"
"37281","2024","COM","2022","3397","63","3460","2024-12-30"
"37282","2024","COM","2022","1345","26","1371","2024-12-30"
"38001","2024","COM","2022","6713","127","6840","2024-12-30"
"38002","2024","COM","2022","1072","31","1103","2024-12-30"
"38003","2024","COM","2022","1240","24","1264","2024-12-30"
"38004","2024","COM","2022","1275","34","1309","2024-12-30"
"38005","2024","COM","2022","955","13","968","2024-12-30"
"38006","2024","COM","2022","3962","107","4069","2024-12-30"
"38008","2024","COM","2022","32","2","34","2024-12-30"
"38009","2024","COM","2022","1023","15","1038","2024-12-30"
"38010","2024","COM","2022","724","18","742","2024-12-30"
"38011","2024","COM","2022","1137","11","1148","2024-12-30"
"38012","2024","COM","2022","2869","51","2920","2024-12-30"
"38013","2024","COM","2022","3602","90","3692","2024-12-30"
"38015","2024","COM","2022","1815","39","1854","2024-12-30"
"38017","2024","COM","2022","1722","37","1759","2024-12-30"
"38018","2024","COM","2022","369","12","381","2024-12-30"
"38019","2024","COM","2022","1465","29","1494","2024-12-30"
"38020","2024","COM","2022","187","2","189","2024-12-30"
"38022","2024","COM","2022","7699","158","7857","2024-12-30"
"38023","2024","COM","2022","197","5","202","2024-12-30"
"38026","2024","COM","2022","1157","18","1175","2024-12-30"
"38027","2024","COM","2022","2002","61","2063","2024-12-30"
"38029","2024","COM","2022","2025","48","2073","2024-12-30"
"38030","2024","COM","2022","1843","32","1875","2024-12-30"
"38031","2024","COM","2022","20","0","20","2024-12-30"
"38032","2024","COM","2022","576","8","584","2024-12-30"
"38033","2024","COM","2022","630","18","648","2024-12-30"
"38034","2024","COM","2022","5007","85","5092","2024-12-30"
"38035","2024","COM","2022","1103","20","1123","2024-12-30"
"38036","2024","COM","2022","96","1","97","2024-12-30"
"38037","2024","COM","2022","1015","15","1030","2024-12-30"
"38038","2024","COM","2022","624","15","639","2024-12-30"
"38039","2024","COM","2022","3230","68","3298","2024-12-30"
"38040","2024","COM","2022","153","1","154","2024-12-30"
"38041","2024","COM","2022","117","1","118","2024-12-30"
"38042","2024","COM","2022","1042","22","1064","2024-12-30"
"38043","2024","COM","2022","1601","44","1645","2024-12-30"
"38044","2024","COM","2022","1536","42","1578","2024-12-30"
"38045","2024","COM","2022","2327","90","2417","2024-12-30"
"38046","2024","COM","2022","1028","16","1044","2024-12-30"
"38047","2024","COM","2022","156","3","159","2024-12-30"
"38048","2024","COM","2022","1094","19","1113","2024-12-30"
"38049","2024","COM","2022","327","2","329","2024-12-30"
"38050","2024","COM","2022","648","15","663","2024-12-30"
"38051","2024","COM","2022","1469","30","1499","2024-12-30"
"38052","2024","COM","2022","2840","80","2920","2024-12-30"
"38053","2024","COM","2022","29816","621","30437","2024-12-30"
"38054","2024","COM","2022","1493","22","1515","2024-12-30"
"38055","2024","COM","2022","620","21","641","2024-12-30"
"38056","2024","COM","2022","91","2","93","2024-12-30"
"38057","2024","COM","2022","671","12","683","2024-12-30"
"38058","2024","COM","2022","2282","39","2321","2024-12-30"
"38059","2024","COM","2022","2509","46","2555","2024-12-30"
"38060","2024","COM","2022","142","3","145","2024-12-30"
"38061","2024","COM","2022","3499","81","3580","2024-12-30"
"38062","2024","COM","2022","791","13","804","2024-12-30"
"38063","2024","COM","2022","439","8","447","2024-12-30"
"38064","2024","COM","2022","3257","66","3323","2024-12-30"
"38065","2024","COM","2022","2152","46","2198","2024-12-30"
"38066","2024","COM","2022","169","5","174","2024-12-30"
"38067","2024","COM","2022","1775","36","1811","2024-12-30"
"38068","2024","COM","2022","1506","32","1538","2024-12-30"
"38069","2024","COM","2022","1583","26","1609","2024-12-30"
"38070","2024","COM","2022","1317","30","1347","2024-12-30"
"38071","2024","COM","2022","3344","34","3378","2024-12-30"
"38072","2024","COM","2022","2714","38","2752","2024-12-30"
"38073","2024","COM","2022","211","3","214","2024-12-30"
"38074","2024","COM","2022","393","6","399","2024-12-30"
"38075","2024","COM","2022","3049","108","3157","2024-12-30"
"38076","2024","COM","2022","1936","63","1999","2024-12-30"
"38077","2024","COM","2022","761","13","774","2024-12-30"
"38078","2024","COM","2022","536","15","551","2024-12-30"
"38080","2024","COM","2022","748","25","773","2024-12-30"
"38081","2024","COM","2022","1993","47","2040","2024-12-30"
"38082","2024","COM","2022","2014","44","2058","2024-12-30"
"38083","2024","COM","2022","435","16","451","2024-12-30"
"38084","2024","COM","2022","1462","26","1488","2024-12-30"
"38085","2024","COM","2022","10459","82","10541","2024-12-30"
"38086","2024","COM","2022","429","12","441","2024-12-30"
"38087","2024","COM","2022","6484","41","6525","2024-12-30"
"38089","2024","COM","2022","226","5","231","2024-12-30"
"38090","2024","COM","2022","286","3","289","2024-12-30"
"38091","2024","COM","2022","744","18","762","2024-12-30"
"38092","2024","COM","2022","94","2","96","2024-12-30"
"38093","2024","COM","2022","432","6","438","2024-12-30"
"38094","2024","COM","2022","1958","40","1998","2024-12-30"
"38095","2024","COM","2022","2476","146","2622","2024-12-30"
"38097","2024","COM","2022","5090","68","5158","2024-12-30"
"38098","2024","COM","2022","739","18","757","2024-12-30"
"38099","2024","COM","2022","737","23","760","2024-12-30"
"38100","2024","COM","2022","2372","48","2420","2024-12-30"
"38101","2024","COM","2022","1051","20","1071","2024-12-30"
"38102","2024","COM","2022","650","21","671","2024-12-30"
"38103","2024","COM","2022","326","7","333","2024-12-30"
"38104","2024","COM","2022","1396","31","1427","2024-12-30"
"38105","2024","COM","2022","2510","52","2562","2024-12-30"
"38106","2024","COM","2022","344","9","353","2024-12-30"
"38107","2024","COM","2022","1691","48","1739","2024-12-30"
"38108","2024","COM","2022","140","0","140","2024-12-30"
"38109","2024","COM","2022","998","35","1033","2024-12-30"
"38110","2024","COM","2022","2347","46","2393","2024-12-30"
"38111","2024","COM","2022","7840","214","8054","2024-12-30"
"38112","2024","COM","2022","81","4","85","2024-12-30"
"38113","2024","COM","2022","576","11","587","2024-12-30"
"38114","2024","COM","2022","1541","38","1579","2024-12-30"
"38115","2024","COM","2022","749","18","767","2024-12-30"
"38116","2024","COM","2022","36","0","36","2024-12-30"
"38117","2024","COM","2022","619","15","634","2024-12-30"
"38118","2024","COM","2022","1803","30","1833","2024-12-30"
"38120","2024","COM","2022","730","18","748","2024-12-30"
"38124","2024","COM","2022","2368","42","2410","2024-12-30"
"38126","2024","COM","2022","4177","132","4309","2024-12-30"
"38127","2024","COM","2022","169","4","173","2024-12-30"
"38128","2024","COM","2022","424","5","429","2024-12-30"
"38129","2024","COM","2022","368","17","385","2024-12-30"
"38130","2024","COM","2022","4793","273","5066","2024-12-30"
"38131","2024","COM","2022","2023","43","2066","2024-12-30"
"38132","2024","COM","2022","73","0","73","2024-12-30"
"38133","2024","COM","2022","5409","408","5817","2024-12-30"
"38134","2024","COM","2022","926","23","949","2024-12-30"
"38135","2024","COM","2022","1288","27","1315","2024-12-30"
"38136","2024","COM","2022","590","17","607","2024-12-30"
"38137","2024","COM","2022","418","20","438","2024-12-30"
"38138","2024","COM","2022","3543","65","3608","2024-12-30"
"38139","2024","COM","2022","1576","33","1609","2024-12-30"
"38140","2024","COM","2022","8463","260","8723","2024-12-30"
"38141","2024","COM","2022","785","12","797","2024-12-30"
"38144","2024","COM","2022","2915","40","2955","2024-12-30"
"38146","2024","COM","2022","818","25","843","2024-12-30"
"38147","2024","COM","2022","879","20","899","2024-12-30"
"38148","2024","COM","2022","3188","87","3275","2024-12-30"
"38149","2024","COM","2022","1670","24","1694","2024-12-30"
"38150","2024","COM","2022","6777","75","6852","2024-12-30"
"38151","2024","COM","2022","36708","218","36926","2024-12-30"
"38152","2024","COM","2022","1510","33","1543","2024-12-30"
"38153","2024","COM","2022","429","20","449","2024-12-30"
"38154","2024","COM","2022","225","3","228","2024-12-30"
"38155","2024","COM","2022","1897","30","1927","2024-12-30"
"38156","2024","COM","2022","976","31","1007","2024-12-30"
"38157","2024","COM","2022","3682","74","3756","2024-12-30"
"38158","2024","COM","2022","10095","105","10200","2024-12-30"
"38159","2024","COM","2022","541","8","549","2024-12-30"
"38160","2024","COM","2022","2301","111","2412","2024-12-30"
"38161","2024","COM","2022","1148","20","1168","2024-12-30"
"38162","2024","COM","2022","1482","32","1514","2024-12-30"
"38163","2024","COM","2022","459","10","469","2024-12-30"
"38166","2024","COM","2022","456","10","466","2024-12-30"
"38167","2024","COM","2022","568","4","572","2024-12-30"
"38169","2024","COM","2022","22471","213","22684","2024-12-30"
"38170","2024","COM","2022","3410","35","3445","2024-12-30"
"38171","2024","COM","2022","337","5","342","2024-12-30"
"38172","2024","COM","2022","1672","35","1707","2024-12-30"
"38173","2024","COM","2022","255","6","261","2024-12-30"
"38174","2024","COM","2022","1092","23","1115","2024-12-30"
"38175","2024","COM","2022","3334","56","3390","2024-12-30"
"38176","2024","COM","2022","2116","42","2158","2024-12-30"
"38177","2024","COM","2022","97","0","97","2024-12-30"
"38179","2024","COM","2022","7353","87","7440","2024-12-30"
"38180","2024","COM","2022","1020","39","1059","2024-12-30"
"38181","2024","COM","2022","2452","50","2502","2024-12-30"
"38182","2024","COM","2022","3093","54","3147","2024-12-30"
"38183","2024","COM","2022","516","13","529","2024-12-30"
"38184","2024","COM","2022","1632","11","1643","2024-12-30"
"38185","2024","COM","2022","156389","2212","158601","2024-12-30"
"38186","2024","COM","2022","356","12","368","2024-12-30"
"38187","2024","COM","2022","1883","19","1902","2024-12-30"
"38188","2024","COM","2022","1388","24","1412","2024-12-30"
"38189","2024","COM","2022","4824","75","4899","2024-12-30"
"38190","2024","COM","2022","1198","16","1214","2024-12-30"
"38191","2024","COM","2022","1264","32","1296","2024-12-30"
"38192","2024","COM","2022","220","4","224","2024-12-30"
"38193","2024","COM","2022","17096","266","17362","2024-12-30"
"38194","2024","COM","2022","2138","45","2183","2024-12-30"
"38195","2024","COM","2022","781","20","801","2024-12-30"
"38197","2024","COM","2022","1911","21","1932","2024-12-30"
"38198","2024","COM","2022","1135","23","1158","2024-12-30"
"38199","2024","COM","2022","2156","55","2211","2024-12-30"
"38200","2024","COM","2022","3925","75","4000","2024-12-30"
"38203","2024","COM","2022","468","8","476","2024-12-30"
"38204","2024","COM","2022","183","5","188","2024-12-30"
"38205","2024","COM","2022","2698","121","2819","2024-12-30"
"38206","2024","COM","2022","1009","27","1036","2024-12-30"
"38207","2024","COM","2022","161","3","164","2024-12-30"
"38208","2024","COM","2022","164","4","168","2024-12-30"
"38209","2024","COM","2022","247","7","254","2024-12-30"
"38210","2024","COM","2022","919","23","942","2024-12-30"
"38211","2024","COM","2022","347","6","353","2024-12-30"
"38212","2024","COM","2022","1258","10","1268","2024-12-30"
"38213","2024","COM","2022","605","11","616","2024-12-30"
"38214","2024","COM","2022","2157","75","2232","2024-12-30"
"38215","2024","COM","2022","2438","55","2493","2024-12-30"
"38216","2024","COM","2022","56","2","58","2024-12-30"
"38217","2024","COM","2022","68","1","69","2024-12-30"
"38218","2024","COM","2022","1186","21","1207","2024-12-30"
"38219","2024","COM","2022","613","14","627","2024-12-30"
"38221","2024","COM","2022","132","4","136","2024-12-30"
"38222","2024","COM","2022","757","18","775","2024-12-30"
"38223","2024","COM","2022","1920","48","1968","2024-12-30"
"38224","2024","COM","2022","92","0","92","2024-12-30"
"38225","2024","COM","2022","3005","89","3094","2024-12-30"
"38226","2024","COM","2022","1431","55","1486","2024-12-30"
"38228","2024","COM","2022","466","20","486","2024-12-30"
"38229","2024","COM","2022","18790","334","19124","2024-12-30"
"38230","2024","COM","2022","1088","32","1120","2024-12-30"
"38231","2024","COM","2022","1029","25","1054","2024-12-30"
"38232","2024","COM","2022","665","11","676","2024-12-30"
"38235","2024","COM","2022","450","7","457","2024-12-30"
"38236","2024","COM","2022","1740","41","1781","2024-12-30"
"38237","2024","COM","2022","192","4","196","2024-12-30"
"38238","2024","COM","2022","1971","44","2015","2024-12-30"
"38239","2024","COM","2022","7573","152","7725","2024-12-30"
"38240","2024","COM","2022","721","15","736","2024-12-30"
"38241","2024","COM","2022","14","0","14","2024-12-30"
"38242","2024","COM","2022","1463","32","1495","2024-12-30"
"38243","2024","COM","2022","256","8","264","2024-12-30"
"38244","2024","COM","2022","782","17","799","2024-12-30"
"38245","2024","COM","2022","273","5","278","2024-12-30"
"38246","2024","COM","2022","1171","27","1198","2024-12-30"
"38247","2024","COM","2022","3508","56","3564","2024-12-30"
"38248","2024","COM","2022","529","20","549","2024-12-30"
"38249","2024","COM","2022","5554","562","6116","2024-12-30"
"38250","2024","COM","2022","606","18","624","2024-12-30"
"38252","2024","COM","2022","347","10","357","2024-12-30"
"38253","2024","COM","2022","1920","36","1956","2024-12-30"
"38254","2024","COM","2022","500","6","506","2024-12-30"
"38255","2024","COM","2022","131","1","132","2024-12-30"
"38256","2024","COM","2022","1839","23","1862","2024-12-30"
"38257","2024","COM","2022","447","9","456","2024-12-30"
"38258","2024","COM","2022","93","0","93","2024-12-30"
"38259","2024","COM","2022","998","15","1013","2024-12-30"
"38260","2024","COM","2022","523","19","542","2024-12-30"
"38261","2024","COM","2022","4416","151","4567","2024-12-30"
"38263","2024","COM","2022","360","5","365","2024-12-30"
"38264","2024","COM","2022","139","0","139","2024-12-30"
"38265","2024","COM","2022","1727","35","1762","2024-12-30"
"38266","2024","COM","2022","454","10","464","2024-12-30"
"38267","2024","COM","2022","843","16","859","2024-12-30"
"38268","2024","COM","2022","254","6","260","2024-12-30"
"38269","2024","COM","2022","4940","193","5133","2024-12-30"
"38270","2024","COM","2022","1838","58","1896","2024-12-30"
"38271","2024","COM","2022","866","12","878","2024-12-30"
"38272","2024","COM","2022","408","5","413","2024-12-30"
"38273","2024","COM","2022","468","23","491","2024-12-30"
"38275","2024","COM","2022","315","41","356","2024-12-30"
"38276","2024","COM","2022","2716","69","2785","2024-12-30"
"38277","2024","COM","2022","527","10","537","2024-12-30"
"38278","2024","COM","2022","523","7","530","2024-12-30"
"38279","2024","COM","2022","1117","20","1137","2024-12-30"
"38280","2024","COM","2022","518","21","539","2024-12-30"
"38281","2024","COM","2022","2321","77","2398","2024-12-30"
"38282","2024","COM","2022","877","26","903","2024-12-30"
"38283","2024","COM","2022","108","2","110","2024-12-30"
"38284","2024","COM","2022","878","22","900","2024-12-30"
"38285","2024","COM","2022","151","1","152","2024-12-30"
"38286","2024","COM","2022","16","0","16","2024-12-30"
"38287","2024","COM","2022","1092","18","1110","2024-12-30"
"38288","2024","COM","2022","1733","33","1766","2024-12-30"
"38289","2024","COM","2022","214","3","217","2024-12-30"
"38290","2024","COM","2022","864","17","881","2024-12-30"
"38291","2024","COM","2022","1052","19","1071","2024-12-30"
"38292","2024","COM","2022","2614","64","2678","2024-12-30"
"38294","2024","COM","2022","682","22","704","2024-12-30"
"38295","2024","COM","2022","727","18","745","2024-12-30"
"38296","2024","COM","2022","972","40","1012","2024-12-30"
"38297","2024","COM","2022","1858","43","1901","2024-12-30"
"38298","2024","COM","2022","6587","56","6643","2024-12-30"
"38299","2024","COM","2022","134","3","137","2024-12-30"
"38300","2024","COM","2022","377","8","385","2024-12-30"
"38301","2024","COM","2022","167","1","168","2024-12-30"
"38303","2024","COM","2022","648","6","654","2024-12-30"
"38304","2024","COM","2022","1485","32","1517","2024-12-30"
"38307","2024","COM","2022","526","8","534","2024-12-30"
"38308","2024","COM","2022","296","7","303","2024-12-30"
"38309","2024","COM","2022","2120","27","2147","2024-12-30"
"38310","2024","COM","2022","1114","25","1139","2024-12-30"
"38311","2024","COM","2022","731","20","751","2024-12-30"
"38313","2024","COM","2022","289","8","297","2024-12-30"
"38314","2024","COM","2022","7373","184","7557","2024-12-30"
"38315","2024","COM","2022","3582","142","3724","2024-12-30"
"38316","2024","COM","2022","6107","46","6153","2024-12-30"
"38317","2024","COM","2022","10846","75","10921","2024-12-30"
"38318","2024","COM","2022","5843","47","5890","2024-12-30"
"38319","2024","COM","2022","809","24","833","2024-12-30"
"38320","2024","COM","2022","1792","40","1832","2024-12-30"
"38321","2024","COM","2022","172","4","176","2024-12-30"
"38322","2024","COM","2022","100","2","102","2024-12-30"
"38323","2024","COM","2022","1181","27","1208","2024-12-30"
"38324","2024","COM","2022","694","18","712","2024-12-30"
"38325","2024","COM","2022","519","15","534","2024-12-30"
"38326","2024","COM","2022","378","12","390","2024-12-30"
"38328","2024","COM","2022","926","31","957","2024-12-30"
"38329","2024","COM","2022","79","0","79","2024-12-30"
"38330","2024","COM","2022","105","2","107","2024-12-30"
"38331","2024","COM","2022","1005","32","1037","2024-12-30"
"38332","2024","COM","2022","3361","52","3413","2024-12-30"
"38333","2024","COM","2022","349","8","357","2024-12-30"
"38334","2024","COM","2022","1323","44","1367","2024-12-30"
"38335","2024","COM","2022","1050","22","1072","2024-12-30"
"38336","2024","COM","2022","2042","35","2077","2024-12-30"
"38337","2024","COM","2022","6599","79","6678","2024-12-30"
"38338","2024","COM","2022","725","17","742","2024-12-30"
"38339","2024","COM","2022","2189","57","2246","2024-12-30"
"38340","2024","COM","2022","2031","33","2064","2024-12-30"
"38341","2024","COM","2022","1102","36","1138","2024-12-30"
"38342","2024","COM","2022","320","6","326","2024-12-30"
"38343","2024","COM","2022","1732","38","1770","2024-12-30"
"38344","2024","COM","2022","8584","120","8704","2024-12-30"
"38345","2024","COM","2022","613","15","628","2024-12-30"
"38346","2024","COM","2022","410","5","415","2024-12-30"
"38347","2024","COM","2022","1103","25","1128","2024-12-30"
"38348","2024","COM","2022","4771","111","4882","2024-12-30"
"38349","2024","COM","2022","2306","43","2349","2024-12-30"
"38350","2024","COM","2022","565","18","583","2024-12-30"
"38351","2024","COM","2022","1161","28","1189","2024-12-30"
"38352","2024","COM","2022","2148","59","2207","2024-12-30"
"38353","2024","COM","2022","960","10","970","2024-12-30"
"38354","2024","COM","2022","421","6","427","2024-12-30"
"38355","2024","COM","2022","119","3","122","2024-12-30"
"38356","2024","COM","2022","341","6","347","2024-12-30"
"38357","2024","COM","2022","2726","140","2866","2024-12-30"
"38358","2024","COM","2022","757","13","770","2024-12-30"
"38359","2024","COM","2022","1258","27","1285","2024-12-30"
"38360","2024","COM","2022","403","10","413","2024-12-30"
"38361","2024","COM","2022","73","2","75","2024-12-30"
"38362","2024","COM","2022","1200","53","1253","2024-12-30"
"38363","2024","COM","2022","929","53","982","2024-12-30"
"38364","2024","COM","2022","424","5","429","2024-12-30"
"38365","2024","COM","2022","842","18","860","2024-12-30"
"38366","2024","COM","2022","258","8","266","2024-12-30"
"38368","2024","COM","2022","1064","25","1089","2024-12-30"
"38369","2024","COM","2022","1020","25","1045","2024-12-30"
"38370","2024","COM","2022","659","18","677","2024-12-30"
"38372","2024","COM","2022","707","9","716","2024-12-30"
"38373","2024","COM","2022","1156","43","1199","2024-12-30"
"38374","2024","COM","2022","3910","98","4008","2024-12-30"
"38375","2024","COM","2022","98","0","98","2024-12-30"
"38376","2024","COM","2022","836","22","858","2024-12-30"
"38377","2024","COM","2022","3526","61","3587","2024-12-30"
"38378","2024","COM","2022","3678","85","3763","2024-12-30"
"38379","2024","COM","2022","261","8","269","2024-12-30"
"38380","2024","COM","2022","330","5","335","2024-12-30"
"38381","2024","COM","2022","2125","56","2181","2024-12-30"
"38382","2024","COM","2022","17930","202","18132","2024-12-30"
"38383","2024","COM","2022","2603","91","2694","2024-12-30"
"38384","2024","COM","2022","3352","63","3415","2024-12-30"
"38386","2024","COM","2022","2388","53","2441","2024-12-30"
"38387","2024","COM","2022","487","10","497","2024-12-30"
"38388","2024","COM","2022","2691","33","2724","2024-12-30"
"38389","2024","COM","2022","3500","71","3571","2024-12-30"
"38390","2024","COM","2022","534","13","547","2024-12-30"
"38391","2024","COM","2022","239","5","244","2024-12-30"
"38392","2024","COM","2022","605","19","624","2024-12-30"
"38393","2024","COM","2022","1598","36","1634","2024-12-30"
"38394","2024","COM","2022","1934","40","1974","2024-12-30"
"38395","2024","COM","2022","2432","74","2506","2024-12-30"
"38396","2024","COM","2022","819","19","838","2024-12-30"
"38397","2024","COM","2022","7087","305","7392","2024-12-30"
"38398","2024","COM","2022","979","19","998","2024-12-30"
"38399","2024","COM","2022","4762","99","4861","2024-12-30"
"38400","2024","COM","2022","3601","72","3673","2024-12-30"
"38401","2024","COM","2022","1698","37","1735","2024-12-30"
"38402","2024","COM","2022","526","20","546","2024-12-30"
"38403","2024","COM","2022","308","5","313","2024-12-30"
"38404","2024","COM","2022","276","9","285","2024-12-30"
"38405","2024","COM","2022","1243","31","1274","2024-12-30"
"38406","2024","COM","2022","163","2","165","2024-12-30"
"38407","2024","COM","2022","1060","28","1088","2024-12-30"
"38408","2024","COM","2022","2678","46","2724","2024-12-30"
"38409","2024","COM","2022","1381","35","1416","2024-12-30"
"38410","2024","COM","2022","1468","33","1501","2024-12-30"
"38412","2024","COM","2022","4502","106","4608","2024-12-30"
"38413","2024","COM","2022","419","8","427","2024-12-30"
"38414","2024","COM","2022","41","2","43","2024-12-30"
"38415","2024","COM","2022","1507","41","1548","2024-12-30"
"38416","2024","COM","2022","7705","149","7854","2024-12-30"
"38417","2024","COM","2022","484","12","496","2024-12-30"
"38418","2024","COM","2022","233","2","235","2024-12-30"
"38419","2024","COM","2022","184","3","187","2024-12-30"
"38420","2024","COM","2022","241","5","246","2024-12-30"
"38421","2024","COM","2022","38022","231","38253","2024-12-30"
"38422","2024","COM","2022","5512","180","5692","2024-12-30"
"38423","2024","COM","2022","5957","49","6006","2024-12-30"
"38424","2024","COM","2022","179","2","181","2024-12-30"
"38425","2024","COM","2022","6722","80","6802","2024-12-30"
"38426","2024","COM","2022","672","14","686","2024-12-30"
"38427","2024","COM","2022","290","4","294","2024-12-30"
"38428","2024","COM","2022","32","0","32","2024-12-30"
"38429","2024","COM","2022","283","7","290","2024-12-30"
"38430","2024","COM","2022","335","8","343","2024-12-30"
"38431","2024","COM","2022","3013","87","3100","2024-12-30"
"38432","2024","COM","2022","944","23","967","2024-12-30"
"38433","2024","COM","2022","1132","25","1157","2024-12-30"
"38434","2024","COM","2022","661","9","670","2024-12-30"
"38436","2024","COM","2022","2212","48","2260","2024-12-30"
"38437","2024","COM","2022","303","6","309","2024-12-30"
"38438","2024","COM","2022","284","1","285","2024-12-30"
"38439","2024","COM","2022","3430","73","3503","2024-12-30"
"38440","2024","COM","2022","778","17","795","2024-12-30"
"38442","2024","COM","2022","935","28","963","2024-12-30"
"38443","2024","COM","2022","467","16","483","2024-12-30"
"38444","2024","COM","2022","105","5","110","2024-12-30"
"38445","2024","COM","2022","788","7","795","2024-12-30"
"38446","2024","COM","2022","576","13","589","2024-12-30"
"38448","2024","COM","2022","1454","32","1486","2024-12-30"
"38449","2024","COM","2022","6182","46","6228","2024-12-30"
"38450","2024","COM","2022","1472","25","1497","2024-12-30"
"38451","2024","COM","2022","3405","57","3462","2024-12-30"
"38452","2024","COM","2022","465","4","469","2024-12-30"
"38453","2024","COM","2022","1849","38","1887","2024-12-30"
"38454","2024","COM","2022","2108","49","2157","2024-12-30"
"38455","2024","COM","2022","4297","92","4389","2024-12-30"
"38456","2024","COM","2022","491","10","501","2024-12-30"
"38457","2024","COM","2022","3107","81","3188","2024-12-30"
"38458","2024","COM","2022","613","15","628","2024-12-30"
"38459","2024","COM","2022","967","24","991","2024-12-30"
"38460","2024","COM","2022","427","13","440","2024-12-30"
"38462","2024","COM","2022","609","14","623","2024-12-30"
"38463","2024","COM","2022","1723","46","1769","2024-12-30"
"38464","2024","COM","2022","2170","39","2209","2024-12-30"
"38465","2024","COM","2022","1142","20","1162","2024-12-30"
"38466","2024","COM","2022","1520","45","1565","2024-12-30"
"38467","2024","COM","2022","1484","39","1523","2024-12-30"
"38468","2024","COM","2022","4548","61","4609","2024-12-30"
"38469","2024","COM","2022","82","0","82","2024-12-30"
"38470","2024","COM","2022","347","8","355","2024-12-30"
"38471","2024","COM","2022","1154","31","1185","2024-12-30"
"38472","2024","COM","2022","250","4","254","2024-12-30"
"38473","2024","COM","2022","1184","22","1206","2024-12-30"
"38474","2024","COM","2022","11579","196","11775","2024-12-30"
"38475","2024","COM","2022","2540","35","2575","2024-12-30"
"38476","2024","COM","2022","879","13","892","2024-12-30"
"38478","2024","COM","2022","1004","11","1015","2024-12-30"
"38479","2024","COM","2022","2085","52","2137","2024-12-30"
"38480","2024","COM","2022","2153","42","2195","2024-12-30"
"38481","2024","COM","2022","1134","35","1169","2024-12-30"
"38483","2024","COM","2022","1642","50","1692","2024-12-30"
"38484","2024","COM","2022","2100","33","2133","2024-12-30"
"38485","2024","COM","2022","11784","103","11887","2024-12-30"
"38486","2024","COM","2022","8087","119","8206","2024-12-30"
"38487","2024","COM","2022","2168","39","2207","2024-12-30"
"38488","2024","COM","2022","601","15","616","2024-12-30"
"38489","2024","COM","2022","134","1","135","2024-12-30"
"38490","2024","COM","2022","1923","38","1961","2024-12-30"
"38492","2024","COM","2022","719","21","740","2024-12-30"
"38494","2024","COM","2022","849","16","865","2024-12-30"
"38495","2024","COM","2022","614","8","622","2024-12-30"
"38496","2024","COM","2022","1255","35","1290","2024-12-30"
"38497","2024","COM","2022","145","0","145","2024-12-30"
"38498","2024","COM","2022","774","13","787","2024-12-30"
"38499","2024","COM","2022","1148","18","1166","2024-12-30"
"38500","2024","COM","2022","599","11","610","2024-12-30"
"38501","2024","COM","2022","2132","24","2156","2024-12-30"
"38503","2024","COM","2022","2463","124","2587","2024-12-30"
"38504","2024","COM","2022","2014","94","2108","2024-12-30"
"38505","2024","COM","2022","789","15","804","2024-12-30"
"38507","2024","COM","2022","7944","123","8067","2024-12-30"
"38508","2024","COM","2022","823","22","845","2024-12-30"
"38509","2024","COM","2022","8123","215","8338","2024-12-30"
"38511","2024","COM","2022","3115","106","3221","2024-12-30"
"38512","2024","COM","2022","802","20","822","2024-12-30"
"38513","2024","COM","2022","258","10","268","2024-12-30"
"38514","2024","COM","2022","201","5","206","2024-12-30"
"38515","2024","COM","2022","2097","43","2140","2024-12-30"
"38516","2024","COM","2022","6447","125","6572","2024-12-30"
"38517","2024","COM","2022","7657","127","7784","2024-12-30"
"38518","2024","COM","2022","514","12","526","2024-12-30"
"38519","2024","COM","2022","2897","52","2949","2024-12-30"
"38520","2024","COM","2022","681","12","693","2024-12-30"
"38521","2024","COM","2022","64","4","68","2024-12-30"
"38522","2024","COM","2022","167","2","169","2024-12-30"
"38523","2024","COM","2022","864","14","878","2024-12-30"
"38524","2024","COM","2022","8314","155","8469","2024-12-30"
"38525","2024","COM","2022","462","8","470","2024-12-30"
"38526","2024","COM","2022","367","11","378","2024-12-30"
"38527","2024","COM","2022","352","2","354","2024-12-30"
"38528","2024","COM","2022","1379","23","1402","2024-12-30"
"38529","2024","COM","2022","4018","83","4101","2024-12-30"
"38530","2024","COM","2022","2495","45","2540","2024-12-30"
"38531","2024","COM","2022","568","11","579","2024-12-30"
"38532","2024","COM","2022","975","23","998","2024-12-30"
"38533","2024","COM","2022","836","16","852","2024-12-30"
"38535","2024","COM","2022","266","3","269","2024-12-30"
"38536","2024","COM","2022","1503","27","1530","2024-12-30"
"38537","2024","COM","2022","7643","94","7737","2024-12-30"
"38538","2024","COM","2022","4940","65","5005","2024-12-30"
"38539","2024","COM","2022","605","15","620","2024-12-30"
"38540","2024","COM","2022","1392","27","1419","2024-12-30"
"38542","2024","COM","2022","324","15","339","2024-12-30"
"38543","2024","COM","2022","2217","41","2258","2024-12-30"
"38544","2024","COM","2022","31555","383","31938","2024-12-30"
"38545","2024","COM","2022","8557","142","8699","2024-12-30"
"38546","2024","COM","2022","961","28","989","2024-12-30"
"38547","2024","COM","2022","7445","109","7554","2024-12-30"
"38548","2024","COM","2022","4365","213","4578","2024-12-30"
"38549","2024","COM","2022","26","0","26","2024-12-30"
"38550","2024","COM","2022","70","1","71","2024-12-30"
"38551","2024","COM","2022","43","1","44","2024-12-30"
"38552","2024","COM","2022","398","9","407","2024-12-30"
"38553","2024","COM","2022","19018","235","19253","2024-12-30"
"38554","2024","COM","2022","1890","67","1957","2024-12-30"
"38555","2024","COM","2022","1162","29","1191","2024-12-30"
"38556","2024","COM","2022","1179","19","1198","2024-12-30"
"38557","2024","COM","2022","5240","65","5305","2024-12-30"
"38558","2024","COM","2022","1979","36","2015","2024-12-30"
"38559","2024","COM","2022","4449","80","4529","2024-12-30"
"38560","2024","COM","2022","1534","27","1561","2024-12-30"
"38561","2024","COM","2022","1704","33","1737","2024-12-30"
"38562","2024","COM","2022","7316","166","7482","2024-12-30"
"38563","2024","COM","2022","21604","537","22141","2024-12-30"
"38564","2024","COM","2022","236","10","246","2024-12-30"
"38565","2024","COM","2022","9845","298","10143","2024-12-30"
"38566","2024","COM","2022","1694","48","1742","2024-12-30"
"38567","2024","COM","2022","438","5","443","2024-12-30"
"39001","2024","COM","2022","832","24","856","2024-12-30"
"39002","2024","COM","2022","61","1","62","2024-12-30"
"39003","2024","COM","2022","48","0","48","2024-12-30"
"39004","2024","COM","2022","50","3","53","2024-12-30"
"39006","2024","COM","2022","424","16","440","2024-12-30"
"39007","2024","COM","2022","149","4","153","2024-12-30"
"39008","2024","COM","2022","432","64","496","2024-12-30"
"39009","2024","COM","2022","573","16","589","2024-12-30"
"39010","2024","COM","2022","91","2","93","2024-12-30"
"39011","2024","COM","2022","423","9","432","2024-12-30"
"39013","2024","COM","2022","3146","193","3339","2024-12-30"
"39014","2024","COM","2022","218","6","224","2024-12-30"
"39015","2024","COM","2022","112","2","114","2024-12-30"
"39016","2024","COM","2022","1149","27","1176","2024-12-30"
"39017","2024","COM","2022","1184","37","1221","2024-12-30"
"39018","2024","COM","2022","584","6","590","2024-12-30"
"39019","2024","COM","2022","219","4","223","2024-12-30"
"39020","2024","COM","2022","100","5","105","2024-12-30"
"39021","2024","COM","2022","590","15","605","2024-12-30"
"39022","2024","COM","2022","724","17","741","2024-12-30"
"39024","2024","COM","2022","258","6","264","2024-12-30"
"39025","2024","COM","2022","279","4","283","2024-12-30"
"39026","2024","COM","2022","186","5","191","2024-12-30"
"39027","2024","COM","2022","187","4","191","2024-12-30"
"39028","2024","COM","2022","449","3","452","2024-12-30"
"39029","2024","COM","2022","389","6","395","2024-12-30"
"39030","2024","COM","2022","874","21","895","2024-12-30"
"39031","2024","COM","2022","200","2","202","2024-12-30"
"39032","2024","COM","2022","359","16","375","2024-12-30"
"39034","2024","COM","2022","300","10","310","2024-12-30"
"39035","2024","COM","2022","333","6","339","2024-12-30"
"39037","2024","COM","2022","181","7","188","2024-12-30"
"39038","2024","COM","2022","154","4","158","2024-12-30"
"39039","2024","COM","2022","247","5","252","2024-12-30"
"39040","2024","COM","2022","192","4","196","2024-12-30"
"39041","2024","COM","2022","159","5","164","2024-12-30"
"39042","2024","COM","2022","498","17","515","2024-12-30"
"39043","2024","COM","2022","1466","23","1489","2024-12-30"
"39045","2024","COM","2022","83","3","86","2024-12-30"
"39046","2024","COM","2022","74","3","77","2024-12-30"
"39047","2024","COM","2022","494","13","507","2024-12-30"
"39048","2024","COM","2022","255","8","263","2024-12-30"
"39049","2024","COM","2022","401","11","412","2024-12-30"
"39050","2024","COM","2022","155","4","159","2024-12-30"
"39051","2024","COM","2022","436","5","441","2024-12-30"
"39052","2024","COM","2022","74","1","75","2024-12-30"
"39053","2024","COM","2022","217","10","227","2024-12-30"
"39054","2024","COM","2022","91","2","93","2024-12-30"
"39055","2024","COM","2022","56","1","57","2024-12-30"
"39056","2024","COM","2022","1530","35","1565","2024-12-30"
"39057","2024","COM","2022","101","2","103","2024-12-30"
"39058","2024","COM","2022","154","7","161","2024-12-30"
"39059","2024","COM","2022","1695","45","1740","2024-12-30"
"39060","2024","COM","2022","60","0","60","2024-12-30"
"39061","2024","COM","2022","114","2","116","2024-12-30"
"39062","2024","COM","2022","64","2","66","2024-12-30"
"39063","2024","COM","2022","218","4","222","2024-12-30"
"39065","2024","COM","2022","110","8","118","2024-12-30"
"39066","2024","COM","2022","182","10","192","2024-12-30"
"39068","2024","COM","2022","313","9","322","2024-12-30"
"39070","2024","COM","2022","89","3","92","2024-12-30"
"39072","2024","COM","2022","355","6","361","2024-12-30"
"39073","2024","COM","2022","191","2","193","2024-12-30"
"39074","2024","COM","2022","199","8","207","2024-12-30"
"39076","2024","COM","2022","215","4","219","2024-12-30"
"39077","2024","COM","2022","44","2","46","2024-12-30"
"39078","2024","COM","2022","683","16","699","2024-12-30"
"39079","2024","COM","2022","211","5","216","2024-12-30"
"39080","2024","COM","2022","57","2","59","2024-12-30"
"39081","2024","COM","2022","388","19","407","2024-12-30"
"39083","2024","COM","2022","332","5","337","2024-12-30"
"39084","2024","COM","2022","142","6","148","2024-12-30"
"39085","2024","COM","2022","90","3","93","2024-12-30"
"39086","2024","COM","2022","234","2","236","2024-12-30"
"39088","2024","COM","2022","389","9","398","2024-12-30"
"39090","2024","COM","2022","185","4","189","2024-12-30"
"39091","2024","COM","2022","83","1","84","2024-12-30"
"39092","2024","COM","2022","195","0","195","2024-12-30"
"39093","2024","COM","2022","423","9","432","2024-12-30"
"39094","2024","COM","2022","160","7","167","2024-12-30"
"39095","2024","COM","2022","121","5","126","2024-12-30"
"39096","2024","COM","2022","460","9","469","2024-12-30"
"39097","2024","COM","2022","8035","425","8460","2024-12-30"
"39099","2024","COM","2022","445","6","451","2024-12-30"
"39100","2024","COM","2022","98","1","99","2024-12-30"
"39101","2024","COM","2022","1460","34","1494","2024-12-30"
"39102","2024","COM","2022","217","7","224","2024-12-30"
"39103","2024","COM","2022","299","6","305","2024-12-30"
"39104","2024","COM","2022","626","12","638","2024-12-30"
"39105","2024","COM","2022","216","8","224","2024-12-30"
"39106","2024","COM","2022","287","5","292","2024-12-30"
"39107","2024","COM","2022","142","1","143","2024-12-30"
"39108","2024","COM","2022","56","3","59","2024-12-30"
"39109","2024","COM","2022","169","6","175","2024-12-30"
"39110","2024","COM","2022","65","0","65","2024-12-30"
"39111","2024","COM","2022","37","0","37","2024-12-30"
"39112","2024","COM","2022","103","2","105","2024-12-30"
"39114","2024","COM","2022","146","4","150","2024-12-30"
"39116","2024","COM","2022","153","2","155","2024-12-30"
"39117","2024","COM","2022","100","1","101","2024-12-30"
"39118","2024","COM","2022","49","0","49","2024-12-30"
"39119","2024","COM","2022","85","0","85","2024-12-30"
"39120","2024","COM","2022","122","8","130","2024-12-30"
"39121","2024","COM","2022","412","9","421","2024-12-30"
"39122","2024","COM","2022","123","3","126","2024-12-30"
"39124","2024","COM","2022","505","14","519","2024-12-30"
"39126","2024","COM","2022","391","13","404","2024-12-30"
"39127","2024","COM","2022","107","3","110","2024-12-30"
"39128","2024","COM","2022","1576","22","1598","2024-12-30"
"39129","2024","COM","2022","401","10","411","2024-12-30"
"39130","2024","COM","2022","761","40","801","2024-12-30"
"39131","2024","COM","2022","568","13","581","2024-12-30"
"39132","2024","COM","2022","32","0","32","2024-12-30"
"39133","2024","COM","2022","73","1","74","2024-12-30"
"39134","2024","COM","2022","209","7","216","2024-12-30"
"39136","2024","COM","2022","33","2","35","2024-12-30"
"39137","2024","COM","2022","415","12","427","2024-12-30"
"39138","2024","COM","2022","317","7","324","2024-12-30"
"39139","2024","COM","2022","80","1","81","2024-12-30"
"39140","2024","COM","2022","39","0","39","2024-12-30"
"39141","2024","COM","2022","268","5","273","2024-12-30"
"39142","2024","COM","2022","126","1","127","2024-12-30"
"39143","2024","COM","2022","33","0","33","2024-12-30"
"39145","2024","COM","2022","295","8","303","2024-12-30"
"39146","2024","COM","2022","598","24","622","2024-12-30"
"39147","2024","COM","2022","95","2","97","2024-12-30"
"39149","2024","COM","2022","322","5","327","2024-12-30"
"39150","2024","COM","2022","1002","29","1031","2024-12-30"
"39151","2024","COM","2022","136","4","140","2024-12-30"
"39153","2024","COM","2022","801","20","821","2024-12-30"
"39154","2024","COM","2022","1428","42","1470","2024-12-30"
"39155","2024","COM","2022","70","2","72","2024-12-30"
"39156","2024","COM","2022","235","7","242","2024-12-30"
"39157","2024","COM","2022","46","3","49","2024-12-30"
"39159","2024","COM","2022","258","4","262","2024-12-30"
"39160","2024","COM","2022","900","18","918","2024-12-30"
"39162","2024","COM","2022","246","4","250","2024-12-30"
"39163","2024","COM","2022","117","1","118","2024-12-30"
"39164","2024","COM","2022","662","14","676","2024-12-30"
"39165","2024","COM","2022","58","0","58","2024-12-30"
"39166","2024","COM","2022","215","3","218","2024-12-30"
"39167","2024","COM","2022","356","4","360","2024-12-30"
"39168","2024","COM","2022","46","0","46","2024-12-30"
"39169","2024","COM","2022","584","13","597","2024-12-30"
"39170","2024","COM","2022","922","24","946","2024-12-30"
"39171","2024","COM","2022","1179","18","1197","2024-12-30"
"39172","2024","COM","2022","260","1","261","2024-12-30"
"39173","2024","COM","2022","1290","28","1318","2024-12-30"
"39174","2024","COM","2022","66","0","66","2024-12-30"
"39175","2024","COM","2022","69","3","72","2024-12-30"
"39176","2024","COM","2022","517","9","526","2024-12-30"
"39177","2024","COM","2022","977","23","1000","2024-12-30"
"39178","2024","COM","2022","86","2","88","2024-12-30"
"39179","2024","COM","2022","231","8","239","2024-12-30"
"39180","2024","COM","2022","250","121","371","2024-12-30"
"39182","2024","COM","2022","685","17","702","2024-12-30"
"39183","2024","COM","2022","619","84","703","2024-12-30"
"39184","2024","COM","2022","193","5","198","2024-12-30"
"39185","2024","COM","2022","388","13","401","2024-12-30"
"39187","2024","COM","2022","274","7","281","2024-12-30"
"39188","2024","COM","2022","343","4","347","2024-12-30"
"39189","2024","COM","2022","2590","73","2663","2024-12-30"
"39190","2024","COM","2022","1316","22","1338","2024-12-30"
"39191","2024","COM","2022","81","5","86","2024-12-30"
"39192","2024","COM","2022","73","1","74","2024-12-30"
"39193","2024","COM","2022","1030","18","1048","2024-12-30"
"39194","2024","COM","2022","490","12","502","2024-12-30"
"39196","2024","COM","2022","121","1","122","2024-12-30"
"39197","2024","COM","2022","368","12","380","2024-12-30"
"39198","2024","COM","2022","23784","816","24600","2024-12-30"
"39199","2024","COM","2022","1195","37","1232","2024-12-30"
"39200","2024","COM","2022","210","3","213","2024-12-30"
"39201","2024","COM","2022","281","38","319","2024-12-30"
"39202","2024","COM","2022","140","1","141","2024-12-30"
"39203","2024","COM","2022","108","6","114","2024-12-30"
"39204","2024","COM","2022","27","1","28","2024-12-30"
"39205","2024","COM","2022","373","10","383","2024-12-30"
"39206","2024","COM","2022","217","6","223","2024-12-30"
"39207","2024","COM","2022","89","3","92","2024-12-30"
"39208","2024","COM","2022","165","5","170","2024-12-30"
"39209","2024","COM","2022","302","6","308","2024-12-30"
"39210","2024","COM","2022","568","12","580","2024-12-30"
"39211","2024","COM","2022","247","3","250","2024-12-30"
"39214","2024","COM","2022","132","2","134","2024-12-30"
"39216","2024","COM","2022","310","12","322","2024-12-30"
"39217","2024","COM","2022","573","16","589","2024-12-30"
"39218","2024","COM","2022","432","9","441","2024-12-30"
"39219","2024","COM","2022","658","13","671","2024-12-30"
"39220","2024","COM","2022","399","15","414","2024-12-30"
"39221","2024","COM","2022","32","2","34","2024-12-30"
"39222","2024","COM","2022","87","1","88","2024-12-30"
"39223","2024","COM","2022","187","6","193","2024-12-30"
"39225","2024","COM","2022","189","6","195","2024-12-30"
"39227","2024","COM","2022","203","2","205","2024-12-30"
"39228","2024","COM","2022","1107","26","1133","2024-12-30"
"39229","2024","COM","2022","206","10","216","2024-12-30"
"39230","2024","COM","2022","73","3","76","2024-12-30"
"39232","2024","COM","2022","478","8","486","2024-12-30"
"39233","2024","COM","2022","2286","45","2331","2024-12-30"
"39234","2024","COM","2022","83","1","84","2024-12-30"
"39235","2024","COM","2022","1170","15","1185","2024-12-30"
"39236","2024","COM","2022","40","0","40","2024-12-30"
"39237","2024","COM","2022","59","4","63","2024-12-30"
"39238","2024","COM","2022","106","6","112","2024-12-30"
"39239","2024","COM","2022","40","1","41","2024-12-30"
"39240","2024","COM","2022","171","3","174","2024-12-30"
"39241","2024","COM","2022","388","7","395","2024-12-30"
"39244","2024","COM","2022","161","4","165","2024-12-30"
"39245","2024","COM","2022","364","9","373","2024-12-30"
"39246","2024","COM","2022","438","13","451","2024-12-30"
"39247","2024","COM","2022","73","1","74","2024-12-30"
"39248","2024","COM","2022","43","0","43","2024-12-30"
"39249","2024","COM","2022","77","3","80","2024-12-30"
"39250","2024","COM","2022","189","3","192","2024-12-30"
"39251","2024","COM","2022","441","105","546","2024-12-30"
"39252","2024","COM","2022","732","10","742","2024-12-30"
"39253","2024","COM","2022","267","3","270","2024-12-30"
"39254","2024","COM","2022","128","1","129","2024-12-30"
"39255","2024","COM","2022","201","8","209","2024-12-30"
"39258","2024","COM","2022","633","17","650","2024-12-30"
"39259","2024","COM","2022","45","0","45","2024-12-30"
"39261","2024","COM","2022","136","3","139","2024-12-30"
"39262","2024","COM","2022","131","1","132","2024-12-30"
"39263","2024","COM","2022","384","8","392","2024-12-30"
"39265","2024","COM","2022","197","4","201","2024-12-30"
"39266","2024","COM","2022","351","2","353","2024-12-30"
"39267","2024","COM","2022","87","4","91","2024-12-30"
"39268","2024","COM","2022","62","0","62","2024-12-30"
"39269","2024","COM","2022","238","5","243","2024-12-30"
"39270","2024","COM","2022","537","60","597","2024-12-30"
"39271","2024","COM","2022","395","9","404","2024-12-30"
"39272","2024","COM","2022","49","1","50","2024-12-30"
"39273","2024","COM","2022","212","5","217","2024-12-30"
"39274","2024","COM","2022","299","12","311","2024-12-30"
"39275","2024","COM","2022","659","17","676","2024-12-30"
"39277","2024","COM","2022","50","1","51","2024-12-30"
"39278","2024","COM","2022","131","4","135","2024-12-30"
"39279","2024","COM","2022","619","14","633","2024-12-30"
"39280","2024","COM","2022","108","0","108","2024-12-30"
"39281","2024","COM","2022","89","1","90","2024-12-30"
"39282","2024","COM","2022","77","2","79","2024-12-30"
"39283","2024","COM","2022","618","11","629","2024-12-30"
"39284","2024","COM","2022","141","0","141","2024-12-30"
"39285","2024","COM","2022","327","3","330","2024-12-30"
"39286","2024","COM","2022","2342","86","2428","2024-12-30"
"39288","2024","COM","2022","383","10","393","2024-12-30"
"39289","2024","COM","2022","334","6","340","2024-12-30"
"39290","2024","COM","2022","454","12","466","2024-12-30"
"39291","2024","COM","2022","239","5","244","2024-12-30"
"39292","2024","COM","2022","137","2","139","2024-12-30"
"39293","2024","COM","2022","203","7","210","2024-12-30"
"39295","2024","COM","2022","146","1","147","2024-12-30"
"39296","2024","COM","2022","211","5","216","2024-12-30"
"39297","2024","COM","2022","1133","31","1164","2024-12-30"
"39298","2024","COM","2022","58","3","61","2024-12-30"
"39299","2024","COM","2022","493","8","501","2024-12-30"
"39300","2024","COM","2022","16942","858","17800","2024-12-30"
"39301","2024","COM","2022","173","5","178","2024-12-30"
"39302","2024","COM","2022","110","1","111","2024-12-30"
"39304","2024","COM","2022","232","9","241","2024-12-30"
"39305","2024","COM","2022","537","11","548","2024-12-30"
"39306","2024","COM","2022","1027","29","1056","2024-12-30"
"39307","2024","COM","2022","325","17","342","2024-12-30"
"39308","2024","COM","2022","319","7","326","2024-12-30"
"39310","2024","COM","2022","472","14","486","2024-12-30"
"39312","2024","COM","2022","107","1","108","2024-12-30"
"39313","2024","COM","2022","215","8","223","2024-12-30"
"39314","2024","COM","2022","68","4","72","2024-12-30"
"39315","2024","COM","2022","379","11","390","2024-12-30"
"39317","2024","COM","2022","358","15","373","2024-12-30"
"39318","2024","COM","2022","207","12","219","2024-12-30"
"39319","2024","COM","2022","145","1","146","2024-12-30"
"39320","2024","COM","2022","328","3","331","2024-12-30"
"39321","2024","COM","2022","164","5","169","2024-12-30"
"39322","2024","COM","2022","74","0","74","2024-12-30"
"39323","2024","COM","2022","301","6","307","2024-12-30"
"39324","2024","COM","2022","8","0","8","2024-12-30"
"39325","2024","COM","2022","577","12","589","2024-12-30"
"39326","2024","COM","2022","168","5","173","2024-12-30"
"39327","2024","COM","2022","891","18","909","2024-12-30"
"39328","2024","COM","2022","439","8","447","2024-12-30"
"39329","2024","COM","2022","165","1","166","2024-12-30"
"39330","2024","COM","2022","139","2","141","2024-12-30"
"39331","2024","COM","2022","882","23","905","2024-12-30"
"39333","2024","COM","2022","2121","110","2231","2024-12-30"
"39334","2024","COM","2022","133","5","138","2024-12-30"
"39335","2024","COM","2022","565","11","576","2024-12-30"
"39336","2024","COM","2022","110","4","114","2024-12-30"
"39337","2024","COM","2022","88","1","89","2024-12-30"
"39338","2024","COM","2022","506","9","515","2024-12-30"
"39339","2024","COM","2022","1120","18","1138","2024-12-30"
"39342","2024","COM","2022","124","1","125","2024-12-30"
"39343","2024","COM","2022","16","0","16","2024-12-30"
"39344","2024","COM","2022","332","12","344","2024-12-30"
"39345","2024","COM","2022","390","18","408","2024-12-30"
"39346","2024","COM","2022","109","5","114","2024-12-30"
"39348","2024","COM","2022","421","29","450","2024-12-30"
"39349","2024","COM","2022","484","24","508","2024-12-30"
"39350","2024","COM","2022","306","5","311","2024-12-30"
"39351","2024","COM","2022","145","7","152","2024-12-30"
"39352","2024","COM","2022","148","3","151","2024-12-30"
"39353","2024","COM","2022","164","9","173","2024-12-30"
"39354","2024","COM","2022","369","11","380","2024-12-30"
"39355","2024","COM","2022","234","7","241","2024-12-30"
"39356","2024","COM","2022","214","4","218","2024-12-30"
"39359","2024","COM","2022","33","0","33","2024-12-30"
"39360","2024","COM","2022","170","1","171","2024-12-30"
"39361","2024","COM","2022","197","4","201","2024-12-30"
"39362","2024","COM","2022","3207","343","3550","2024-12-30"
"39363","2024","COM","2022","83","1","84","2024-12-30"
"39364","2024","COM","2022","483","14","497","2024-12-30"
"39365","2024","COM","2022","1302","26","1328","2024-12-30"
"39366","2024","COM","2022","203","14","217","2024-12-30"
"39367","2024","COM","2022","2371","61","2432","2024-12-30"
"39368","2024","COM","2022","5099","264","5363","2024-12-30"
"39370","2024","COM","2022","1094","275","1369","2024-12-30"
"39372","2024","COM","2022","82","3","85","2024-12-30"
"39373","2024","COM","2022","159","5","164","2024-12-30"
"39375","2024","COM","2022","129","4","133","2024-12-30"
"39376","2024","COM","2022","76","4","80","2024-12-30"
"39377","2024","COM","2022","175","7","182","2024-12-30"
"39378","2024","COM","2022","770","16","786","2024-12-30"
"39379","2024","COM","2022","538","6","544","2024-12-30"
"39380","2024","COM","2022","41","2","43","2024-12-30"
"39381","2024","COM","2022","98","0","98","2024-12-30"
"39385","2024","COM","2022","549","10","559","2024-12-30"
"39386","2024","COM","2022","90","1","91","2024-12-30"
"39387","2024","COM","2022","290","3","293","2024-12-30"
"39388","2024","COM","2022","197","3","200","2024-12-30"
"39389","2024","COM","2022","597","14","611","2024-12-30"
"39390","2024","COM","2022","304","12","316","2024-12-30"
"39391","2024","COM","2022","396","12","408","2024-12-30"
"39392","2024","COM","2022","194","7","201","2024-12-30"
"39393","2024","COM","2022","64","2","66","2024-12-30"
"39394","2024","COM","2022","71","2","73","2024-12-30"
"39396","2024","COM","2022","1048","12","1060","2024-12-30"
"39397","2024","COM","2022","1571","37","1608","2024-12-30"
"39398","2024","COM","2022","419","4","423","2024-12-30"
"39399","2024","COM","2022","330","8","338","2024-12-30"
"39400","2024","COM","2022","148","1","149","2024-12-30"
"39401","2024","COM","2022","237","6","243","2024-12-30"
"39402","2024","COM","2022","385","6","391","2024-12-30"
"39403","2024","COM","2022","217","8","225","2024-12-30"
"39404","2024","COM","2022","448","10","458","2024-12-30"
"39405","2024","COM","2022","1023","21","1044","2024-12-30"
"39406","2024","COM","2022","285","2","287","2024-12-30"
"39407","2024","COM","2022","336","5","341","2024-12-30"
"39408","2024","COM","2022","154","6","160","2024-12-30"
"39409","2024","COM","2022","134","4","138","2024-12-30"
"39411","2024","COM","2022","1535","39","1574","2024-12-30"
"39412","2024","COM","2022","295","7","302","2024-12-30"
"39413","2024","COM","2022","332","10","342","2024-12-30"
"39415","2024","COM","2022","1063","17","1080","2024-12-30"
"39418","2024","COM","2022","101","2","103","2024-12-30"
"39419","2024","COM","2022","62","1","63","2024-12-30"
"39420","2024","COM","2022","204","3","207","2024-12-30"
"39421","2024","COM","2022","237","16","253","2024-12-30"
"39422","2024","COM","2022","509","11","520","2024-12-30"
"39423","2024","COM","2022","99","1","100","2024-12-30"
"39424","2024","COM","2022","156","3","159","2024-12-30"
"39425","2024","COM","2022","86","3","89","2024-12-30"
"39426","2024","COM","2022","201","6","207","2024-12-30"
"39427","2024","COM","2022","63","1","64","2024-12-30"
"39428","2024","COM","2022","21","4","25","2024-12-30"
"39429","2024","COM","2022","437","8","445","2024-12-30"
"39430","2024","COM","2022","105","1","106","2024-12-30"
"39431","2024","COM","2022","329","6","335","2024-12-30"
"39432","2024","COM","2022","126","3","129","2024-12-30"
"39434","2024","COM","2022","4007","371","4378","2024-12-30"
"39435","2024","COM","2022","626","19","645","2024-12-30"
"39436","2024","COM","2022","243","0","243","2024-12-30"
"39437","2024","COM","2022","275","5","280","2024-12-30"
"39439","2024","COM","2022","539","11","550","2024-12-30"
"39441","2024","COM","2022","1244","47","1291","2024-12-30"
"39443","2024","COM","2022","114","5","119","2024-12-30"
"39444","2024","COM","2022","52","1","53","2024-12-30"
"39445","2024","COM","2022","276","14","290","2024-12-30"
"39446","2024","COM","2022","245","7","252","2024-12-30"
"39447","2024","COM","2022","297","11","308","2024-12-30"
"39448","2024","COM","2022","450","15","465","2024-12-30"
"39449","2024","COM","2022","265","10","275","2024-12-30"
"39451","2024","COM","2022","507","3","510","2024-12-30"
"39452","2024","COM","2022","529","7","536","2024-12-30"
"39453","2024","COM","2022","444","11","455","2024-12-30"
"39454","2024","COM","2022","94","3","97","2024-12-30"
"39455","2024","COM","2022","53","1","54","2024-12-30"
"39456","2024","COM","2022","348","3","351","2024-12-30"
"39457","2024","COM","2022","55","0","55","2024-12-30"
"39458","2024","COM","2022","236","9","245","2024-12-30"
"39460","2024","COM","2022","187","7","194","2024-12-30"
"39461","2024","COM","2022","77","1","78","2024-12-30"
"39462","2024","COM","2022","692","6","698","2024-12-30"
"39463","2024","COM","2022","236","12","248","2024-12-30"
"39464","2024","COM","2022","237","1","238","2024-12-30"
"39465","2024","COM","2022","214","1","215","2024-12-30"
"39466","2024","COM","2022","119","3","122","2024-12-30"
"39467","2024","COM","2022","151","2","153","2024-12-30"
"39468","2024","COM","2022","132","0","132","2024-12-30"
"39469","2024","COM","2022","120","0","120","2024-12-30"
"39470","2024","COM","2022","3702","78","3780","2024-12-30"
"39471","2024","COM","2022","751","19","770","2024-12-30"
"39472","2024","COM","2022","218","4","222","2024-12-30"
"39473","2024","COM","2022","87","2","89","2024-12-30"
"39474","2024","COM","2022","364","5","369","2024-12-30"
"39475","2024","COM","2022","2364","97","2461","2024-12-30"
"39476","2024","COM","2022","1855","45","1900","2024-12-30"
"39477","2024","COM","2022","255","5","260","2024-12-30"
"39478","2024","COM","2022","8556","219","8775","2024-12-30"
"39479","2024","COM","2022","246","7","253","2024-12-30"
"39480","2024","COM","2022","277","9","286","2024-12-30"
"39481","2024","COM","2022","388","14","402","2024-12-30"
"39485","2024","COM","2022","782","14","796","2024-12-30"
"39486","2024","COM","2022","120","5","125","2024-12-30"
"39487","2024","COM","2022","1818","43","1861","2024-12-30"
"39489","2024","COM","2022","461","10","471","2024-12-30"
"39490","2024","COM","2022","239","5","244","2024-12-30"
"39491","2024","COM","2022","2146","83","2229","2024-12-30"
"39492","2024","COM","2022","214","6","220","2024-12-30"
"39493","2024","COM","2022","242","9","251","2024-12-30"
"39494","2024","COM","2022","362","22","384","2024-12-30"
"39495","2024","COM","2022","73","0","73","2024-12-30"
"39497","2024","COM","2022","99","1","100","2024-12-30"
"39498","2024","COM","2022","654","15","669","2024-12-30"
"39499","2024","COM","2022","189","1","190","2024-12-30"
"39500","2024","COM","2022","2430","147","2577","2024-12-30"
"39501","2024","COM","2022","1114","30","1144","2024-12-30"
"39502","2024","COM","2022","275","8","283","2024-12-30"
"39503","2024","COM","2022","400","17","417","2024-12-30"
"39504","2024","COM","2022","227","7","234","2024-12-30"
"39505","2024","COM","2022","56","3","59","2024-12-30"
"39507","2024","COM","2022","78","1","79","2024-12-30"
"39508","2024","COM","2022","728","7","735","2024-12-30"
"39510","2024","COM","2022","808","23","831","2024-12-30"
"39511","2024","COM","2022","64","1","65","2024-12-30"
"39512","2024","COM","2022","57","1","58","2024-12-30"
"39513","2024","COM","2022","236","2","238","2024-12-30"
"39514","2024","COM","2022","186","6","192","2024-12-30"
"39517","2024","COM","2022","550","15","565","2024-12-30"
"39518","2024","COM","2022","72","2","74","2024-12-30"
"39519","2024","COM","2022","174","5","179","2024-12-30"
"39520","2024","COM","2022","519","12","531","2024-12-30"
"39522","2024","COM","2022","108","2","110","2024-12-30"
"39523","2024","COM","2022","184","8","192","2024-12-30"
"39525","2024","COM","2022","396","8","404","2024-12-30"
"39526","2024","COM","2022","3926","104","4030","2024-12-30"
"39527","2024","COM","2022","125","2","127","2024-12-30"
"39528","2024","COM","2022","389","10","399","2024-12-30"
"39529","2024","COM","2022","64","1","65","2024-12-30"
"39530","2024","COM","2022","816","24","840","2024-12-30"
"39531","2024","COM","2022","183","2","185","2024-12-30"
"39532","2024","COM","2022","36","1","37","2024-12-30"
"39533","2024","COM","2022","209","7","216","2024-12-30"
"39534","2024","COM","2022","262","6","268","2024-12-30"
"39535","2024","COM","2022","445","14","459","2024-12-30"
"39537","2024","COM","2022","471","10","481","2024-12-30"
"39538","2024","COM","2022","65","1","66","2024-12-30"
"39539","2024","COM","2022","307","7","314","2024-12-30"
"39540","2024","COM","2022","205","8","213","2024-12-30"
"39543","2024","COM","2022","221","10","231","2024-12-30"
"39545","2024","COM","2022","166","5","171","2024-12-30"
"39546","2024","COM","2022","351","8","359","2024-12-30"
"39547","2024","COM","2022","675","21","696","2024-12-30"
"39548","2024","COM","2022","82","2","84","2024-12-30"
"39550","2024","COM","2022","197","4","201","2024-12-30"
"39551","2024","COM","2022","112","3","115","2024-12-30"
"39552","2024","COM","2022","287","9","296","2024-12-30"
"39553","2024","COM","2022","291","11","302","2024-12-30"
"39554","2024","COM","2022","230","5","235","2024-12-30"
"39555","2024","COM","2022","233","2","235","2024-12-30"
"39556","2024","COM","2022","87","2","89","2024-12-30"
"39557","2024","COM","2022","183","9","192","2024-12-30"
"39558","2024","COM","2022","302","6","308","2024-12-30"
"39559","2024","COM","2022","395","3","398","2024-12-30"
"39560","2024","COM","2022","582","14","596","2024-12-30"
"39561","2024","COM","2022","391","14","405","2024-12-30"
"39565","2024","COM","2022","96","1","97","2024-12-30"
"39567","2024","COM","2022","305","12","317","2024-12-30"
"39568","2024","COM","2022","34","2","36","2024-12-30"
"39569","2024","COM","2022","649","15","664","2024-12-30"
"39570","2024","COM","2022","225","7","232","2024-12-30"
"39571","2024","COM","2022","240","1","241","2024-12-30"
"39572","2024","COM","2022","365","14","379","2024-12-30"
"39573","2024","COM","2022","798","14","812","2024-12-30"
"39574","2024","COM","2022","707","17","724","2024-12-30"
"39575","2024","COM","2022","92","2","94","2024-12-30"
"39576","2024","COM","2022","945","26","971","2024-12-30"
"39577","2024","COM","2022","388","12","400","2024-12-30"
"39579","2024","COM","2022","893","30","923","2024-12-30"
"39581","2024","COM","2022","255","1","256","2024-12-30"
"39582","2024","COM","2022","784","24","808","2024-12-30"
"39583","2024","COM","2022","186","4","190","2024-12-30"
"39584","2024","COM","2022","162","1","163","2024-12-30"
"39585","2024","COM","2022","22","2","24","2024-12-30"
"39586","2024","COM","2022","27","1","28","2024-12-30"
"40001","2024","COM","2022","6215","472","6687","2024-12-30"
"40002","2024","COM","2022","1555","24","1579","2024-12-30"
"40003","2024","COM","2022","266","10","276","2024-12-30"
"40004","2024","COM","2022","2241","51","2292","2024-12-30"
"40005","2024","COM","2022","214","4","218","2024-12-30"
"40006","2024","COM","2022","713","9","722","2024-12-30"
"40007","2024","COM","2022","162","2","164","2024-12-30"
"40008","2024","COM","2022","96","1","97","2024-12-30"
"40011","2024","COM","2022","342","6","348","2024-12-30"
"40012","2024","COM","2022","260","4","264","2024-12-30"
"40013","2024","COM","2022","92","4","96","2024-12-30"
"40014","2024","COM","2022","358","6","364","2024-12-30"
"40015","2024","COM","2022","51","2","53","2024-12-30"
"40016","2024","COM","2022","274","2","276","2024-12-30"
"40017","2024","COM","2022","386","9","395","2024-12-30"
"40018","2024","COM","2022","410","8","418","2024-12-30"
"40019","2024","COM","2022","1117","18","1135","2024-12-30"
"40020","2024","COM","2022","629","22","651","2024-12-30"
"40021","2024","COM","2022","973","21","994","2024-12-30"
"40022","2024","COM","2022","393","14","407","2024-12-30"
"40023","2024","COM","2022","333","8","341","2024-12-30"
"40024","2024","COM","2022","267","7","274","2024-12-30"
"40025","2024","COM","2022","868","21","889","2024-12-30"
"40026","2024","COM","2022","402","12","414","2024-12-30"
"40027","2024","COM","2022","154","2","156","2024-12-30"
"40028","2024","COM","2022","244","7","251","2024-12-30"
"40029","2024","COM","2022","325","7","332","2024-12-30"
"40030","2024","COM","2022","53","0","53","2024-12-30"
"40031","2024","COM","2022","1233","22","1255","2024-12-30"
"40032","2024","COM","2022","222","2","224","2024-12-30"
"40033","2024","COM","2022","164","5","169","2024-12-30"
"40034","2024","COM","2022","616","28","644","2024-12-30"
"40035","2024","COM","2022","582","13","595","2024-12-30"
"40036","2024","COM","2022","3733","64","3797","2024-12-30"
"40037","2024","COM","2022","1913","49","1962","2024-12-30"
"40038","2024","COM","2022","109","5","114","2024-12-30"
"40039","2024","COM","2022","133","6","139","2024-12-30"
"40040","2024","COM","2022","402","10","412","2024-12-30"
"40041","2024","COM","2022","123","2","125","2024-12-30"
"40042","2024","COM","2022","350","7","357","2024-12-30"
"40043","2024","COM","2022","787","13","800","2024-12-30"
"40044","2024","COM","2022","1022","18","1040","2024-12-30"
"40046","2024","COM","2022","15412","386","15798","2024-12-30"
"40047","2024","COM","2022","255","6","261","2024-12-30"
"40049","2024","COM","2022","372","11","383","2024-12-30"
"40050","2024","COM","2022","205","2","207","2024-12-30"
"40051","2024","COM","2022","847","19","866","2024-12-30"
"40052","2024","COM","2022","205","4","209","2024-12-30"
"40053","2024","COM","2022","319","7","326","2024-12-30"
"40054","2024","COM","2022","273","4","277","2024-12-30"
"40055","2024","COM","2022","1626","49","1675","2024-12-30"
"40056","2024","COM","2022","727","16","743","2024-12-30"
"40057","2024","COM","2022","240","6","246","2024-12-30"
"40058","2024","COM","2022","230","11","241","2024-12-30"
"40059","2024","COM","2022","778","22","800","2024-12-30"
"40060","2024","COM","2022","145","2","147","2024-12-30"
"40061","2024","COM","2022","1025","22","1047","2024-12-30"
"40062","2024","COM","2022","518","11","529","2024-12-30"
"40063","2024","COM","2022","869","19","888","2024-12-30"
"40064","2024","COM","2022","172","4","176","2024-12-30"
"40065","2024","COM","2022","9218","281","9499","2024-12-30"
"40066","2024","COM","2022","540","10","550","2024-12-30"
"40067","2024","COM","2022","631","12","643","2024-12-30"
"40068","2024","COM","2022","607","8","615","2024-12-30"
"40069","2024","COM","2022","424","5","429","2024-12-30"
"40070","2024","COM","2022","420","12","432","2024-12-30"
"40071","2024","COM","2022","595","40","635","2024-12-30"
"40072","2024","COM","2022","185","6","191","2024-12-30"
"40073","2024","COM","2022","120","2","122","2024-12-30"
"40074","2024","COM","2022","576","20","596","2024-12-30"
"40075","2024","COM","2022","2510","54","2564","2024-12-30"
"40076","2024","COM","2022","423","8","431","2024-12-30"
"40077","2024","COM","2022","799","16","815","2024-12-30"
"40078","2024","COM","2022","397","11","408","2024-12-30"
"40079","2024","COM","2022","139","5","144","2024-12-30"
"40080","2024","COM","2022","1126","35","1161","2024-12-30"
"40081","2024","COM","2022","416","7","423","2024-12-30"
"40082","2024","COM","2022","246","7","253","2024-12-30"
"40083","2024","COM","2022","118","7","125","2024-12-30"
"40084","2024","COM","2022","742","34","776","2024-12-30"
"40085","2024","COM","2022","434","9","443","2024-12-30"
"40086","2024","COM","2022","558","8","566","2024-12-30"
"40087","2024","COM","2022","336","5","341","2024-12-30"
"40088","2024","COM","2022","21716","829","22545","2024-12-30"
"40089","2024","COM","2022","851","27","878","2024-12-30"
"40090","2024","COM","2022","454","10","464","2024-12-30"
"40091","2024","COM","2022","682","13","695","2024-12-30"
"40092","2024","COM","2022","250","5","255","2024-12-30"
"40093","2024","COM","2022","232","7","239","2024-12-30"
"40094","2024","COM","2022","799","17","816","2024-12-30"
"40095","2024","COM","2022","697","20","717","2024-12-30"
"40096","2024","COM","2022","96","2","98","2024-12-30"
"40097","2024","COM","2022","486","9","495","2024-12-30"
"40098","2024","COM","2022","347","7","354","2024-12-30"
"40099","2024","COM","2022","314","4","318","2024-12-30"
"40100","2024","COM","2022","388","8","396","2024-12-30"
"40101","2024","COM","2022","471","16","487","2024-12-30"
"40102","2024","COM","2022","1282","207","1489","2024-12-30"
"40103","2024","COM","2022","647","11","658","2024-12-30"
"40104","2024","COM","2022","1552","17","1569","2024-12-30"
"40105","2024","COM","2022","426","13","439","2024-12-30"
"40106","2024","COM","2022","215","6","221","2024-12-30"
"40108","2024","COM","2022","925","18","943","2024-12-30"
"40109","2024","COM","2022","436","9","445","2024-12-30"
"40110","2024","COM","2022","763","18","781","2024-12-30"
"40111","2024","COM","2022","708","14","722","2024-12-30"
"40112","2024","COM","2022","98","2","100","2024-12-30"
"40113","2024","COM","2022","530","15","545","2024-12-30"
"40114","2024","COM","2022","364","12","376","2024-12-30"
"40115","2024","COM","2022","276","10","286","2024-12-30"
"40116","2024","COM","2022","272","6","278","2024-12-30"
"40117","2024","COM","2022","2414","58","2472","2024-12-30"
"40118","2024","COM","2022","1464","30","1494","2024-12-30"
"40119","2024","COM","2022","4622","106","4728","2024-12-30"
"40120","2024","COM","2022","606","17","623","2024-12-30"
"40121","2024","COM","2022","273","4","277","2024-12-30"
"40122","2024","COM","2022","991","27","1018","2024-12-30"
"40123","2024","COM","2022","1189","35","1224","2024-12-30"
"40124","2024","COM","2022","141","2","143","2024-12-30"
"40125","2024","COM","2022","1395","40","1435","2024-12-30"
"40126","2024","COM","2022","1909","46","1955","2024-12-30"
"40127","2024","COM","2022","611","8","619","2024-12-30"
"40128","2024","COM","2022","706","16","722","2024-12-30"
"40129","2024","COM","2022","1003","20","1023","2024-12-30"
"40130","2024","COM","2022","168","0","168","2024-12-30"
"40131","2024","COM","2022","680","3","683","2024-12-30"
"40132","2024","COM","2022","1396","26","1422","2024-12-30"
"40133","2024","COM","2022","7095","119","7214","2024-12-30"
"40134","2024","COM","2022","2883","39","2922","2024-12-30"
"40135","2024","COM","2022","849","22","871","2024-12-30"
"40136","2024","COM","2022","148","0","148","2024-12-30"
"40137","2024","COM","2022","288","10","298","2024-12-30"
"40138","2024","COM","2022","286","6","292","2024-12-30"
"40139","2024","COM","2022","603","12","615","2024-12-30"
"40140","2024","COM","2022","190","1","191","2024-12-30"
"40141","2024","COM","2022","286","3","289","2024-12-30"
"40142","2024","COM","2022","1086","22","1108","2024-12-30"
"40143","2024","COM","2022","305","6","311","2024-12-30"
"40144","2024","COM","2022","240","11","251","2024-12-30"
"40145","2024","COM","2022","588","20","608","2024-12-30"
"40146","2024","COM","2022","167","1","168","2024-12-30"
"40147","2024","COM","2022","367","2","369","2024-12-30"
"40148","2024","COM","2022","78","5","83","2024-12-30"
"40149","2024","COM","2022","376","3","379","2024-12-30"
"40150","2024","COM","2022","2182","40","2222","2024-12-30"
"40151","2024","COM","2022","425","15","440","2024-12-30"
"40152","2024","COM","2022","1030","28","1058","2024-12-30"
"40153","2024","COM","2022","228","6","234","2024-12-30"
"40154","2024","COM","2022","345","4","349","2024-12-30"
"40155","2024","COM","2022","1550","39","1589","2024-12-30"
"40156","2024","COM","2022","591","10","601","2024-12-30"
"40157","2024","COM","2022","1704","43","1747","2024-12-30"
"40158","2024","COM","2022","282","2","284","2024-12-30"
"40159","2024","COM","2022","332","4","336","2024-12-30"
"40160","2024","COM","2022","188","10","198","2024-12-30"
"40161","2024","COM","2022","80","1","81","2024-12-30"
"40162","2024","COM","2022","564","9","573","2024-12-30"
"40163","2024","COM","2022","613","8","621","2024-12-30"
"40164","2024","COM","2022","321","5","326","2024-12-30"
"40165","2024","COM","2022","375","13","388","2024-12-30"
"40166","2024","COM","2022","77","1","78","2024-12-30"
"40167","2024","COM","2022","653","11","664","2024-12-30"
"40168","2024","COM","2022","2602","49","2651","2024-12-30"
"40169","2024","COM","2022","128","3","131","2024-12-30"
"40170","2024","COM","2022","230","5","235","2024-12-30"
"40171","2024","COM","2022","129","3","132","2024-12-30"
"40172","2024","COM","2022","270","7","277","2024-12-30"
"40173","2024","COM","2022","133","4","137","2024-12-30"
"40174","2024","COM","2022","85","4","89","2024-12-30"
"40175","2024","COM","2022","457","8","465","2024-12-30"
"40176","2024","COM","2022","99","2","101","2024-12-30"
"40177","2024","COM","2022","301","6","307","2024-12-30"
"40178","2024","COM","2022","670","26","696","2024-12-30"
"40179","2024","COM","2022","1970","45","2015","2024-12-30"
"40180","2024","COM","2022","1206","25","1231","2024-12-30"
"40181","2024","COM","2022","1038","26","1064","2024-12-30"
"40182","2024","COM","2022","855","21","876","2024-12-30"
"40183","2024","COM","2022","992","21","1013","2024-12-30"
"40184","2024","COM","2022","7449","180","7629","2024-12-30"
"40185","2024","COM","2022","346","3","349","2024-12-30"
"40186","2024","COM","2022","834","19","853","2024-12-30"
"40187","2024","COM","2022","1303","22","1325","2024-12-30"
"40188","2024","COM","2022","482","10","492","2024-12-30"
"40189","2024","COM","2022","77","3","80","2024-12-30"
"40190","2024","COM","2022","393","13","406","2024-12-30"
"40191","2024","COM","2022","604","17","621","2024-12-30"
"40192","2024","COM","2022","31455","1412","32867","2024-12-30"
"40193","2024","COM","2022","78","2","80","2024-12-30"
"40194","2024","COM","2022","1223","23","1246","2024-12-30"
"40195","2024","COM","2022","593","14","607","2024-12-30"
"40196","2024","COM","2022","561","13","574","2024-12-30"
"40197","2024","COM","2022","5005","133","5138","2024-12-30"
"40198","2024","COM","2022","168","7","175","2024-12-30"
"40199","2024","COM","2022","268","4","272","2024-12-30"
"40200","2024","COM","2022","755","6","761","2024-12-30"
"40201","2024","COM","2022","1336","102","1438","2024-12-30"
"40202","2024","COM","2022","3331","79","3410","2024-12-30"
"40203","2024","COM","2022","316","13","329","2024-12-30"
"40204","2024","COM","2022","267","7","274","2024-12-30"
"40205","2024","COM","2022","249","7","256","2024-12-30"
"40206","2024","COM","2022","304","12","316","2024-12-30"
"40207","2024","COM","2022","1498","205","1703","2024-12-30"
"40208","2024","COM","2022","376","14","390","2024-12-30"
"40209","2024","COM","2022","6194","92","6286","2024-12-30"
"40210","2024","COM","2022","1057","17","1074","2024-12-30"
"40211","2024","COM","2022","789","16","805","2024-12-30"
"40212","2024","COM","2022","1057","24","1081","2024-12-30"
"40213","2024","COM","2022","650","12","662","2024-12-30"
"40214","2024","COM","2022","493","7","500","2024-12-30"
"40215","2024","COM","2022","285","8","293","2024-12-30"
"40216","2024","COM","2022","198","2","200","2024-12-30"
"40217","2024","COM","2022","7463","194","7657","2024-12-30"
"40218","2024","COM","2022","454","14","468","2024-12-30"
"40219","2024","COM","2022","106","2","108","2024-12-30"
"40220","2024","COM","2022","135","2","137","2024-12-30"
"40221","2024","COM","2022","342","5","347","2024-12-30"
"40222","2024","COM","2022","832","12","844","2024-12-30"
"40223","2024","COM","2022","237","3","240","2024-12-30"
"40224","2024","COM","2022","3693","184","3877","2024-12-30"
"40225","2024","COM","2022","189","2","191","2024-12-30"
"40226","2024","COM","2022","198","3","201","2024-12-30"
"40227","2024","COM","2022","1483","21","1504","2024-12-30"
"40228","2024","COM","2022","1605","26","1631","2024-12-30"
"40229","2024","COM","2022","1737","41","1778","2024-12-30"
"40230","2024","COM","2022","2975","101","3076","2024-12-30"
"40231","2024","COM","2022","1228","35","1263","2024-12-30"
"40232","2024","COM","2022","219","9","228","2024-12-30"
"40233","2024","COM","2022","3151","69","3220","2024-12-30"
"40234","2024","COM","2022","879","20","899","2024-12-30"
"40235","2024","COM","2022","697","19","716","2024-12-30"
"40236","2024","COM","2022","765","18","783","2024-12-30"
"40237","2024","COM","2022","797","7","804","2024-12-30"
"40238","2024","COM","2022","625","18","643","2024-12-30"
"40239","2024","COM","2022","104","4","108","2024-12-30"
"40240","2024","COM","2022","490","17","507","2024-12-30"
"40242","2024","COM","2022","104","0","104","2024-12-30"
"40243","2024","COM","2022","3115","58","3173","2024-12-30"
"40244","2024","COM","2022","1425","33","1458","2024-12-30"
"40245","2024","COM","2022","1987","34","2021","2024-12-30"
"40246","2024","COM","2022","1191","140","1331","2024-12-30"
"40247","2024","COM","2022","181","5","186","2024-12-30"
"40248","2024","COM","2022","1913","40","1953","2024-12-30"
"40249","2024","COM","2022","500","11","511","2024-12-30"
"40250","2024","COM","2022","691","12","703","2024-12-30"
"40251","2024","COM","2022","421","13","434","2024-12-30"
"40252","2024","COM","2022","618","15","633","2024-12-30"
"40253","2024","COM","2022","633","21","654","2024-12-30"
"40254","2024","COM","2022","444","12","456","2024-12-30"
"40255","2024","COM","2022","464","12","476","2024-12-30"
"40256","2024","COM","2022","732","18","750","2024-12-30"
"40257","2024","COM","2022","1457","32","1489","2024-12-30"
"40258","2024","COM","2022","251","10","261","2024-12-30"
"40259","2024","COM","2022","418","17","435","2024-12-30"
"40260","2024","COM","2022","410","7","417","2024-12-30"
"40261","2024","COM","2022","2946","50","2996","2024-12-30"
"40262","2024","COM","2022","312","5","317","2024-12-30"
"40263","2024","COM","2022","407","6","413","2024-12-30"
"40264","2024","COM","2022","1810","38","1848","2024-12-30"
"40265","2024","COM","2022","109","0","109","2024-12-30"
"40266","2024","COM","2022","1738","38","1776","2024-12-30"
"40267","2024","COM","2022","1015","13","1028","2024-12-30"
"40268","2024","COM","2022","735","23","758","2024-12-30"
"40269","2024","COM","2022","1242","34","1276","2024-12-30"
"40270","2024","COM","2022","441","14","455","2024-12-30"
"40271","2024","COM","2022","1228","27","1255","2024-12-30"
"40272","2024","COM","2022","1749","37","1786","2024-12-30"
"40273","2024","COM","2022","6123","132","6255","2024-12-30"
"40274","2024","COM","2022","1356","38","1394","2024-12-30"
"40275","2024","COM","2022","623","20","643","2024-12-30"
"40276","2024","COM","2022","324","3","327","2024-12-30"
"40277","2024","COM","2022","728","43","771","2024-12-30"
"40278","2024","COM","2022","982","16","998","2024-12-30"
"40279","2024","COM","2022","14114","493","14607","2024-12-30"
"40280","2024","COM","2022","1729","28","1757","2024-12-30"
"40281","2024","COM","2022","9996","366","10362","2024-12-30"
"40282","2024","COM","2022","5038","127","5165","2024-12-30"
"40283","2024","COM","2022","3384","140","3524","2024-12-30"
"40284","2024","COM","2022","8051","249","8300","2024-12-30"
"40285","2024","COM","2022","628","13","641","2024-12-30"
"40286","2024","COM","2022","1131","25","1156","2024-12-30"
"40287","2024","COM","2022","4662","75","4737","2024-12-30"
"40288","2024","COM","2022","1151","23","1174","2024-12-30"
"40289","2024","COM","2022","241","4","245","2024-12-30"
"40290","2024","COM","2022","105","3","108","2024-12-30"
"40291","2024","COM","2022","1806","34","1840","2024-12-30"
"40292","2024","COM","2022","1605","72","1677","2024-12-30"
"40293","2024","COM","2022","1099","20","1119","2024-12-30"
"40294","2024","COM","2022","1568","33","1601","2024-12-30"
"40295","2024","COM","2022","1298","10","1308","2024-12-30"
"40296","2024","COM","2022","3914","100","4014","2024-12-30"
"40297","2024","COM","2022","221","4","225","2024-12-30"
"40298","2024","COM","2022","401","12","413","2024-12-30"
"40299","2024","COM","2022","193","3","196","2024-12-30"
"40300","2024","COM","2022","1022","28","1050","2024-12-30"
"40301","2024","COM","2022","137","5","142","2024-12-30"
"40303","2024","COM","2022","361","5","366","2024-12-30"
"40304","2024","COM","2022","3669","69","3738","2024-12-30"
"40305","2024","COM","2022","193","6","199","2024-12-30"
"40306","2024","COM","2022","636","10","646","2024-12-30"
"40307","2024","COM","2022","1162","21","1183","2024-12-30"
"40308","2024","COM","2022","887","26","913","2024-12-30"
"40309","2024","COM","2022","1131","21","1152","2024-12-30"
"40310","2024","COM","2022","8445","208","8653","2024-12-30"
"40311","2024","COM","2022","680","19","699","2024-12-30"
"40312","2024","COM","2022","12900","329","13229","2024-12-30"
"40313","2024","COM","2022","3174","50","3224","2024-12-30"
"40314","2024","COM","2022","1331","26","1357","2024-12-30"
"40315","2024","COM","2022","763","21","784","2024-12-30"
"40316","2024","COM","2022","841","19","860","2024-12-30"
"40317","2024","COM","2022","3455","82","3537","2024-12-30"
"40318","2024","COM","2022","309","6","315","2024-12-30"
"40319","2024","COM","2022","285","6","291","2024-12-30"
"40320","2024","COM","2022","610","15","625","2024-12-30"
"40321","2024","COM","2022","242","6","248","2024-12-30"
"40322","2024","COM","2022","188","2","190","2024-12-30"
"40323","2024","COM","2022","238","5","243","2024-12-30"
"40324","2024","COM","2022","249","9","258","2024-12-30"
"40325","2024","COM","2022","283","11","294","2024-12-30"
"40326","2024","COM","2022","1451","42","1493","2024-12-30"
"40327","2024","COM","2022","224","3","227","2024-12-30"
"40328","2024","COM","2022","1682","31","1713","2024-12-30"
"40329","2024","COM","2022","508","8","516","2024-12-30"
"40330","2024","COM","2022","313","10","323","2024-12-30"
"40331","2024","COM","2022","2487","48","2535","2024-12-30"
"40332","2024","COM","2022","2342","59","2401","2024-12-30"
"40333","2024","COM","2022","1344","25","1369","2024-12-30"
"40334","2024","COM","2022","384","16","400","2024-12-30"
"41001","2024","COM","2022","187","5","192","2024-12-30"
"41002","2024","COM","2022","801","21","822","2024-12-30"
"41003","2024","COM","2022","580","200","780","2024-12-30"
"41004","2024","COM","2022","269","5","274","2024-12-30"
"41006","2024","COM","2022","429","12","441","2024-12-30"
"41007","2024","COM","2022","749","14","763","2024-12-30"
"41008","2024","COM","2022","680","20","700","2024-12-30"
"41009","2024","COM","2022","677","18","695","2024-12-30"
"41010","2024","COM","2022","986","20","1006","2024-12-30"
"41012","2024","COM","2022","205","3","208","2024-12-30"
"41013","2024","COM","2022","271","7","278","2024-12-30"
"41014","2024","COM","2022","165","1","166","2024-12-30"
"41016","2024","COM","2022","1102","18","1120","2024-12-30"
"41017","2024","COM","2022","658","21","679","2024-12-30"
"41018","2024","COM","2022","47092","1490","48582","2024-12-30"
"41019","2024","COM","2022","104","2","106","2024-12-30"
"41020","2024","COM","2022","455","10","465","2024-12-30"
"41022","2024","COM","2022","136","2","138","2024-12-30"
"41024","2024","COM","2022","179","7","186","2024-12-30"
"41025","2024","COM","2022","1341","16","1357","2024-12-30"
"41026","2024","COM","2022","161","2","163","2024-12-30"
"41027","2024","COM","2022","143","6","149","2024-12-30"
"41028","2024","COM","2022","496","9","505","2024-12-30"
"41029","2024","COM","2022","1487","29","1516","2024-12-30"
"41030","2024","COM","2022","225","5","230","2024-12-30"
"41031","2024","COM","2022","2700","72","2772","2024-12-30"
"41032","2024","COM","2022","2708","70","2778","2024-12-30"
"41034","2024","COM","2022","99","3","102","2024-12-30"
"41035","2024","COM","2022","607","23","630","2024-12-30"
"41036","2024","COM","2022","440","10","450","2024-12-30"
"41037","2024","COM","2022","211","4","215","2024-12-30"
"41038","2024","COM","2022","409","12","421","2024-12-30"
"41039","2024","COM","2022","693","20","713","2024-12-30"
"41040","2024","COM","2022","797","15","812","2024-12-30"
"41041","2024","COM","2022","160","1","161","2024-12-30"
"41042","2024","COM","2022","524","8","532","2024-12-30"
"41043","2024","COM","2022","1661","34","1695","2024-12-30"
"41044","2024","COM","2022","1134","14","1148","2024-12-30"
"41045","2024","COM","2022","1091","22","1113","2024-12-30"
"41046","2024","COM","2022","1045","20","1065","2024-12-30"
"41047","2024","COM","2022","4488","114","4602","2024-12-30"
"41048","2024","COM","2022","230","4","234","2024-12-30"
"41049","2024","COM","2022","944","13","957","2024-12-30"
"41050","2024","COM","2022","908","25","933","2024-12-30"
"41051","2024","COM","2022","1076","26","1102","2024-12-30"
"41052","2024","COM","2022","1136","34","1170","2024-12-30"
"41053","2024","COM","2022","515","10","525","2024-12-30"
"41054","2024","COM","2022","352","7","359","2024-12-30"
"41055","2024","COM","2022","2433","56","2489","2024-12-30"
"41057","2024","COM","2022","161","6","167","2024-12-30"
"41058","2024","COM","2022","188","1","189","2024-12-30"
"41059","2024","COM","2022","6787","149","6936","2024-12-30"
"41060","2024","COM","2022","690","7","697","2024-12-30"
"41061","2024","COM","2022","1568","25","1593","2024-12-30"
"41062","2024","COM","2022","534","12","546","2024-12-30"
"41063","2024","COM","2022","503","8","511","2024-12-30"
"41065","2024","COM","2022","575","16","591","2024-12-30"
"41066","2024","COM","2022","424","15","439","2024-12-30"
"41067","2024","COM","2022","2830","78","2908","2024-12-30"
"41068","2024","COM","2022","498","7","505","2024-12-30"
"41069","2024","COM","2022","252","6","258","2024-12-30"
"41070","2024","COM","2022","527","14","541","2024-12-30"
"41071","2024","COM","2022","521","6","527","2024-12-30"
"41072","2024","COM","2022","422","14","436","2024-12-30"
"41073","2024","COM","2022","671","17","688","2024-12-30"
"41074","2024","COM","2022","1200","17","1217","2024-12-30"
"41075","2024","COM","2022","1027","7","1034","2024-12-30"
"41077","2024","COM","2022","119","6","125","2024-12-30"
"41078","2024","COM","2022","790","22","812","2024-12-30"
"41079","2024","COM","2022","98","0","98","2024-12-30"
"41080","2024","COM","2022","1426","30","1456","2024-12-30"
"41081","2024","COM","2022","220","5","225","2024-12-30"
"41083","2024","COM","2022","582","3","585","2024-12-30"
"41084","2024","COM","2022","951","18","969","2024-12-30"
"41085","2024","COM","2022","1078","23","1101","2024-12-30"
"41086","2024","COM","2022","659","8","667","2024-12-30"
"41087","2024","COM","2022","326","7","333","2024-12-30"
"41088","2024","COM","2022","235","8","243","2024-12-30"
"41089","2024","COM","2022","207","2","209","2024-12-30"
"41090","2024","COM","2022","253","5","258","2024-12-30"
"41091","2024","COM","2022","1270","23","1293","2024-12-30"
"41093","2024","COM","2022","271","10","281","2024-12-30"
"41094","2024","COM","2022","1199","33","1232","2024-12-30"
"41095","2024","COM","2022","1065","15","1080","2024-12-30"
"41096","2024","COM","2022","319","2","321","2024-12-30"
"41097","2024","COM","2022","2290","23","2313","2024-12-30"
"41098","2024","COM","2022","163","4","167","2024-12-30"
"41099","2024","COM","2022","496","11","507","2024-12-30"
"41100","2024","COM","2022","172","7","179","2024-12-30"
"41101","2024","COM","2022","1139","31","1170","2024-12-30"
"41102","2024","COM","2022","371","5","376","2024-12-30"
"41103","2024","COM","2022","410","12","422","2024-12-30"
"41104","2024","COM","2022","2293","54","2347","2024-12-30"
"41105","2024","COM","2022","862","17","879","2024-12-30"
"41106","2024","COM","2022","4519","55","4574","2024-12-30"
"41107","2024","COM","2022","474","12","486","2024-12-30"
"41108","2024","COM","2022","121","1","122","2024-12-30"
"41109","2024","COM","2022","727","19","746","2024-12-30"
"41110","2024","COM","2022","826","21","847","2024-12-30"
"41112","2024","COM","2022","243","10","253","2024-12-30"
"41113","2024","COM","2022","178","5","183","2024-12-30"
"41114","2024","COM","2022","288","6","294","2024-12-30"
"41115","2024","COM","2022","409","4","413","2024-12-30"
"41116","2024","COM","2022","186","2","188","2024-12-30"
"41118","2024","COM","2022","224","4","228","2024-12-30"
"41119","2024","COM","2022","353","5","358","2024-12-30"
"41120","2024","COM","2022","1260","33","1293","2024-12-30"
"41121","2024","COM","2022","32","0","32","2024-12-30"
"41122","2024","COM","2022","226","7","233","2024-12-30"
"41123","2024","COM","2022","679","8","687","2024-12-30"
"41124","2024","COM","2022","323","20","343","2024-12-30"
"41125","2024","COM","2022","742","16","758","2024-12-30"
"41126","2024","COM","2022","1155","24","1179","2024-12-30"
"41127","2024","COM","2022","365","6","371","2024-12-30"
"41128","2024","COM","2022","721","18","739","2024-12-30"
"41129","2024","COM","2022","661","11","672","2024-12-30"
"41130","2024","COM","2022","680","13","693","2024-12-30"
"41131","2024","COM","2022","816","23","839","2024-12-30"
"41132","2024","COM","2022","308","4","312","2024-12-30"
"41134","2024","COM","2022","620","18","638","2024-12-30"
"41135","2024","COM","2022","846","20","866","2024-12-30"
"41136","2024","COM","2022","6294","106","6400","2024-12-30"
"41137","2024","COM","2022","549","12","561","2024-12-30"
"41138","2024","COM","2022","302","9","311","2024-12-30"
"41139","2024","COM","2022","1039","17","1056","2024-12-30"
"41140","2024","COM","2022","722","18","740","2024-12-30"
"41141","2024","COM","2022","341","8","349","2024-12-30"
"41142","2024","COM","2022","2329","96","2425","2024-12-30"
"41143","2024","COM","2022","1306","41","1347","2024-12-30"
"41144","2024","COM","2022","723","23","746","2024-12-30"
"41145","2024","COM","2022","793","22","815","2024-12-30"
"41146","2024","COM","2022","993","13","1006","2024-12-30"
"41147","2024","COM","2022","1925","42","1967","2024-12-30"
"41148","2024","COM","2022","1307","33","1340","2024-12-30"
"41149","2024","COM","2022","3678","198","3876","2024-12-30"
"41150","2024","COM","2022","3360","71","3431","2024-12-30"
"41151","2024","COM","2022","3641","45","3686","2024-12-30"
"41152","2024","COM","2022","636","14","650","2024-12-30"
"41153","2024","COM","2022","141","2","143","2024-12-30"
"41154","2024","COM","2022","1079","27","1106","2024-12-30"
"41155","2024","COM","2022","1250","27","1277","2024-12-30"
"41156","2024","COM","2022","514","9","523","2024-12-30"
"41157","2024","COM","2022","1518","14","1532","2024-12-30"
"41158","2024","COM","2022","2439","59","2498","2024-12-30"
"41159","2024","COM","2022","1263","17","1280","2024-12-30"
"41160","2024","COM","2022","316","7","323","2024-12-30"
"41161","2024","COM","2022","2293","48","2341","2024-12-30"
"41163","2024","COM","2022","126","2","128","2024-12-30"
"41164","2024","COM","2022","2654","37","2691","2024-12-30"
"41166","2024","COM","2022","390","11","401","2024-12-30"
"41167","2024","COM","2022","3327","81","3408","2024-12-30"
"41168","2024","COM","2022","216","4","220","2024-12-30"
"41171","2024","COM","2022","1647","28","1675","2024-12-30"
"41172","2024","COM","2022","228","1","229","2024-12-30"
"41173","2024","COM","2022","3350","60","3410","2024-12-30"
"41174","2024","COM","2022","168","6","174","2024-12-30"
"41175","2024","COM","2022","1093","32","1125","2024-12-30"
"41176","2024","COM","2022","752","12","764","2024-12-30"
"41177","2024","COM","2022","149","2","151","2024-12-30"
"41178","2024","COM","2022","58","2","60","2024-12-30"
"41179","2024","COM","2022","198","1","199","2024-12-30"
"41180","2024","COM","2022","1537","210","1747","2024-12-30"
"41181","2024","COM","2022","786","22","808","2024-12-30"
"41182","2024","COM","2022","280","10","290","2024-12-30"
"41184","2024","COM","2022","587","13","600","2024-12-30"
"41185","2024","COM","2022","2281","55","2336","2024-12-30"
"41186","2024","COM","2022","301","6","307","2024-12-30"
"41187","2024","COM","2022","176","6","182","2024-12-30"
"41188","2024","COM","2022","116","3","119","2024-12-30"
"41189","2024","COM","2022","455","11","466","2024-12-30"
"41190","2024","COM","2022","220","5","225","2024-12-30"
"41191","2024","COM","2022","64","2","66","2024-12-30"
"41192","2024","COM","2022","289","6","295","2024-12-30"
"41193","2024","COM","2022","155","2","157","2024-12-30"
"41194","2024","COM","2022","18377","459","18836","2024-12-30"
"41195","2024","COM","2022","151","2","153","2024-12-30"
"41196","2024","COM","2022","80","3","83","2024-12-30"
"41198","2024","COM","2022","2826","87","2913","2024-12-30"
"41199","2024","COM","2022","1214","36","1250","2024-12-30"
"41200","2024","COM","2022","478","29","507","2024-12-30"
"41201","2024","COM","2022","310","3","313","2024-12-30"
"41203","2024","COM","2022","493","8","501","2024-12-30"
"41204","2024","COM","2022","1772","34","1806","2024-12-30"
"41205","2024","COM","2022","174","2","176","2024-12-30"
"41206","2024","COM","2022","904","27","931","2024-12-30"
"41207","2024","COM","2022","1155","22","1177","2024-12-30"
"41208","2024","COM","2022","115","2","117","2024-12-30"
"41209","2024","COM","2022","756","42","798","2024-12-30"
"41211","2024","COM","2022","2711","53","2764","2024-12-30"
"41212","2024","COM","2022","3184","96","3280","2024-12-30"
"41213","2024","COM","2022","96","5","101","2024-12-30"
"41214","2024","COM","2022","656","13","669","2024-12-30"
"41215","2024","COM","2022","92","2","94","2024-12-30"
"41216","2024","COM","2022","507","9","516","2024-12-30"
"41217","2024","COM","2022","777","20","797","2024-12-30"
"41218","2024","COM","2022","756","16","772","2024-12-30"
"41219","2024","COM","2022","329","3","332","2024-12-30"
"41220","2024","COM","2022","4249","81","4330","2024-12-30"
"41221","2024","COM","2022","638","7","645","2024-12-30"
"41222","2024","COM","2022","365","6","371","2024-12-30"
"41223","2024","COM","2022","776","17","793","2024-12-30"
"41224","2024","COM","2022","183","0","183","2024-12-30"
"41225","2024","COM","2022","587","12","599","2024-12-30"
"41226","2024","COM","2022","3016","78","3094","2024-12-30"
"41228","2024","COM","2022","294","6","300","2024-12-30"
"41229","2024","COM","2022","1458","25","1483","2024-12-30"
"41230","2024","COM","2022","1841","57","1898","2024-12-30"
"41231","2024","COM","2022","1185","26","1211","2024-12-30"
"41232","2024","COM","2022","4880","97","4977","2024-12-30"
"41233","2024","COM","2022","872","15","887","2024-12-30"
"41234","2024","COM","2022","293","11","304","2024-12-30"
"41235","2024","COM","2022","956","19","975","2024-12-30"
"41236","2024","COM","2022","90","3","93","2024-12-30"
"41237","2024","COM","2022","1110","23","1133","2024-12-30"
"41238","2024","COM","2022","1960","30","1990","2024-12-30"
"41239","2024","COM","2022","982","24","1006","2024-12-30"
"41241","2024","COM","2022","1340","24","1364","2024-12-30"
"41242","2024","COM","2022","4225","61","4286","2024-12-30"
"41243","2024","COM","2022","795","20","815","2024-12-30"
"41245","2024","COM","2022","396","4","400","2024-12-30"
"41246","2024","COM","2022","486","15","501","2024-12-30"
"41247","2024","COM","2022","1570","30","1600","2024-12-30"
"41248","2024","COM","2022","1045","21","1066","2024-12-30"
"41249","2024","COM","2022","1013","12","1025","2024-12-30"
"41250","2024","COM","2022","478","7","485","2024-12-30"
"41251","2024","COM","2022","509","8","517","2024-12-30"
"41252","2024","COM","2022","1583","37","1620","2024-12-30"
"41253","2024","COM","2022","277","5","282","2024-12-30"
"41254","2024","COM","2022","173","4","177","2024-12-30"
"41255","2024","COM","2022","330","6","336","2024-12-30"
"41256","2024","COM","2022","1252","16","1268","2024-12-30"
"41258","2024","COM","2022","1171","23","1194","2024-12-30"
"41259","2024","COM","2022","817","35","852","2024-12-30"
"41260","2024","COM","2022","425","6","431","2024-12-30"
"41261","2024","COM","2022","129","3","132","2024-12-30"
"41262","2024","COM","2022","1133","28","1161","2024-12-30"
"41265","2024","COM","2022","304","6","310","2024-12-30"
"41266","2024","COM","2022","84","3","87","2024-12-30"
"41267","2024","COM","2022","944","16","960","2024-12-30"
"41268","2024","COM","2022","148","3","151","2024-12-30"
"41269","2024","COM","2022","15566","624","16190","2024-12-30"
"41271","2024","COM","2022","557","13","570","2024-12-30"
"41273","2024","COM","2022","466","15","481","2024-12-30"
"41274","2024","COM","2022","125","1","126","2024-12-30"
"41275","2024","COM","2022","1223","25","1248","2024-12-30"
"41276","2024","COM","2022","2558","84","2642","2024-12-30"
"41277","2024","COM","2022","119","0","119","2024-12-30"
"41278","2024","COM","2022","255","4","259","2024-12-30"
"41279","2024","COM","2022","384","8","392","2024-12-30"
"41280","2024","COM","2022","2657","59","2716","2024-12-30"
"41281","2024","COM","2022","420","9","429","2024-12-30"
"41282","2024","COM","2022","412","11","423","2024-12-30"
"41283","2024","COM","2022","269","8","277","2024-12-30"
"41284","2024","COM","2022","65","3","68","2024-12-30"
"41285","2024","COM","2022","494","3","497","2024-12-30"
"41286","2024","COM","2022","146","4","150","2024-12-30"
"41287","2024","COM","2022","490","14","504","2024-12-30"
"41288","2024","COM","2022","832","16","848","2024-12-30"
"41289","2024","COM","2022","388","9","397","2024-12-30"
"41290","2024","COM","2022","222","2","224","2024-12-30"
"41291","2024","COM","2022","318","4","322","2024-12-30"
"41292","2024","COM","2022","203","1","204","2024-12-30"
"41293","2024","COM","2022","246","5","251","2024-12-30"
"41294","2024","COM","2022","1115","56","1171","2024-12-30"
"41295","2024","COM","2022","8050","210","8260","2024-12-30"
"41296","2024","COM","2022","1424","39","1463","2024-12-30"
"41297","2024","COM","2022","757","11","768","2024-12-30"
"42001","2024","COM","2022","483","6","489","2024-12-30"
"42002","2024","COM","2022","179","3","182","2024-12-30"
"42003","2024","COM","2022","1877","46","1923","2024-12-30"
"42005","2024","COM","2022","10312","167","10479","2024-12-30"
"42006","2024","COM","2022","424","14","438","2024-12-30"
"42007","2024","COM","2022","217","5","222","2024-12-30"
"42008","2024","COM","2022","110","2","112","2024-12-30"
"42009","2024","COM","2022","526","17","543","2024-12-30"
"42010","2024","COM","2022","1693","26","1719","2024-12-30"
"42011","2024","COM","2022","2848","56","2904","2024-12-30"
"42012","2024","COM","2022","686","24","710","2024-12-30"
"42013","2024","COM","2022","2004","51","2055","2024-12-30"
"42014","2024","COM","2022","313","8","321","2024-12-30"
"42015","2024","COM","2022","1429","26","1455","2024-12-30"
"42016","2024","COM","2022","425","11","436","2024-12-30"
"42017","2024","COM","2022","525","7","532","2024-12-30"
"42018","2024","COM","2022","465","11","476","2024-12-30"
"42019","2024","COM","2022","3017","71","3088","2024-12-30"
"42020","2024","COM","2022","1214","25","1239","2024-12-30"
"42021","2024","COM","2022","1284","9","1293","2024-12-30"
"42022","2024","COM","2022","4478","52","4530","2024-12-30"
"42023","2024","COM","2022","2920","58","2978","2024-12-30"
"42025","2024","COM","2022","196","4","200","2024-12-30"
"42026","2024","COM","2022","1718","33","1751","2024-12-30"
"42027","2024","COM","2022","433","5","438","2024-12-30"
"42028","2024","COM","2022","409","4","413","2024-12-30"
"42029","2024","COM","2022","1531","31","1562","2024-12-30"
"42030","2024","COM","2022","542","5","547","2024-12-30"
"42031","2024","COM","2022","322","8","330","2024-12-30"
"42032","2024","COM","2022","1719","27","1746","2024-12-30"
"42033","2024","COM","2022","614","25","639","2024-12-30"
"42034","2024","COM","2022","99","6","105","2024-12-30"
"42035","2024","COM","2022","208","9","217","2024-12-30"
"42036","2024","COM","2022","522","17","539","2024-12-30"
"42037","2024","COM","2022","668","27","695","2024-12-30"
"42038","2024","COM","2022","740","10","750","2024-12-30"
"42039","2024","COM","2022","448","5","453","2024-12-30"
"42040","2024","COM","2022","44","2","46","2024-12-30"
"42041","2024","COM","2022","653","12","665","2024-12-30"
"42042","2024","COM","2022","1071","20","1091","2024-12-30"
"42043","2024","COM","2022","1782","41","1823","2024-12-30"
"42044","2024","COM","2022","12307","79","12386","2024-12-30"
"42045","2024","COM","2022","39","1","40","2024-12-30"
"42046","2024","COM","2022","2035","44","2079","2024-12-30"
"42047","2024","COM","2022","315","11","326","2024-12-30"
"42048","2024","COM","2022","1440","26","1466","2024-12-30"
"42049","2024","COM","2022","680","20","700","2024-12-30"
"42050","2024","COM","2022","137","3","140","2024-12-30"
"42051","2024","COM","2022","533","14","547","2024-12-30"
"42052","2024","COM","2022","3703","96","3799","2024-12-30"
"42053","2024","COM","2022","1700","23","1723","2024-12-30"
"42054","2024","COM","2022","354","10","364","2024-12-30"
"42055","2024","COM","2022","135","8","143","2024-12-30"
"42056","2024","COM","2022","2886","52","2938","2024-12-30"
"42058","2024","COM","2022","255","9","264","2024-12-30"
"42059","2024","COM","2022","5507","99","5606","2024-12-30"
"42060","2024","COM","2022","536","10","546","2024-12-30"
"42061","2024","COM","2022","522","13","535","2024-12-30"
"42062","2024","COM","2022","1155","35","1190","2024-12-30"
"42063","2024","COM","2022","388","9","397","2024-12-30"
"42064","2024","COM","2022","751","30","781","2024-12-30"
"42065","2024","COM","2022","1450","44","1494","2024-12-30"
"42066","2024","COM","2022","555","12","567","2024-12-30"
"42067","2024","COM","2022","295","3","298","2024-12-30"
"42068","2024","COM","2022","413","11","424","2024-12-30"
"42069","2024","COM","2022","3041","87","3128","2024-12-30"
"42070","2024","COM","2022","944","24","968","2024-12-30"
"42071","2024","COM","2022","6893","121","7014","2024-12-30"
"42072","2024","COM","2022","62","1","63","2024-12-30"
"42073","2024","COM","2022","753","19","772","2024-12-30"
"42074","2024","COM","2022","1067","28","1095","2024-12-30"
"42075","2024","COM","2022","1337","14","1351","2024-12-30"
"42076","2024","COM","2022","913","22","935","2024-12-30"
"42077","2024","COM","2022","315","8","323","2024-12-30"
"42078","2024","COM","2022","240","12","252","2024-12-30"
"42079","2024","COM","2022","705","13","718","2024-12-30"
"42081","2024","COM","2022","1496","25","1521","2024-12-30"
"42083","2024","COM","2022","523","4","527","2024-12-30"
"42084","2024","COM","2022","159","4","163","2024-12-30"
"42085","2024","COM","2022","861","16","877","2024-12-30"
"42086","2024","COM","2022","515","12","527","2024-12-30"
"42087","2024","COM","2022","1299","31","1330","2024-12-30"
"42088","2024","COM","2022","745","23","768","2024-12-30"
"42089","2024","COM","2022","660","30","690","2024-12-30"
"42090","2024","COM","2022","479","8","487","2024-12-30"
"42091","2024","COM","2022","709","20","729","2024-12-30"
"42092","2024","COM","2022","2820","116","2936","2024-12-30"
"42093","2024","COM","2022","1358","20","1378","2024-12-30"
"42094","2024","COM","2022","8370","144","8514","2024-12-30"
"42095","2024","COM","2022","17128","175","17303","2024-12-30"
"42096","2024","COM","2022","686","11","697","2024-12-30"
"42097","2024","COM","2022","4643","72","4715","2024-12-30"
"42098","2024","COM","2022","567","14","581","2024-12-30"
"42099","2024","COM","2022","3825","46","3871","2024-12-30"
"42100","2024","COM","2022","278","10","288","2024-12-30"
"42101","2024","COM","2022","134","3","137","2024-12-30"
"42102","2024","COM","2022","885","24","909","2024-12-30"
"42103","2024","COM","2022","4951","42","4993","2024-12-30"
"42104","2024","COM","2022","849","19","868","2024-12-30"
"42105","2024","COM","2022","253","4","257","2024-12-30"
"42106","2024","COM","2022","236","7","243","2024-12-30"
"42107","2024","COM","2022","319","10","329","2024-12-30"
"42108","2024","COM","2022","1073","24","1097","2024-12-30"
"42109","2024","COM","2022","106","1","107","2024-12-30"
"42110","2024","COM","2022","4868","41","4909","2024-12-30"
"42112","2024","COM","2022","397","10","407","2024-12-30"
"42113","2024","COM","2022","240","6","246","2024-12-30"
"42115","2024","COM","2022","1229","15","1244","2024-12-30"
"42116","2024","COM","2022","245","9","254","2024-12-30"
"42117","2024","COM","2022","111","8","119","2024-12-30"
"42118","2024","COM","2022","764","15","779","2024-12-30"
"42119","2024","COM","2022","361","9","370","2024-12-30"
"42120","2024","COM","2022","1794","39","1833","2024-12-30"
"42121","2024","COM","2022","170","2","172","2024-12-30"
"42122","2024","COM","2022","1747","80","1827","2024-12-30"
"42123","2024","COM","2022","4896","42","4938","2024-12-30"
"42124","2024","COM","2022","307","6","313","2024-12-30"
"42125","2024","COM","2022","137","2","139","2024-12-30"
"42126","2024","COM","2022","1254","29","1283","2024-12-30"
"42127","2024","COM","2022","7246","130","7376","2024-12-30"
"42128","2024","COM","2022","401","7","408","2024-12-30"
"42129","2024","COM","2022","1867","68","1935","2024-12-30"
"42130","2024","COM","2022","560","10","570","2024-12-30"
"42131","2024","COM","2022","322","9","331","2024-12-30"
"42132","2024","COM","2022","619","12","631","2024-12-30"
"42133","2024","COM","2022","680","20","700","2024-12-30"
"42134","2024","COM","2022","1395","48","1443","2024-12-30"
"42135","2024","COM","2022","550","28","578","2024-12-30"
"42136","2024","COM","2022","783","31","814","2024-12-30"
"42137","2024","COM","2022","841","11","852","2024-12-30"
"42138","2024","COM","2022","679","22","701","2024-12-30"
"42139","2024","COM","2022","1338","71","1409","2024-12-30"
"42140","2024","COM","2022","460","8","468","2024-12-30"
"42141","2024","COM","2022","560","10","570","2024-12-30"
"42142","2024","COM","2022","326","5","331","2024-12-30"
"42143","2024","COM","2022","537","6","543","2024-12-30"
"42145","2024","COM","2022","1100","20","1120","2024-12-30"
"42146","2024","COM","2022","64","1","65","2024-12-30"
"42147","2024","COM","2022","16098","564","16662","2024-12-30"
"42148","2024","COM","2022","507","9","516","2024-12-30"
"42149","2024","COM","2022","5655","95","5750","2024-12-30"
"42150","2024","COM","2022","1287","35","1322","2024-12-30"
"42151","2024","COM","2022","426","82","508","2024-12-30"
"42152","2024","COM","2022","564","325","889","2024-12-30"
"42153","2024","COM","2022","479","8","487","2024-12-30"
"42154","2024","COM","2022","482","50","532","2024-12-30"
"42155","2024","COM","2022","1036","27","1063","2024-12-30"
"42156","2024","COM","2022","1356","30","1386","2024-12-30"
"42157","2024","COM","2022","814","20","834","2024-12-30"
"42158","2024","COM","2022","208","3","211","2024-12-30"
"42159","2024","COM","2022","1587","97","1684","2024-12-30"
"42160","2024","COM","2022","187","6","193","2024-12-30"
"42161","2024","COM","2022","573","17","590","2024-12-30"
"42162","2024","COM","2022","1150","19","1169","2024-12-30"
"42163","2024","COM","2022","1070","13","1083","2024-12-30"
"42164","2024","COM","2022","69","0","69","2024-12-30"
"42165","2024","COM","2022","2882","83","2965","2024-12-30"
"42166","2024","COM","2022","627","14","641","2024-12-30"
"42167","2024","COM","2022","399","10","409","2024-12-30"
"42168","2024","COM","2022","3665","102","3767","2024-12-30"
"42169","2024","COM","2022","1601","24","1625","2024-12-30"
"42170","2024","COM","2022","2105","160","2265","2024-12-30"
"42171","2024","COM","2022","285","2","287","2024-12-30"
"42172","2024","COM","2022","1072","25","1097","2024-12-30"
"42173","2024","COM","2022","371","8","379","2024-12-30"
"42174","2024","COM","2022","1268","20","1288","2024-12-30"
"42175","2024","COM","2022","1197","35","1232","2024-12-30"
"42176","2024","COM","2022","2165","53","2218","2024-12-30"
"42177","2024","COM","2022","2584","55","2639","2024-12-30"
"42178","2024","COM","2022","902","17","919","2024-12-30"
"42179","2024","COM","2022","851","30","881","2024-12-30"
"42180","2024","COM","2022","1040","99","1139","2024-12-30"
"42181","2024","COM","2022","1447","28","1475","2024-12-30"
"42182","2024","COM","2022","3220","108","3328","2024-12-30"
"42183","2024","COM","2022","8162","46","8208","2024-12-30"
"42184","2024","COM","2022","11034","206","11240","2024-12-30"
"42185","2024","COM","2022","737","20","757","2024-12-30"
"42186","2024","COM","2022","15457","141","15598","2024-12-30"
"42187","2024","COM","2022","35364","695","36059","2024-12-30"
"42188","2024","COM","2022","252","4","256","2024-12-30"
"42189","2024","COM","2022","9853","98","9951","2024-12-30"
"42191","2024","COM","2022","1006","22","1028","2024-12-30"
"42192","2024","COM","2022","422","4","426","2024-12-30"
"42193","2024","COM","2022","1421","38","1459","2024-12-30"
"42194","2024","COM","2022","208","2","210","2024-12-30"
"42195","2024","COM","2022","992","21","1013","2024-12-30"
"42196","2024","COM","2022","117","4","121","2024-12-30"
"42197","2024","COM","2022","1052","34","1086","2024-12-30"
"42198","2024","COM","2022","909","26","935","2024-12-30"
"42199","2024","COM","2022","1942","49","1991","2024-12-30"
"42200","2024","COM","2022","1534","26","1560","2024-12-30"
"42201","2024","COM","2022","705","29","734","2024-12-30"
"42202","2024","COM","2022","675","15","690","2024-12-30"
"42203","2024","COM","2022","338","1","339","2024-12-30"
"42204","2024","COM","2022","1457","23","1480","2024-12-30"
"42205","2024","COM","2022","683","16","699","2024-12-30"
"42206","2024","COM","2022","1817","37","1854","2024-12-30"
"42207","2024","COM","2022","35586","362","35948","2024-12-30"
"42208","2024","COM","2022","1888","46","1934","2024-12-30"
"42209","2024","COM","2022","386","16","402","2024-12-30"
"42210","2024","COM","2022","484","7","491","2024-12-30"
"42211","2024","COM","2022","2428","35","2463","2024-12-30"
"42212","2024","COM","2022","1028","17","1045","2024-12-30"
"42213","2024","COM","2022","311","12","323","2024-12-30"
"42214","2024","COM","2022","1077","34","1111","2024-12-30"
"42215","2024","COM","2022","1252","23","1275","2024-12-30"
"42216","2024","COM","2022","684","23","707","2024-12-30"
"42217","2024","COM","2022","457","3","460","2024-12-30"
"42218","2024","COM","2022","172569","1653","174222","2024-12-30"
"42219","2024","COM","2022","1032","24","1056","2024-12-30"
"42220","2024","COM","2022","594","20","614","2024-12-30"
"42221","2024","COM","2022","565","10","575","2024-12-30"
"42222","2024","COM","2022","5848","112","5960","2024-12-30"
"42223","2024","COM","2022","6182","65","6247","2024-12-30"
"42224","2024","COM","2022","2912","144","3056","2024-12-30"
"42225","2024","COM","2022","3821","95","3916","2024-12-30"
"42226","2024","COM","2022","452","6","458","2024-12-30"
"42227","2024","COM","2022","415","8","423","2024-12-30"
"42228","2024","COM","2022","1458","28","1486","2024-12-30"
"42229","2024","COM","2022","215","6","221","2024-12-30"
"42230","2024","COM","2022","1594","34","1628","2024-12-30"
"42231","2024","COM","2022","1222","72","1294","2024-12-30"
"42232","2024","COM","2022","630","11","641","2024-12-30"
"42233","2024","COM","2022","961","25","986","2024-12-30"
"42234","2024","COM","2022","3684","57","3741","2024-12-30"
"42235","2024","COM","2022","334","6","340","2024-12-30"
"42236","2024","COM","2022","540","10","550","2024-12-30"
"42237","2024","COM","2022","6594","66","6660","2024-12-30"
"42238","2024","COM","2022","310","6","316","2024-12-30"
"42239","2024","COM","2022","1155","25","1180","2024-12-30"
"42240","2024","COM","2022","844","20","864","2024-12-30"
"42241","2024","COM","2022","392","6","398","2024-12-30"
"42242","2024","COM","2022","1978","31","2009","2024-12-30"
"42243","2024","COM","2022","297","3","300","2024-12-30"
"42245","2024","COM","2022","565","16","581","2024-12-30"
"42246","2024","COM","2022","1143","17","1160","2024-12-30"
"42247","2024","COM","2022","282","9","291","2024-12-30"
"42248","2024","COM","2022","1145","33","1178","2024-12-30"
"42249","2024","COM","2022","1644","32","1676","2024-12-30"
"42251","2024","COM","2022","559","14","573","2024-12-30"
"42252","2024","COM","2022","247","7","254","2024-12-30"
"42253","2024","COM","2022","1159","38","1197","2024-12-30"
"42254","2024","COM","2022","807","18","825","2024-12-30"
"42255","2024","COM","2022","269","9","278","2024-12-30"
"42256","2024","COM","2022","5088","83","5171","2024-12-30"
"42257","2024","COM","2022","850","12","862","2024-12-30"
"42259","2024","COM","2022","3768","63","3831","2024-12-30"
"42260","2024","COM","2022","870","59","929","2024-12-30"
"42261","2024","COM","2022","926","20","946","2024-12-30"
"42262","2024","COM","2022","1824","39","1863","2024-12-30"
"42264","2024","COM","2022","945","25","970","2024-12-30"
"42265","2024","COM","2022","872","24","896","2024-12-30"
"42266","2024","COM","2022","653","14","667","2024-12-30"
"42267","2024","COM","2022","1689","45","1734","2024-12-30"
"42268","2024","COM","2022","816","17","833","2024-12-30"
"42269","2024","COM","2022","194","2","196","2024-12-30"
"42270","2024","COM","2022","1348","29","1377","2024-12-30"
"42271","2024","COM","2022","4758","53","4811","2024-12-30"
"42272","2024","COM","2022","1705","30","1735","2024-12-30"
"42273","2024","COM","2022","381","14","395","2024-12-30"
"42274","2024","COM","2022","275","5","280","2024-12-30"
"42275","2024","COM","2022","6318","104","6422","2024-12-30"
"42276","2024","COM","2022","412","15","427","2024-12-30"
"42277","2024","COM","2022","340","3","343","2024-12-30"
"42278","2024","COM","2022","141","4","145","2024-12-30"
"42279","2024","COM","2022","15579","256","15835","2024-12-30"
"42280","2024","COM","2022","416","11","427","2024-12-30"
"42281","2024","COM","2022","130","4","134","2024-12-30"
"42282","2024","COM","2022","235","5","240","2024-12-30"
"42283","2024","COM","2022","1209","28","1237","2024-12-30"
"42284","2024","COM","2022","1423","24","1447","2024-12-30"
"42285","2024","COM","2022","4121","78","4199","2024-12-30"
"42286","2024","COM","2022","949","10","959","2024-12-30"
"42287","2024","COM","2022","1083","23","1106","2024-12-30"
"42288","2024","COM","2022","683","15","698","2024-12-30"
"42289","2024","COM","2022","1976","63","2039","2024-12-30"
"42290","2024","COM","2022","596","18","614","2024-12-30"
"42293","2024","COM","2022","1164","19","1183","2024-12-30"
"42294","2024","COM","2022","972","32","1004","2024-12-30"
"42295","2024","COM","2022","562","8","570","2024-12-30"
"42296","2024","COM","2022","545","16","561","2024-12-30"
"42297","2024","COM","2022","625","32","657","2024-12-30"
"42298","2024","COM","2022","373","8","381","2024-12-30"
"42299","2024","COM","2022","3489","74","3563","2024-12-30"
"42300","2024","COM","2022","650","16","666","2024-12-30"
"42301","2024","COM","2022","716","9","725","2024-12-30"
"42302","2024","COM","2022","8071","153","8224","2024-12-30"
"42303","2024","COM","2022","275","8","283","2024-12-30"
"42304","2024","COM","2022","6651","264","6915","2024-12-30"
"42305","2024","COM","2022","7103","75","7178","2024-12-30"
"42306","2024","COM","2022","509","13","522","2024-12-30"
"42307","2024","COM","2022","957","18","975","2024-12-30"
"42308","2024","COM","2022","771","8","779","2024-12-30"
"42310","2024","COM","2022","143","3","146","2024-12-30"
"42311","2024","COM","2022","1484","25","1509","2024-12-30"
"42312","2024","COM","2022","630","19","649","2024-12-30"
"42313","2024","COM","2022","672","19","691","2024-12-30"
"42314","2024","COM","2022","273","7","280","2024-12-30"
"42315","2024","COM","2022","455","14","469","2024-12-30"
"42316","2024","COM","2022","8495","133","8628","2024-12-30"
"42317","2024","COM","2022","116","5","121","2024-12-30"
"42318","2024","COM","2022","1461","23","1484","2024-12-30"
"42319","2024","COM","2022","680","12","692","2024-12-30"
"42320","2024","COM","2022","710","7","717","2024-12-30"
"42321","2024","COM","2022","103","0","103","2024-12-30"
"42322","2024","COM","2022","1118","31","1149","2024-12-30"
"42323","2024","COM","2022","8984","122","9106","2024-12-30"
"42324","2024","COM","2022","1217","15","1232","2024-12-30"
"42325","2024","COM","2022","390","4","394","2024-12-30"
"42326","2024","COM","2022","917","31","948","2024-12-30"
"42327","2024","COM","2022","655","14","669","2024-12-30"
"42328","2024","COM","2022","727","80","807","2024-12-30"
"42329","2024","COM","2022","386","7","393","2024-12-30"
"42330","2024","COM","2022","7705","118","7823","2024-12-30"
"42331","2024","COM","2022","1045","33","1078","2024-12-30"
"42332","2024","COM","2022","5175","113","5288","2024-12-30"
"42333","2024","COM","2022","599","13","612","2024-12-30"
"42334","2024","COM","2022","1210","16","1226","2024-12-30"
"42335","2024","COM","2022","448","18","466","2024-12-30"
"42336","2024","COM","2022","621","18","639","2024-12-30"
"42337","2024","COM","2022","231","3","234","2024-12-30"
"42338","2024","COM","2022","1523","68","1591","2024-12-30"
"42339","2024","COM","2022","213","9","222","2024-12-30"
"43001","2024","COM","2022","171","4","175","2024-12-30"
"43002","2024","COM","2022","1483","49","1532","2024-12-30"
"43003","2024","COM","2022","892","15","907","2024-12-30"
"43004","2024","COM","2022","118","3","121","2024-12-30"
"43005","2024","COM","2022","153","2","155","2024-12-30"
"43006","2024","COM","2022","124","2","126","2024-12-30"
"43007","2024","COM","2022","615","11","626","2024-12-30"
"43008","2024","COM","2022","148","1","149","2024-12-30"
"43009","2024","COM","2022","24","0","24","2024-12-30"
"43010","2024","COM","2022","1216","34","1250","2024-12-30"
"43011","2024","COM","2022","177","4","181","2024-12-30"
"43012","2024","COM","2022","6133","83","6216","2024-12-30"
"43013","2024","COM","2022","300","10","310","2024-12-30"
"43014","2024","COM","2022","51","2","53","2024-12-30"
"43015","2024","COM","2022","48","0","48","2024-12-30"
"43016","2024","COM","2022","874","23","897","2024-12-30"
"43017","2024","COM","2022","294","7","301","2024-12-30"
"43018","2024","COM","2022","1387","129","1516","2024-12-30"
"43019","2024","COM","2022","106","2","108","2024-12-30"
"43020","2024","COM","2022","4631","69","4700","2024-12-30"
"43021","2024","COM","2022","1071","18","1089","2024-12-30"
"43022","2024","COM","2022","263","12","275","2024-12-30"
"43023","2024","COM","2022","217","5","222","2024-12-30"
"43024","2024","COM","2022","865","16","881","2024-12-30"
"43025","2024","COM","2022","2964","70","3034","2024-12-30"
"43026","2024","COM","2022","448","12","460","2024-12-30"
"43027","2024","COM","2022","44","0","44","2024-12-30"
"43028","2024","COM","2022","448","19","467","2024-12-30"
"43029","2024","COM","2022","102","5","107","2024-12-30"
"43030","2024","COM","2022","450","12","462","2024-12-30"
"43031","2024","COM","2022","129","5","134","2024-12-30"
"43032","2024","COM","2022","1722","54","1776","2024-12-30"
"43033","2024","COM","2022","618","13","631","2024-12-30"
"43034","2024","COM","2022","382","8","390","2024-12-30"
"43035","2024","COM","2022","91","1","92","2024-12-30"
"43036","2024","COM","2022","405","10","415","2024-12-30"
"43037","2024","COM","2022","271","6","277","2024-12-30"
"43038","2024","COM","2022","1051","32","1083","2024-12-30"
"43039","2024","COM","2022","615","20","635","2024-12-30"
"43040","2024","COM","2022","6523","314","6837","2024-12-30"
"43041","2024","COM","2022","4242","235","4477","2024-12-30"
"43042","2024","COM","2022","687","19","706","2024-12-30"
"43043","2024","COM","2022","484","8","492","2024-12-30"
"43044","2024","COM","2022","212","4","216","2024-12-30"
"43045","2024","COM","2022","439","17","456","2024-12-30"
"43046","2024","COM","2022","2502","73","2575","2024-12-30"
"43047","2024","COM","2022","348","5","353","2024-12-30"
"43048","2024","COM","2022","595","38","633","2024-12-30"
"43049","2024","COM","2022","517","7","524","2024-12-30"
"43050","2024","COM","2022","130","0","130","2024-12-30"
"43051","2024","COM","2022","2451","51","2502","2024-12-30"
"43052","2024","COM","2022","183","6","189","2024-12-30"
"43053","2024","COM","2022","203","4","207","2024-12-30"
"43054","2024","COM","2022","173","7","180","2024-12-30"
"43055","2024","COM","2022","164","4","168","2024-12-30"
"43056","2024","COM","2022","408","8","416","2024-12-30"
"43057","2024","COM","2022","50","2","52","2024-12-30"
"43058","2024","COM","2022","1111","30","1141","2024-12-30"
"43059","2024","COM","2022","111","2","113","2024-12-30"
"43060","2024","COM","2022","67","1","68","2024-12-30"
"43061","2024","COM","2022","881","27","908","2024-12-30"
"43062","2024","COM","2022","849","16","865","2024-12-30"
"43063","2024","COM","2022","158","5","163","2024-12-30"
"43064","2024","COM","2022","64","3","67","2024-12-30"
"43065","2024","COM","2022","116","4","120","2024-12-30"
"43066","2024","COM","2022","128","5","133","2024-12-30"
"43067","2024","COM","2022","270","8","278","2024-12-30"
"43068","2024","COM","2022","32","0","32","2024-12-30"
"43069","2024","COM","2022","291","10","301","2024-12-30"
"43070","2024","COM","2022","173","1","174","2024-12-30"
"43071","2024","COM","2022","449","4","453","2024-12-30"
"43072","2024","COM","2022","147","4","151","2024-12-30"
"43073","2024","COM","2022","128","3","131","2024-12-30"
"43074","2024","COM","2022","868","23","891","2024-12-30"
"43075","2024","COM","2022","74","4","78","2024-12-30"
"43076","2024","COM","2022","132","2","134","2024-12-30"
"43077","2024","COM","2022","552","13","565","2024-12-30"
"43078","2024","COM","2022","3137","77","3214","2024-12-30"
"43079","2024","COM","2022","286","5","291","2024-12-30"
"43080","2024","COM","2022","2004","18","2022","2024-12-30"
"43082","2024","COM","2022","70","2","72","2024-12-30"
"43083","2024","COM","2022","153","4","157","2024-12-30"
"43084","2024","COM","2022","1658","46","1704","2024-12-30"
"43085","2024","COM","2022","56","6","62","2024-12-30"
"43086","2024","COM","2022","173","8","181","2024-12-30"
"43087","2024","COM","2022","2623","61","2684","2024-12-30"
"43088","2024","COM","2022","326","9","335","2024-12-30"
"43089","2024","COM","2022","3574","92","3666","2024-12-30"
"43090","2024","COM","2022","127","6","133","2024-12-30"
"43091","2024","COM","2022","318","15","333","2024-12-30"
"43092","2024","COM","2022","344","5","349","2024-12-30"
"43093","2024","COM","2022","302","7","309","2024-12-30"
"43094","2024","COM","2022","76","2","78","2024-12-30"
"43095","2024","COM","2022","141","3","144","2024-12-30"
"43096","2024","COM","2022","878","223","1101","2024-12-30"
"43097","2024","COM","2022","105","4","109","2024-12-30"
"43098","2024","COM","2022","114","5","119","2024-12-30"
"43099","2024","COM","2022","551","6","557","2024-12-30"
"43100","2024","COM","2022","182","2","184","2024-12-30"
"43101","2024","COM","2022","75","1","76","2024-12-30"
"43102","2024","COM","2022","1126","15","1141","2024-12-30"
"43103","2024","COM","2022","111","1","112","2024-12-30"
"43104","2024","COM","2022","184","12","196","2024-12-30"
"43105","2024","COM","2022","177","5","182","2024-12-30"
"43106","2024","COM","2022","143","2","145","2024-12-30"
"43107","2024","COM","2022","82","1","83","2024-12-30"
"43108","2024","COM","2022","434","8","442","2024-12-30"
"43109","2024","COM","2022","82","0","82","2024-12-30"
"43110","2024","COM","2022","828","14","842","2024-12-30"
"43111","2024","COM","2022","869","19","888","2024-12-30"
"43112","2024","COM","2022","3433","78","3511","2024-12-30"
"43113","2024","COM","2022","1929","54","1983","2024-12-30"
"43114","2024","COM","2022","1774","34","1808","2024-12-30"
"43115","2024","COM","2022","1019","18","1037","2024-12-30"
"43116","2024","COM","2022","61","2","63","2024-12-30"
"43117","2024","COM","2022","245","6","251","2024-12-30"
"43118","2024","COM","2022","255","7","262","2024-12-30"
"43119","2024","COM","2022","813","16","829","2024-12-30"
"43120","2024","COM","2022","1305","26","1331","2024-12-30"
"43121","2024","COM","2022","214","5","219","2024-12-30"
"43122","2024","COM","2022","293","8","301","2024-12-30"
"43123","2024","COM","2022","423","16","439","2024-12-30"
"43124","2024","COM","2022","947","21","968","2024-12-30"
"43125","2024","COM","2022","102","2","104","2024-12-30"
"43126","2024","COM","2022","756","18","774","2024-12-30"
"43127","2024","COM","2022","882","19","901","2024-12-30"
"43128","2024","COM","2022","142","4","146","2024-12-30"
"43129","2024","COM","2022","157","4","161","2024-12-30"
"43130","2024","COM","2022","1111","28","1139","2024-12-30"
"43131","2024","COM","2022","190","1","191","2024-12-30"
"43132","2024","COM","2022","1426","43","1469","2024-12-30"
"43133","2024","COM","2022","148","3","151","2024-12-30"
"43134","2024","COM","2022","167","2","169","2024-12-30"
"43135","2024","COM","2022","1773","34","1807","2024-12-30"
"43136","2024","COM","2022","219","5","224","2024-12-30"
"43137","2024","COM","2022","8874","411","9285","2024-12-30"
"43138","2024","COM","2022","406","6","412","2024-12-30"
"43139","2024","COM","2022","53","0","53","2024-12-30"
"43140","2024","COM","2022","677","18","695","2024-12-30"
"43141","2024","COM","2022","1136","19","1155","2024-12-30"
"43142","2024","COM","2022","613","17","630","2024-12-30"
"43143","2024","COM","2022","123","0","123","2024-12-30"
"43144","2024","COM","2022","108","3","111","2024-12-30"
"43145","2024","COM","2022","52","2","54","2024-12-30"
"43147","2024","COM","2022","607","14","621","2024-12-30"
"43148","2024","COM","2022","855","15","870","2024-12-30"
"43149","2024","COM","2022","115","4","119","2024-12-30"
"43150","2024","COM","2022","542","12","554","2024-12-30"
"43151","2024","COM","2022","183","5","188","2024-12-30"
"43152","2024","COM","2022","2827","90","2917","2024-12-30"
"43153","2024","COM","2022","1861","33","1894","2024-12-30"
"43154","2024","COM","2022","535","14","549","2024-12-30"
"43155","2024","COM","2022","72","1","73","2024-12-30"
"43156","2024","COM","2022","110","5","115","2024-12-30"
"43157","2024","COM","2022","18989","820","19809","2024-12-30"
"43158","2024","COM","2022","357","10","367","2024-12-30"
"43159","2024","COM","2022","947","25","972","2024-12-30"
"43160","2024","COM","2022","200","2","202","2024-12-30"
"43162","2024","COM","2022","2971","59","3030","2024-12-30"
"43163","2024","COM","2022","1185","17","1202","2024-12-30"
"43164","2024","COM","2022","477","8","485","2024-12-30"
"43165","2024","COM","2022","1536","23","1559","2024-12-30"
"43166","2024","COM","2022","381","16","397","2024-12-30"
"43167","2024","COM","2022","191","7","198","2024-12-30"
"43168","2024","COM","2022","116","2","118","2024-12-30"
"43169","2024","COM","2022","52","0","52","2024-12-30"
"43170","2024","COM","2022","453","10","463","2024-12-30"
"43171","2024","COM","2022","90","2","92","2024-12-30"
"43172","2024","COM","2022","224","4","228","2024-12-30"
"43173","2024","COM","2022","86","2","88","2024-12-30"
"43174","2024","COM","2022","937","20","957","2024-12-30"
"43175","2024","COM","2022","164","4","168","2024-12-30"
"43177","2024","COM","2022","3502","57","3559","2024-12-30"
"43178","2024","COM","2022","196","9","205","2024-12-30"
"43180","2024","COM","2022","90","6","96","2024-12-30"
"43181","2024","COM","2022","750","17","767","2024-12-30"
"43182","2024","COM","2022","54","2","56","2024-12-30"
"43183","2024","COM","2022","107","1","108","2024-12-30"
"43184","2024","COM","2022","2457","38","2495","2024-12-30"
"43185","2024","COM","2022","3257","105","3362","2024-12-30"
"43186","2024","COM","2022","413","5","418","2024-12-30"
"43187","2024","COM","2022","319","1","320","2024-12-30"
"43188","2024","COM","2022","473","8","481","2024-12-30"
"43189","2024","COM","2022","523","15","538","2024-12-30"
"43190","2024","COM","2022","3459","102","3561","2024-12-30"
"43191","2024","COM","2022","244","5","249","2024-12-30"
"43192","2024","COM","2022","277","6","283","2024-12-30"
"43193","2024","COM","2022","158","1","159","2024-12-30"
"43194","2024","COM","2022","694","18","712","2024-12-30"
"43195","2024","COM","2022","193","4","197","2024-12-30"
"43196","2024","COM","2022","183","2","185","2024-12-30"
"43197","2024","COM","2022","338","10","348","2024-12-30"
"43198","2024","COM","2022","303","6","309","2024-12-30"
"43199","2024","COM","2022","993","20","1013","2024-12-30"
"43200","2024","COM","2022","2021","46","2067","2024-12-30"
"43201","2024","COM","2022","248","6","254","2024-12-30"
"43202","2024","COM","2022","54","2","56","2024-12-30"
"43203","2024","COM","2022","487","13","500","2024-12-30"
"43204","2024","COM","2022","165","2","167","2024-12-30"
"43205","2024","COM","2022","4220","62","4282","2024-12-30"
"43206","2024","COM","2022","397","16","413","2024-12-30"
"43207","2024","COM","2022","253","10","263","2024-12-30"
"43208","2024","COM","2022","37","2","39","2024-12-30"
"43210","2024","COM","2022","228","6","234","2024-12-30"
"43211","2024","COM","2022","2666","60","2726","2024-12-30"
"43212","2024","COM","2022","1019","16","1035","2024-12-30"
"43213","2024","COM","2022","2324","56","2380","2024-12-30"
"43214","2024","COM","2022","109","4","113","2024-12-30"
"43215","2024","COM","2022","193","4","197","2024-12-30"
"43216","2024","COM","2022","2419","63","2482","2024-12-30"
"43217","2024","COM","2022","555","10","565","2024-12-30"
"43218","2024","COM","2022","1250","36","1286","2024-12-30"
"43219","2024","COM","2022","110","4","114","2024-12-30"
"43220","2024","COM","2022","167","3","170","2024-12-30"
"43221","2024","COM","2022","397","7","404","2024-12-30"
"43222","2024","COM","2022","166","3","169","2024-12-30"
"43223","2024","COM","2022","1132","19","1151","2024-12-30"
"43224","2024","COM","2022","6060","111","6171","2024-12-30"
"43225","2024","COM","2022","60","0","60","2024-12-30"
"43226","2024","COM","2022","108","4","112","2024-12-30"
"43227","2024","COM","2022","804","21","825","2024-12-30"
"43228","2024","COM","2022","91","2","93","2024-12-30"
"43229","2024","COM","2022","609","13","622","2024-12-30"
"43230","2024","COM","2022","1070","18","1088","2024-12-30"
"43231","2024","COM","2022","154","6","160","2024-12-30"
"43232","2024","COM","2022","333","12","345","2024-12-30"
"43233","2024","COM","2022","1078","32","1110","2024-12-30"
"43234","2024","COM","2022","1664","102","1766","2024-12-30"
"43236","2024","COM","2022","1471","24","1495","2024-12-30"
"43237","2024","COM","2022","240","6","246","2024-12-30"
"43238","2024","COM","2022","301","8","309","2024-12-30"
"43239","2024","COM","2022","827","15","842","2024-12-30"
"43240","2024","COM","2022","261","5","266","2024-12-30"
"43241","2024","COM","2022","1286","18","1304","2024-12-30"
"43242","2024","COM","2022","63","2","65","2024-12-30"
"43244","2024","COM","2022","3148","78","3226","2024-12-30"
"43245","2024","COM","2022","235","5","240","2024-12-30"
"43246","2024","COM","2022","455","14","469","2024-12-30"
"43247","2024","COM","2022","65","3","68","2024-12-30"
"43249","2024","COM","2022","540","9","549","2024-12-30"
"43250","2024","COM","2022","39","4","43","2024-12-30"
"43251","2024","COM","2022","3392","134","3526","2024-12-30"
"43252","2024","COM","2022","26","1","27","2024-12-30"
"43253","2024","COM","2022","191","10","201","2024-12-30"
"43254","2024","COM","2022","265","3","268","2024-12-30"
"43256","2024","COM","2022","341","6","347","2024-12-30"
"43257","2024","COM","2022","470","9","479","2024-12-30"
"43258","2024","COM","2022","1793","52","1845","2024-12-30"
"43259","2024","COM","2022","363","12","375","2024-12-30"
"43260","2024","COM","2022","22","0","22","2024-12-30"
"43261","2024","COM","2022","631","11","642","2024-12-30"
"43262","2024","COM","2022","1245","31","1276","2024-12-30"
"43263","2024","COM","2022","67","0","67","2024-12-30"
"43264","2024","COM","2022","281","15","296","2024-12-30"
"43265","2024","COM","2022","1455","48","1503","2024-12-30"
"43267","2024","COM","2022","1466","17","1483","2024-12-30"
"43268","2024","COM","2022","7380","438","7818","2024-12-30"
"44001","2024","COM","2022","2052","40","2092","2024-12-30"
"44002","2024","COM","2022","4121","142","4263","2024-12-30"
"44003","2024","COM","2022","11346","423","11769","2024-12-30"
"44005","2024","COM","2022","7288","112","7400","2024-12-30"
"44006","2024","COM","2022","1881","47","1928","2024-12-30"
"44007","2024","COM","2022","2451","64","2515","2024-12-30"
"44009","2024","COM","2022","9617","215","9832","2024-12-30"
"44010","2024","COM","2022","2799","95","2894","2024-12-30"
"44012","2024","COM","2022","3523","45","3568","2024-12-30"
"44013","2024","COM","2022","3317","42","3359","2024-12-30"
"44014","2024","COM","2022","3967","71","4038","2024-12-30"
"44015","2024","COM","2022","10352","175","10527","2024-12-30"
"44016","2024","COM","2022","1114","17","1131","2024-12-30"
"44018","2024","COM","2022","8281","138","8419","2024-12-30"
"44019","2024","COM","2022","1100","12","1112","2024-12-30"
"44020","2024","COM","2022","20590","303","20893","2024-12-30"
"44021","2024","COM","2022","5004","85","5089","2024-12-30"
"44022","2024","COM","2022","2814","51","2865","2024-12-30"
"44023","2024","COM","2022","3067","45","3112","2024-12-30"
"44024","2024","COM","2022","2760","55","2815","2024-12-30"
"44025","2024","COM","2022","4031","67","4098","2024-12-30"
"44026","2024","COM","2022","20535","589","21124","2024-12-30"
"44027","2024","COM","2022","2600","44","2644","2024-12-30"
"44028","2024","COM","2022","4011","105","4116","2024-12-30"
"44029","2024","COM","2022","7158","117","7275","2024-12-30"
"44030","2024","COM","2022","4424","95","4519","2024-12-30"
"44031","2024","COM","2022","811","15","826","2024-12-30"
"44032","2024","COM","2022","3443","72","3515","2024-12-30"
"44033","2024","COM","2022","3246","66","3312","2024-12-30"
"44035","2024","COM","2022","20483","573","21056","2024-12-30"
"44036","2024","COM","2022","12231","431","12662","2024-12-30"
"44037","2024","COM","2022","3138","212","3350","2024-12-30"
"44038","2024","COM","2022","3035","39","3074","2024-12-30"
"44039","2024","COM","2022","1172","16","1188","2024-12-30"
"44041","2024","COM","2022","6342","107","6449","2024-12-30"
"44043","2024","COM","2022","7459","278","7737","2024-12-30"
"44044","2024","COM","2022","1072","25","1097","2024-12-30"
"44045","2024","COM","2022","3954","49","4003","2024-12-30"
"44046","2024","COM","2022","2615","59","2674","2024-12-30"
"44047","2024","COM","2022","23541","267","23808","2024-12-30"
"44048","2024","COM","2022","2534","44","2578","2024-12-30"
"44049","2024","COM","2022","4081","57","4138","2024-12-30"
"44050","2024","COM","2022","2985","62","3047","2024-12-30"
"44051","2024","COM","2022","3578","337","3915","2024-12-30"
"44052","2024","COM","2022","8117","84","8201","2024-12-30"
"44053","2024","COM","2022","2288","39","2327","2024-12-30"
"44054","2024","COM","2022","3062","60","3122","2024-12-30"
"44055","2024","COM","2022","16613","551","17164","2024-12-30"
"44056","2024","COM","2022","3852","63","3915","2024-12-30"
"44057","2024","COM","2022","2257","56","2313","2024-12-30"
"44058","2024","COM","2022","502","9","511","2024-12-30"
"44061","2024","COM","2022","3289","56","3345","2024-12-30"
"44062","2024","COM","2022","1880","31","1911","2024-12-30"
"44063","2024","COM","2022","3794","86","3880","2024-12-30"
"44064","2024","COM","2022","5090","357","5447","2024-12-30"
"44065","2024","COM","2022","770","20","790","2024-12-30"
"44066","2024","COM","2022","6910","113","7023","2024-12-30"
"44067","2024","COM","2022","5242","105","5347","2024-12-30"
"44068","2024","COM","2022","3577","63","3640","2024-12-30"
"44069","2024","COM","2022","16684","575","17259","2024-12-30"
"44070","2024","COM","2022","4734","116","4850","2024-12-30"
"44071","2024","COM","2022","5992","156","6148","2024-12-30"
"44072","2024","COM","2022","7178","124","7302","2024-12-30"
"44073","2024","COM","2022","6528","119","6647","2024-12-30"
"44074","2024","COM","2022","4172","49","4221","2024-12-30"
"44075","2024","COM","2022","1825","38","1863","2024-12-30"
"44076","2024","COM","2022","1381","21","1402","2024-12-30"
"44077","2024","COM","2022","2753","33","2786","2024-12-30"
"44078","2024","COM","2022","327","4","331","2024-12-30"
"44079","2024","COM","2022","3214","366","3580","2024-12-30"
"44080","2024","COM","2022","769","17","786","2024-12-30"
"44081","2024","COM","2022","4769","117","4886","2024-12-30"
"44082","2024","COM","2022","5593","108","5701","2024-12-30"
"44083","2024","COM","2022","2468","54","2522","2024-12-30"
"44084","2024","COM","2022","8595","152","8747","2024-12-30"
"44085","2024","COM","2022","949","32","981","2024-12-30"
"44086","2024","COM","2022","1064","23","1087","2024-12-30"
"44087","2024","COM","2022","7665","231","7896","2024-12-30"
"44088","2024","COM","2022","3071","53","3124","2024-12-30"
"44089","2024","COM","2022","3689","54","3743","2024-12-30"
"44090","2024","COM","2022","1578","23","1601","2024-12-30"
"44091","2024","COM","2022","1529","34","1563","2024-12-30"
"44092","2024","COM","2022","670","8","678","2024-12-30"
"44094","2024","COM","2022","3393","68","3461","2024-12-30"
"44095","2024","COM","2022","1587","27","1614","2024-12-30"
"44096","2024","COM","2022","4681","94","4775","2024-12-30"
"44097","2024","COM","2022","2156","50","2206","2024-12-30"
"44098","2024","COM","2022","5619","98","5717","2024-12-30"
"44099","2024","COM","2022","1964","60","2024","2024-12-30"
"44100","2024","COM","2022","2341","58","2399","2024-12-30"
"44101","2024","COM","2022","6523","134","6657","2024-12-30"
"44102","2024","COM","2022","3346","72","3418","2024-12-30"
"44103","2024","COM","2022","7289","96","7385","2024-12-30"
"44104","2024","COM","2022","843","7","850","2024-12-30"
"44105","2024","COM","2022","356","7","363","2024-12-30"
"44106","2024","COM","2022","1846","20","1866","2024-12-30"
"44107","2024","COM","2022","2004","32","2036","2024-12-30"
"44108","2024","COM","2022","2903","50","2953","2024-12-30"
"44109","2024","COM","2022","325070","4739","329809","2024-12-30"
"44110","2024","COM","2022","9448","191","9639","2024-12-30"
"44111","2024","COM","2022","2335","39","2374","2024-12-30"
"44112","2024","COM","2022","579","11","590","2024-12-30"
"44113","2024","COM","2022","4280","89","4369","2024-12-30"
"44114","2024","COM","2022","28341","608","28949","2024-12-30"
"44115","2024","COM","2022","3915","80","3995","2024-12-30"
"44116","2024","COM","2022","3030","99","3129","2024-12-30"
"44117","2024","COM","2022","3374","57","3431","2024-12-30"
"44118","2024","COM","2022","1454","27","1481","2024-12-30"
"44119","2024","COM","2022","2042","29","2071","2024-12-30"
"44120","2024","COM","2022","5335","220","5555","2024-12-30"
"44121","2024","COM","2022","437","4","441","2024-12-30"
"44122","2024","COM","2022","3865","71","3936","2024-12-30"
"44123","2024","COM","2022","1011","15","1026","2024-12-30"
"44124","2024","COM","2022","829","12","841","2024-12-30"
"44125","2024","COM","2022","2663","62","2725","2024-12-30"
"44126","2024","COM","2022","4617","75","4692","2024-12-30"
"44127","2024","COM","2022","2802","42","2844","2024-12-30"
"44128","2024","COM","2022","5281","104","5385","2024-12-30"
"44129","2024","COM","2022","11249","308","11557","2024-12-30"
"44130","2024","COM","2022","6942","85","7027","2024-12-30"
"44131","2024","COM","2022","18382","486","18868","2024-12-30"
"44132","2024","COM","2022","12530","307","12837","2024-12-30"
"44133","2024","COM","2022","3046","53","3099","2024-12-30"
"44134","2024","COM","2022","1050","21","1071","2024-12-30"
"44135","2024","COM","2022","4007","107","4114","2024-12-30"
"44136","2024","COM","2022","1246","29","1275","2024-12-30"
"44137","2024","COM","2022","3557","66","3623","2024-12-30"
"44138","2024","COM","2022","1124","17","1141","2024-12-30"
"44139","2024","COM","2022","1541","22","1563","2024-12-30"
"44140","2024","COM","2022","1559","26","1585","2024-12-30"
"44141","2024","COM","2022","1288","13","1301","2024-12-30"
"44142","2024","COM","2022","1932","38","1970","2024-12-30"
"44143","2024","COM","2022","43349","706","44055","2024-12-30"
"44144","2024","COM","2022","2358","51","2409","2024-12-30"
"44145","2024","COM","2022","3272","52","3324","2024-12-30"
"44146","2024","COM","2022","2152","39","2191","2024-12-30"
"44148","2024","COM","2022","705","12","717","2024-12-30"
"44149","2024","COM","2022","4075","58","4133","2024-12-30"
"44150","2024","COM","2022","3991","52","4043","2024-12-30"
"44151","2024","COM","2022","6949","181","7130","2024-12-30"
"44152","2024","COM","2022","3014","53","3067","2024-12-30"
"44153","2024","COM","2022","1749","49","1798","2024-12-30"
"44154","2024","COM","2022","14645","363","15008","2024-12-30"
"44155","2024","COM","2022","3499","72","3571","2024-12-30"
"44156","2024","COM","2022","3209","44","3253","2024-12-30"
"44157","2024","COM","2022","1764","21","1785","2024-12-30"
"44158","2024","COM","2022","7739","195","7934","2024-12-30"
"44159","2024","COM","2022","1246","26","1272","2024-12-30"
"44161","2024","COM","2022","3790","70","3860","2024-12-30"
"44162","2024","COM","2022","50561","721","51282","2024-12-30"
"44163","2024","COM","2022","4890","109","4999","2024-12-30"
"44164","2024","COM","2022","2376","47","2423","2024-12-30"
"44165","2024","COM","2022","2405","47","2452","2024-12-30"
"44166","2024","COM","2022","6024","98","6122","2024-12-30"
"44168","2024","COM","2022","4125","57","4182","2024-12-30"
"44169","2024","COM","2022","7768","124","7892","2024-12-30"
"44170","2024","COM","2022","963","20","983","2024-12-30"
"44171","2024","COM","2022","2114","28","2142","2024-12-30"
"44172","2024","COM","2022","16227","285","16512","2024-12-30"
"44173","2024","COM","2022","2118","45","2163","2024-12-30"
"44174","2024","COM","2022","2390","41","2431","2024-12-30"
"44175","2024","COM","2022","5246","106","5352","2024-12-30"
"44176","2024","COM","2022","3221","52","3273","2024-12-30"
"44178","2024","COM","2022","2644","46","2690","2024-12-30"
"44179","2024","COM","2022","5435","85","5520","2024-12-30"
"44180","2024","COM","2022","6625","109","6734","2024-12-30"
"44182","2024","COM","2022","5520","103","5623","2024-12-30"
"44183","2024","COM","2022","2859","60","2919","2024-12-30"
"44184","2024","COM","2022","73111","1667","74778","2024-12-30"
"44185","2024","COM","2022","3304","63","3367","2024-12-30"
"44186","2024","COM","2022","7209","145","7354","2024-12-30"
"44187","2024","COM","2022","4701","146","4847","2024-12-30"
"44188","2024","COM","2022","9392","205","9597","2024-12-30"
"44189","2024","COM","2022","2447","34","2481","2024-12-30"
"44190","2024","COM","2022","28373","623","28996","2024-12-30"
"44192","2024","COM","2022","2846","56","2902","2024-12-30"
"44193","2024","COM","2022","1527","21","1548","2024-12-30"
"44194","2024","COM","2022","8534","128","8662","2024-12-30"
"44195","2024","COM","2022","9465","193","9658","2024-12-30"
"44196","2024","COM","2022","1693","26","1719","2024-12-30"
"44197","2024","COM","2022","1658","34","1692","2024-12-30"
"44198","2024","COM","2022","9163","117","9280","2024-12-30"
"44199","2024","COM","2022","1965","49","2014","2024-12-30"
"44200","2024","COM","2022","339","8","347","2024-12-30"
"44201","2024","COM","2022","7457","172","7629","2024-12-30"
"44202","2024","COM","2022","1820","25","1845","2024-12-30"
"44203","2024","COM","2022","2005","36","2041","2024-12-30"
"44204","2024","COM","2022","10956","167","11123","2024-12-30"
"44205","2024","COM","2022","2619","35","2654","2024-12-30"
"44206","2024","COM","2022","1936","27","1963","2024-12-30"
"44207","2024","COM","2022","1124","10","1134","2024-12-30"
"44208","2024","COM","2022","976","8","984","2024-12-30"
"44209","2024","COM","2022","10414","207","10621","2024-12-30"
"44210","2024","COM","2022","8234","82","8316","2024-12-30"
"44211","2024","COM","2022","4862","109","4971","2024-12-30"
"44212","2024","COM","2022","9524","214","9738","2024-12-30"
"44213","2024","COM","2022","7509","127","7636","2024-12-30"
"44214","2024","COM","2022","2084","41","2125","2024-12-30"
"44215","2024","COM","2022","26048","439","26487","2024-12-30"
"44216","2024","COM","2022","4110","59","4169","2024-12-30"
"44217","2024","COM","2022","6633","97","6730","2024-12-30"
"44218","2024","COM","2022","687","15","702","2024-12-30"
"44220","2024","COM","2022","1716","23","1739","2024-12-30"
"44221","2024","COM","2022","1559","24","1583","2024-12-30"
"44222","2024","COM","2022","1258","19","1277","2024-12-30"
"44223","2024","COM","2022","3691","66","3757","2024-12-30"
"44224","2024","COM","2022","1815","22","1837","2024-12-30"
"45001","2024","COM","2022","192","5","197","2024-12-30"
"45002","2024","COM","2022","374","5","379","2024-12-30"
"45004","2024","COM","2022","13432","576","14008","2024-12-30"
"45005","2024","COM","2022","252","3","255","2024-12-30"
"45006","2024","COM","2022","1201","35","1236","2024-12-30"
"45008","2024","COM","2022","2009","27","2036","2024-12-30"
"45009","2024","COM","2022","1140","28","1168","2024-12-30"
"45010","2024","COM","2022","1070","36","1106","2024-12-30"
"45011","2024","COM","2022","209","3","212","2024-12-30"
"45012","2024","COM","2022","180","2","182","2024-12-30"
"45013","2024","COM","2022","216","8","224","2024-12-30"
"45014","2024","COM","2022","505","8","513","2024-12-30"
"45015","2024","COM","2022","729","11","740","2024-12-30"
"45016","2024","COM","2022","858","21","879","2024-12-30"
"45017","2024","COM","2022","335","3","338","2024-12-30"
"45018","2024","COM","2022","954","13","967","2024-12-30"
"45019","2024","COM","2022","643","31","674","2024-12-30"
"45020","2024","COM","2022","970","21","991","2024-12-30"
"45021","2024","COM","2022","299","6","305","2024-12-30"
"45022","2024","COM","2022","447","6","453","2024-12-30"
"45023","2024","COM","2022","106","2","108","2024-12-30"
"45024","2024","COM","2022","2005","49","2054","2024-12-30"
"45025","2024","COM","2022","1482","21","1503","2024-12-30"
"45026","2024","COM","2022","968","14","982","2024-12-30"
"45027","2024","COM","2022","402","5","407","2024-12-30"
"45028","2024","COM","2022","7811","183","7994","2024-12-30"
"45029","2024","COM","2022","1750","23","1773","2024-12-30"
"45030","2024","COM","2022","1991","116","2107","2024-12-30"
"45031","2024","COM","2022","1416","88","1504","2024-12-30"
"45032","2024","COM","2022","307","1","308","2024-12-30"
"45033","2024","COM","2022","379","3","382","2024-12-30"
"45034","2024","COM","2022","2106","54","2160","2024-12-30"
"45035","2024","COM","2022","1142","22","1164","2024-12-30"
"45036","2024","COM","2022","863","31","894","2024-12-30"
"45037","2024","COM","2022","502","7","509","2024-12-30"
"45038","2024","COM","2022","414","16","430","2024-12-30"
"45039","2024","COM","2022","698","20","718","2024-12-30"
"45040","2024","COM","2022","1851","25","1876","2024-12-30"
"45041","2024","COM","2022","107","0","107","2024-12-30"
"45042","2024","COM","2022","1846","37","1883","2024-12-30"
"45043","2024","COM","2022","1019","22","1041","2024-12-30"
"45044","2024","COM","2022","156","7","163","2024-12-30"
"45045","2024","COM","2022","307","13","320","2024-12-30"
"45046","2024","COM","2022","1061","17","1078","2024-12-30"
"45047","2024","COM","2022","419","10","429","2024-12-30"
"45049","2024","COM","2022","1231","31","1262","2024-12-30"
"45050","2024","COM","2022","1323","39","1362","2024-12-30"
"45051","2024","COM","2022","1774","34","1808","2024-12-30"
"45052","2024","COM","2022","95","2","97","2024-12-30"
"45053","2024","COM","2022","5012","70","5082","2024-12-30"
"45054","2024","COM","2022","526","9","535","2024-12-30"
"45055","2024","COM","2022","542","5","547","2024-12-30"
"45056","2024","COM","2022","321","5","326","2024-12-30"
"45058","2024","COM","2022","177","7","184","2024-12-30"
"45059","2024","COM","2022","208","2","210","2024-12-30"
"45060","2024","COM","2022","761","17","778","2024-12-30"
"45061","2024","COM","2022","2346","57","2403","2024-12-30"
"45062","2024","COM","2022","1477","21","1498","2024-12-30"
"45063","2024","COM","2022","895","11","906","2024-12-30"
"45064","2024","COM","2022","427","5","432","2024-12-30"
"45065","2024","COM","2022","222","3","225","2024-12-30"
"45066","2024","COM","2022","688","10","698","2024-12-30"
"45067","2024","COM","2022","4081","115","4196","2024-12-30"
"45068","2024","COM","2022","12958","219","13177","2024-12-30"
"45069","2024","COM","2022","961","23","984","2024-12-30"
"45070","2024","COM","2022","52","0","52","2024-12-30"
"45072","2024","COM","2022","1611","26","1637","2024-12-30"
"45073","2024","COM","2022","516","5","521","2024-12-30"
"45074","2024","COM","2022","110","3","113","2024-12-30"
"45075","2024","COM","2022","10492","205","10697","2024-12-30"
"45076","2024","COM","2022","223","7","230","2024-12-30"
"45077","2024","COM","2022","623","7","630","2024-12-30"
"45078","2024","COM","2022","250","10","260","2024-12-30"
"45079","2024","COM","2022","149","0","149","2024-12-30"
"45080","2024","COM","2022","340","13","353","2024-12-30"
"45081","2024","COM","2022","611","15","626","2024-12-30"
"45082","2024","COM","2022","8470","140","8610","2024-12-30"
"45083","2024","COM","2022","2108","31","2139","2024-12-30"
"45084","2024","COM","2022","424","9","433","2024-12-30"
"45085","2024","COM","2022","1858","24","1882","2024-12-30"
"45086","2024","COM","2022","275","3","278","2024-12-30"
"45087","2024","COM","2022","3152","54","3206","2024-12-30"
"45088","2024","COM","2022","274","10","284","2024-12-30"
"45089","2024","COM","2022","8948","202","9150","2024-12-30"
"45091","2024","COM","2022","319","13","332","2024-12-30"
"45092","2024","COM","2022","1504","34","1538","2024-12-30"
"45093","2024","COM","2022","2653","37","2690","2024-12-30"
"45094","2024","COM","2022","228","2","230","2024-12-30"
"45095","2024","COM","2022","2103","40","2143","2024-12-30"
"45096","2024","COM","2022","530","6","536","2024-12-30"
"45097","2024","COM","2022","1230","20","1250","2024-12-30"
"45098","2024","COM","2022","3540","71","3611","2024-12-30"
"45099","2024","COM","2022","498","9","507","2024-12-30"
"45100","2024","COM","2022","524","14","538","2024-12-30"
"45101","2024","COM","2022","270","10","280","2024-12-30"
"45102","2024","COM","2022","362","10","372","2024-12-30"
"45103","2024","COM","2022","1579","18","1597","2024-12-30"
"45104","2024","COM","2022","2840","61","2901","2024-12-30"
"45105","2024","COM","2022","82","2","84","2024-12-30"
"45107","2024","COM","2022","299","6","305","2024-12-30"
"45108","2024","COM","2022","2251","51","2302","2024-12-30"
"45109","2024","COM","2022","565","10","575","2024-12-30"
"45110","2024","COM","2022","318","8","326","2024-12-30"
"45111","2024","COM","2022","453","11","464","2024-12-30"
"45112","2024","COM","2022","367","5","372","2024-12-30"
"45113","2024","COM","2022","263","6","269","2024-12-30"
"45114","2024","COM","2022","214","10","224","2024-12-30"
"45115","2024","COM","2022","3799","62","3861","2024-12-30"
"45116","2024","COM","2022","951","28","979","2024-12-30"
"45118","2024","COM","2022","319","4","323","2024-12-30"
"45119","2024","COM","2022","2363","50","2413","2024-12-30"
"45120","2024","COM","2022","173","2","175","2024-12-30"
"45121","2024","COM","2022","460","7","467","2024-12-30"
"45122","2024","COM","2022","1454","35","1489","2024-12-30"
"45123","2024","COM","2022","1905","35","1940","2024-12-30"
"45124","2024","COM","2022","171","3","174","2024-12-30"
"45125","2024","COM","2022","107","2","109","2024-12-30"
"45126","2024","COM","2022","2833","65","2898","2024-12-30"
"45127","2024","COM","2022","3257","41","3298","2024-12-30"
"45129","2024","COM","2022","1362","17","1379","2024-12-30"
"45130","2024","COM","2022","1414","27","1441","2024-12-30"
"45131","2024","COM","2022","387","11","398","2024-12-30"
"45132","2024","COM","2022","356","7","363","2024-12-30"
"45133","2024","COM","2022","539","14","553","2024-12-30"
"45134","2024","COM","2022","1446","26","1472","2024-12-30"
"45135","2024","COM","2022","293","10","303","2024-12-30"
"45136","2024","COM","2022","564","7","571","2024-12-30"
"45137","2024","COM","2022","711","8","719","2024-12-30"
"45138","2024","COM","2022","57","2","59","2024-12-30"
"45139","2024","COM","2022","512","21","533","2024-12-30"
"45141","2024","COM","2022","175","1","176","2024-12-30"
"45142","2024","COM","2022","3846","69","3915","2024-12-30"
"45143","2024","COM","2022","30","1","31","2024-12-30"
"45144","2024","COM","2022","1134","97","1231","2024-12-30"
"45145","2024","COM","2022","3794","75","3869","2024-12-30"
"45146","2024","COM","2022","7317","156","7473","2024-12-30"
"45147","2024","COM","2022","21664","211","21875","2024-12-30"
"45148","2024","COM","2022","1677","43","1720","2024-12-30"
"45149","2024","COM","2022","303","6","309","2024-12-30"
"45150","2024","COM","2022","178","0","178","2024-12-30"
"45151","2024","COM","2022","251","5","256","2024-12-30"
"45152","2024","COM","2022","218","3","221","2024-12-30"
"45153","2024","COM","2022","700","10","710","2024-12-30"
"45154","2024","COM","2022","2015","33","2048","2024-12-30"
"45155","2024","COM","2022","13431","371","13802","2024-12-30"
"45156","2024","COM","2022","599","14","613","2024-12-30"
"45157","2024","COM","2022","420","5","425","2024-12-30"
"45158","2024","COM","2022","329","10","339","2024-12-30"
"45159","2024","COM","2022","177","8","185","2024-12-30"
"45160","2024","COM","2022","672","9","681","2024-12-30"
"45161","2024","COM","2022","818","17","835","2024-12-30"
"45162","2024","COM","2022","541","13","554","2024-12-30"
"45164","2024","COM","2022","667","17","684","2024-12-30"
"45165","2024","COM","2022","603","8","611","2024-12-30"
"45166","2024","COM","2022","282","8","290","2024-12-30"
"45167","2024","COM","2022","1754","33","1787","2024-12-30"
"45168","2024","COM","2022","543","4","547","2024-12-30"
"45169","2024","COM","2022","9838","241","10079","2024-12-30"
"45170","2024","COM","2022","175","2","177","2024-12-30"
"45171","2024","COM","2022","531","14","545","2024-12-30"
"45173","2024","COM","2022","4636","69","4705","2024-12-30"
"45174","2024","COM","2022","266","6","272","2024-12-30"
"45175","2024","COM","2022","1631","26","1657","2024-12-30"
"45176","2024","COM","2022","435","8","443","2024-12-30"
"45177","2024","COM","2022","241","9","250","2024-12-30"
"45178","2024","COM","2022","1394","25","1419","2024-12-30"
"45179","2024","COM","2022","3100","53","3153","2024-12-30"
"45180","2024","COM","2022","86","3","89","2024-12-30"
"45181","2024","COM","2022","88","3","91","2024-12-30"
"45182","2024","COM","2022","1255","22","1277","2024-12-30"
"45183","2024","COM","2022","122","3","125","2024-12-30"
"45184","2024","COM","2022","386","7","393","2024-12-30"
"45185","2024","COM","2022","304","4","308","2024-12-30"
"45186","2024","COM","2022","589","13","602","2024-12-30"
"45187","2024","COM","2022","3002","61","3063","2024-12-30"
"45188","2024","COM","2022","2582","67","2649","2024-12-30"
"45189","2024","COM","2022","246","3","249","2024-12-30"
"45191","2024","COM","2022","8022","161","8183","2024-12-30"
"45193","2024","COM","2022","2185","50","2235","2024-12-30"
"45194","2024","COM","2022","3083","50","3133","2024-12-30"
"45195","2024","COM","2022","565","10","575","2024-12-30"
"45196","2024","COM","2022","1669","32","1701","2024-12-30"
"45197","2024","COM","2022","1861","27","1888","2024-12-30"
"45198","2024","COM","2022","313","8","321","2024-12-30"
"45199","2024","COM","2022","507","12","519","2024-12-30"
"45200","2024","COM","2022","1385","38","1423","2024-12-30"
"45201","2024","COM","2022","173","3","176","2024-12-30"
"45202","2024","COM","2022","1029","16","1045","2024-12-30"
"45203","2024","COM","2022","6621","124","6745","2024-12-30"
"45204","2024","COM","2022","857","23","880","2024-12-30"
"45205","2024","COM","2022","259","6","265","2024-12-30"
"45206","2024","COM","2022","314","3","317","2024-12-30"
"45207","2024","COM","2022","357","8","365","2024-12-30"
"45208","2024","COM","2022","14819","399","15218","2024-12-30"
"45209","2024","COM","2022","297","5","302","2024-12-30"
"45210","2024","COM","2022","727","15","742","2024-12-30"
"45212","2024","COM","2022","1257","22","1279","2024-12-30"
"45213","2024","COM","2022","644","22","666","2024-12-30"
"45214","2024","COM","2022","243","3","246","2024-12-30"
"45215","2024","COM","2022","230","1","231","2024-12-30"
"45216","2024","COM","2022","133","2","135","2024-12-30"
"45217","2024","COM","2022","175","5","180","2024-12-30"
"45218","2024","COM","2022","128","1","129","2024-12-30"
"45219","2024","COM","2022","183","4","187","2024-12-30"
"45220","2024","COM","2022","571","17","588","2024-12-30"
"45222","2024","COM","2022","1441","36","1477","2024-12-30"
"45223","2024","COM","2022","368","5","373","2024-12-30"
"45224","2024","COM","2022","4984","65","5049","2024-12-30"
"45225","2024","COM","2022","345","15","360","2024-12-30"
"45226","2024","COM","2022","1365","22","1387","2024-12-30"
"45227","2024","COM","2022","1160","21","1181","2024-12-30"
"45228","2024","COM","2022","1176","29","1205","2024-12-30"
"45229","2024","COM","2022","2571","35","2606","2024-12-30"
"45230","2024","COM","2022","743","13","756","2024-12-30"
"45231","2024","COM","2022","122","5","127","2024-12-30"
"45232","2024","COM","2022","22988","504","23492","2024-12-30"
"45233","2024","COM","2022","403","3","406","2024-12-30"
"45234","2024","COM","2022","116344","2472","118816","2024-12-30"
"45235","2024","COM","2022","4341","96","4437","2024-12-30"
"45237","2024","COM","2022","129","2","131","2024-12-30"
"45238","2024","COM","2022","702","12","714","2024-12-30"
"45239","2024","COM","2022","423","6","429","2024-12-30"
"45240","2024","COM","2022","1343","23","1366","2024-12-30"
"45241","2024","COM","2022","539","15","554","2024-12-30"
"45242","2024","COM","2022","279","4","283","2024-12-30"
"45243","2024","COM","2022","314","6","320","2024-12-30"
"45244","2024","COM","2022","2560","80","2640","2024-12-30"
"45245","2024","COM","2022","1124","17","1141","2024-12-30"
"45246","2024","COM","2022","116","4","120","2024-12-30"
"45247","2024","COM","2022","3719","79","3798","2024-12-30"
"45248","2024","COM","2022","2341","38","2379","2024-12-30"
"45249","2024","COM","2022","920","27","947","2024-12-30"
"45250","2024","COM","2022","241","5","246","2024-12-30"
"45251","2024","COM","2022","286","3","289","2024-12-30"
"45252","2024","COM","2022","8981","138","9119","2024-12-30"
"45253","2024","COM","2022","1729","43","1772","2024-12-30"
"45254","2024","COM","2022","2464","48","2512","2024-12-30"
"45255","2024","COM","2022","429","4","433","2024-12-30"
"45256","2024","COM","2022","256","7","263","2024-12-30"
"45257","2024","COM","2022","530","7","537","2024-12-30"
"45258","2024","COM","2022","3336","50","3386","2024-12-30"
"45259","2024","COM","2022","1165","16","1181","2024-12-30"
"45260","2024","COM","2022","246","8","254","2024-12-30"
"45261","2024","COM","2022","1396","33","1429","2024-12-30"
"45262","2024","COM","2022","136","2","138","2024-12-30"
"45263","2024","COM","2022","299","8","307","2024-12-30"
"45264","2024","COM","2022","181","3","184","2024-12-30"
"45265","2024","COM","2022","398","5","403","2024-12-30"
"45266","2024","COM","2022","205","1","206","2024-12-30"
"45268","2024","COM","2022","602","12","614","2024-12-30"
"45269","2024","COM","2022","3691","74","3765","2024-12-30"
"45270","2024","COM","2022","1993","47","2040","2024-12-30"
"45271","2024","COM","2022","961","23","984","2024-12-30"
"45272","2024","COM","2022","3430","76","3506","2024-12-30"
"45273","2024","COM","2022","3057","43","3100","2024-12-30"
"45274","2024","COM","2022","7768","195","7963","2024-12-30"
"45275","2024","COM","2022","498","5","503","2024-12-30"
"45276","2024","COM","2022","509","6","515","2024-12-30"
"45277","2024","COM","2022","445","8","453","2024-12-30"
"45278","2024","COM","2022","1062","69","1131","2024-12-30"
"45279","2024","COM","2022","1864","41","1905","2024-12-30"
"45280","2024","COM","2022","1046","17","1063","2024-12-30"
"45281","2024","COM","2022","953","16","969","2024-12-30"
"45282","2024","COM","2022","3156","86","3242","2024-12-30"
"45283","2024","COM","2022","154","6","160","2024-12-30"
"45284","2024","COM","2022","22088","623","22711","2024-12-30"
"45285","2024","COM","2022","16608","234","16842","2024-12-30"
"45286","2024","COM","2022","9534","138","9672","2024-12-30"
"45288","2024","COM","2022","391","8","399","2024-12-30"
"45289","2024","COM","2022","1235","18","1253","2024-12-30"
"45290","2024","COM","2022","1825","17","1842","2024-12-30"
"45291","2024","COM","2022","1225","45","1270","2024-12-30"
"45292","2024","COM","2022","842","12","854","2024-12-30"
"45293","2024","COM","2022","1144","24","1168","2024-12-30"
"45294","2024","COM","2022","149","1","150","2024-12-30"
"45296","2024","COM","2022","768","15","783","2024-12-30"
"45297","2024","COM","2022","1030","26","1056","2024-12-30"
"45298","2024","COM","2022","6200","105","6305","2024-12-30"
"45299","2024","COM","2022","270","0","270","2024-12-30"
"45300","2024","COM","2022","4209","103","4312","2024-12-30"
"45301","2024","COM","2022","393","3","396","2024-12-30"
"45302","2024","COM","2022","16866","222","17088","2024-12-30"
"45303","2024","COM","2022","613","17","630","2024-12-30"
"45305","2024","COM","2022","220","1","221","2024-12-30"
"45306","2024","COM","2022","778","19","797","2024-12-30"
"45307","2024","COM","2022","1131","23","1154","2024-12-30"
"45308","2024","COM","2022","3204","76","3280","2024-12-30"
"45309","2024","COM","2022","680","13","693","2024-12-30"
"45310","2024","COM","2022","1703","26","1729","2024-12-30"
"45311","2024","COM","2022","660","18","678","2024-12-30"
"45312","2024","COM","2022","476","8","484","2024-12-30"
"45313","2024","COM","2022","835","11","846","2024-12-30"
"45314","2024","COM","2022","453","9","462","2024-12-30"
"45315","2024","COM","2022","5142","53","5195","2024-12-30"
"45316","2024","COM","2022","775","20","795","2024-12-30"
"45317","2024","COM","2022","1338","32","1370","2024-12-30"
"45320","2024","COM","2022","388","10","398","2024-12-30"
"45321","2024","COM","2022","691","19","710","2024-12-30"
"45322","2024","COM","2022","197","9","206","2024-12-30"
"45323","2024","COM","2022","213","3","216","2024-12-30"
"45324","2024","COM","2022","2463","49","2512","2024-12-30"
"45325","2024","COM","2022","282","14","296","2024-12-30"
"45326","2024","COM","2022","383","9","392","2024-12-30"
"45327","2024","COM","2022","3419","67","3486","2024-12-30"
"45328","2024","COM","2022","294","4","298","2024-12-30"
"45329","2024","COM","2022","1267","37","1304","2024-12-30"
"45330","2024","COM","2022","210","0","210","2024-12-30"
"45331","2024","COM","2022","602","7","609","2024-12-30"
"45332","2024","COM","2022","1483","23","1506","2024-12-30"
"45333","2024","COM","2022","2045","41","2086","2024-12-30"
"45334","2024","COM","2022","621","9","630","2024-12-30"
"45335","2024","COM","2022","1965","47","2012","2024-12-30"
"45336","2024","COM","2022","854","23","877","2024-12-30"
"45337","2024","COM","2022","279","3","282","2024-12-30"
"45338","2024","COM","2022","6931","360","7291","2024-12-30"
"45339","2024","COM","2022","475","7","482","2024-12-30"
"45340","2024","COM","2022","537","11","548","2024-12-30"
"45341","2024","COM","2022","192","6","198","2024-12-30"
"45342","2024","COM","2022","401","3","404","2024-12-30"
"45343","2024","COM","2022","196","5","201","2024-12-30"
"45344","2024","COM","2022","1076","19","1095","2024-12-30"
"45345","2024","COM","2022","1101","33","1134","2024-12-30"
"45346","2024","COM","2022","2212","33","2245","2024-12-30"
"45347","2024","COM","2022","797","20","817","2024-12-30"
"45348","2024","COM","2022","666","13","679","2024-12-30"
"46001","2024","COM","2022","529","12","541","2024-12-30"
"46002","2024","COM","2022","88","2","90","2024-12-30"
"46003","2024","COM","2022","694","25","719","2024-12-30"
"46004","2024","COM","2022","221","12","233","2024-12-30"
"46005","2024","COM","2022","334","10","344","2024-12-30"
"46006","2024","COM","2022","397","10","407","2024-12-30"
"46007","2024","COM","2022","1000","24","1024","2024-12-30"
"46008","2024","COM","2022","214","3","217","2024-12-30"
"46009","2024","COM","2022","707","21","728","2024-12-30"
"46010","2024","COM","2022","376","9","385","2024-12-30"
"46011","2024","COM","2022","376","11","387","2024-12-30"
"46012","2024","COM","2022","558","14","572","2024-12-30"
"46013","2024","COM","2022","207","8","215","2024-12-30"
"46015","2024","COM","2022","1481","34","1515","2024-12-30"
"46016","2024","COM","2022","391","14","405","2024-12-30"
"46017","2024","COM","2022","145","4","149","2024-12-30"
"46018","2024","COM","2022","141","8","149","2024-12-30"
"46020","2024","COM","2022","228","13","241","2024-12-30"
"46021","2024","COM","2022","732","13","745","2024-12-30"
"46022","2024","COM","2022","204","3","207","2024-12-30"
"46023","2024","COM","2022","508","13","521","2024-12-30"
"46024","2024","COM","2022","406","12","418","2024-12-30"
"46026","2024","COM","2022","129","3","132","2024-12-30"
"46027","2024","COM","2022","138","4","142","2024-12-30"
"46028","2024","COM","2022","1073","30","1103","2024-12-30"
"46029","2024","COM","2022","1968","51","2019","2024-12-30"
"46030","2024","COM","2022","343","14","357","2024-12-30"
"46031","2024","COM","2022","135","0","135","2024-12-30"
"46032","2024","COM","2022","388","8","396","2024-12-30"
"46033","2024","COM","2022","534","11","545","2024-12-30"
"46034","2024","COM","2022","301","7","308","2024-12-30"
"46035","2024","COM","2022","182","4","186","2024-12-30"
"46036","2024","COM","2022","122","2","124","2024-12-30"
"46037","2024","COM","2022","94","1","95","2024-12-30"
"46038","2024","COM","2022","1429","26","1455","2024-12-30"
"46039","2024","COM","2022","197","2","199","2024-12-30"
"46040","2024","COM","2022","222","8","230","2024-12-30"
"46041","2024","COM","2022","168","4","172","2024-12-30"
"46042","2024","COM","2022","19902","880","20782","2024-12-30"
"46043","2024","COM","2022","185","5","190","2024-12-30"
"46044","2024","COM","2022","590","15","605","2024-12-30"
"46045","2024","COM","2022","1134","31","1165","2024-12-30"
"46046","2024","COM","2022","458","10","468","2024-12-30"
"46047","2024","COM","2022","165","7","172","2024-12-30"
"46049","2024","COM","2022","241","6","247","2024-12-30"
"46050","2024","COM","2022","135","4","139","2024-12-30"
"46051","2024","COM","2022","347","8","355","2024-12-30"
"46052","2024","COM","2022","254","6","260","2024-12-30"
"46053","2024","COM","2022","445","13","458","2024-12-30"
"46054","2024","COM","2022","379","9","388","2024-12-30"
"46055","2024","COM","2022","1070","32","1102","2024-12-30"
"46056","2024","COM","2022","107","2","109","2024-12-30"
"46057","2024","COM","2022","621","12","633","2024-12-30"
"46058","2024","COM","2022","426","10","436","2024-12-30"
"46059","2024","COM","2022","224","10","234","2024-12-30"
"46060","2024","COM","2022","230","1","231","2024-12-30"
"46061","2024","COM","2022","174","4","178","2024-12-30"
"46062","2024","COM","2022","425","7","432","2024-12-30"
"46063","2024","COM","2022","1827","38","1865","2024-12-30"
"46064","2024","COM","2022","919","8","927","2024-12-30"
"46065","2024","COM","2022","415","14","429","2024-12-30"
"46066","2024","COM","2022","651","6","657","2024-12-30"
"46068","2024","COM","2022","179","3","182","2024-12-30"
"46069","2024","COM","2022","178","3","181","2024-12-30"
"46070","2024","COM","2022","647","15","662","2024-12-30"
"46072","2024","COM","2022","303","7","310","2024-12-30"
"46073","2024","COM","2022","409","19","428","2024-12-30"
"46074","2024","COM","2022","399","7","406","2024-12-30"
"46075","2024","COM","2022","238","5","243","2024-12-30"
"46076","2024","COM","2022","360","10","370","2024-12-30"
"46078","2024","COM","2022","96","1","97","2024-12-30"
"46079","2024","COM","2022","99","1","100","2024-12-30"
"46080","2024","COM","2022","823","17","840","2024-12-30"
"46081","2024","COM","2022","82","1","83","2024-12-30"
"46082","2024","COM","2022","389","8","397","2024-12-30"
"46083","2024","COM","2022","1154","14","1168","2024-12-30"
"46084","2024","COM","2022","311","5","316","2024-12-30"
"46085","2024","COM","2022","242","6","248","2024-12-30"
"46086","2024","COM","2022","655","13","668","2024-12-30"
"46087","2024","COM","2022","637","18","655","2024-12-30"
"46088","2024","COM","2022","834","23","857","2024-12-30"
"46089","2024","COM","2022","946","12","958","2024-12-30"
"46090","2024","COM","2022","160","1","161","2024-12-30"
"46091","2024","COM","2022","209","6","215","2024-12-30"
"46092","2024","COM","2022","218","4","222","2024-12-30"
"46093","2024","COM","2022","92","1","93","2024-12-30"
"46094","2024","COM","2022","282","6","288","2024-12-30"
"46095","2024","COM","2022","987","15","1002","2024-12-30"
"46096","2024","COM","2022","96","4","100","2024-12-30"
"46097","2024","COM","2022","106","5","111","2024-12-30"
"46098","2024","COM","2022","313","7","320","2024-12-30"
"46100","2024","COM","2022","722","30","752","2024-12-30"
"46101","2024","COM","2022","467","15","482","2024-12-30"
"46102","2024","COM","2022","9757","592","10349","2024-12-30"
"46103","2024","COM","2022","981","27","1008","2024-12-30"
"46104","2024","COM","2022","86","2","88","2024-12-30"
"46105","2024","COM","2022","805","23","828","2024-12-30"
"46106","2024","COM","2022","240","9","249","2024-12-30"
"46107","2024","COM","2022","179","5","184","2024-12-30"
"46108","2024","COM","2022","403","13","416","2024-12-30"
"46109","2024","COM","2022","533","10","543","2024-12-30"
"46111","2024","COM","2022","176","4","180","2024-12-30"
"46112","2024","COM","2022","262","6","268","2024-12-30"
"46113","2024","COM","2022","312","5","317","2024-12-30"
"46114","2024","COM","2022","375","6","381","2024-12-30"
"46115","2024","COM","2022","165","6","171","2024-12-30"
"46116","2024","COM","2022","70","5","75","2024-12-30"
"46117","2024","COM","2022","657","32","689","2024-12-30"
"46118","2024","COM","2022","683","11","694","2024-12-30"
"46119","2024","COM","2022","304","3","307","2024-12-30"
"46120","2024","COM","2022","357","6","363","2024-12-30"
"46121","2024","COM","2022","141","1","142","2024-12-30"
"46122","2024","COM","2022","95","2","97","2024-12-30"
"46123","2024","COM","2022","353","7","360","2024-12-30"
"46124","2024","COM","2022","296","12","308","2024-12-30"
"46125","2024","COM","2022","340","16","356","2024-12-30"
"46126","2024","COM","2022","219","4","223","2024-12-30"
"46127","2024","COM","2022","4080","115","4195","2024-12-30"
"46128","2024","COM","2022","3496","68","3564","2024-12-30"
"46129","2024","COM","2022","302","8","310","2024-12-30"
"46130","2024","COM","2022","235","3","238","2024-12-30"
"46131","2024","COM","2022","158","6","164","2024-12-30"
"46132","2024","COM","2022","523","20","543","2024-12-30"
"46133","2024","COM","2022","277","3","280","2024-12-30"
"46134","2024","COM","2022","252","6","258","2024-12-30"
"46135","2024","COM","2022","44","2","46","2024-12-30"
"46136","2024","COM","2022","276","3","279","2024-12-30"
"46137","2024","COM","2022","1316","24","1340","2024-12-30"
"46138","2024","COM","2022","890","18","908","2024-12-30"
"46139","2024","COM","2022","201","7","208","2024-12-30"
"46140","2024","COM","2022","374","9","383","2024-12-30"
"46142","2024","COM","2022","172","2","174","2024-12-30"
"46143","2024","COM","2022","1278","43","1321","2024-12-30"
"46144","2024","COM","2022","264","8","272","2024-12-30"
"46145","2024","COM","2022","796","11","807","2024-12-30"
"46146","2024","COM","2022","89","2","91","2024-12-30"
"46147","2024","COM","2022","124","1","125","2024-12-30"
"46148","2024","COM","2022","1878","47","1925","2024-12-30"
"46149","2024","COM","2022","716","14","730","2024-12-30"
"46151","2024","COM","2022","113","3","116","2024-12-30"
"46152","2024","COM","2022","318","4","322","2024-12-30"
"46153","2024","COM","2022","571","13","584","2024-12-30"
"46154","2024","COM","2022","353","10","363","2024-12-30"
"46155","2024","COM","2022","136","0","136","2024-12-30"
"46156","2024","COM","2022","1188","28","1216","2024-12-30"
"46157","2024","COM","2022","132","5","137","2024-12-30"
"46159","2024","COM","2022","246","6","252","2024-12-30"
"46160","2024","COM","2022","429","9","438","2024-12-30"
"46161","2024","COM","2022","242","6","248","2024-12-30"
"46162","2024","COM","2022","205","8","213","2024-12-30"
"46163","2024","COM","2022","292","2","294","2024-12-30"
"46164","2024","COM","2022","244","6","250","2024-12-30"
"46165","2024","COM","2022","485","11","496","2024-12-30"
"46167","2024","COM","2022","108","1","109","2024-12-30"
"46168","2024","COM","2022","191","8","199","2024-12-30"
"46169","2024","COM","2022","224","7","231","2024-12-30"
"46170","2024","COM","2022","929","26","955","2024-12-30"
"46171","2024","COM","2022","234","3","237","2024-12-30"
"46172","2024","COM","2022","499","13","512","2024-12-30"
"46173","2024","COM","2022","842","10","852","2024-12-30"
"46174","2024","COM","2022","235","8","243","2024-12-30"
"46175","2024","COM","2022","943","36","979","2024-12-30"
"46176","2024","COM","2022","720","14","734","2024-12-30"
"46177","2024","COM","2022","514","21","535","2024-12-30"
"46178","2024","COM","2022","273","3","276","2024-12-30"
"46179","2024","COM","2022","134","4","138","2024-12-30"
"46180","2024","COM","2022","614","28","642","2024-12-30"
"46181","2024","COM","2022","94","5","99","2024-12-30"
"46182","2024","COM","2022","1758","27","1785","2024-12-30"
"46183","2024","COM","2022","183","2","185","2024-12-30"
"46184","2024","COM","2022","348","6","354","2024-12-30"
"46185","2024","COM","2022","1639","36","1675","2024-12-30"
"46186","2024","COM","2022","356","5","361","2024-12-30"
"46187","2024","COM","2022","553","12","565","2024-12-30"
"46188","2024","COM","2022","288","10","298","2024-12-30"
"46189","2024","COM","2022","487","14","501","2024-12-30"
"46190","2024","COM","2022","126","3","129","2024-12-30"
"46191","2024","COM","2022","1125","27","1152","2024-12-30"
"46192","2024","COM","2022","264","3","267","2024-12-30"
"46193","2024","COM","2022","448","9","457","2024-12-30"
"46194","2024","COM","2022","199","5","204","2024-12-30"
"46195","2024","COM","2022","357","12","369","2024-12-30"
"46196","2024","COM","2022","91","2","93","2024-12-30"
"46197","2024","COM","2022","1102","126","1228","2024-12-30"
"46198","2024","COM","2022","111","1","112","2024-12-30"
"46199","2024","COM","2022","342","6","348","2024-12-30"
"46200","2024","COM","2022","275","3","278","2024-12-30"
"46201","2024","COM","2022","1812","52","1864","2024-12-30"
"46202","2024","COM","2022","570","5","575","2024-12-30"
"46203","2024","COM","2022","213","6","219","2024-12-30"
"46204","2024","COM","2022","588","9","597","2024-12-30"
"46205","2024","COM","2022","320","3","323","2024-12-30"
"46206","2024","COM","2022","121","4","125","2024-12-30"
"46207","2024","COM","2022","301","6","307","2024-12-30"
"46208","2024","COM","2022","309","8","317","2024-12-30"
"46209","2024","COM","2022","170","4","174","2024-12-30"
"46210","2024","COM","2022","73","1","74","2024-12-30"
"46211","2024","COM","2022","351","3","354","2024-12-30"
"46212","2024","COM","2022","72","1","73","2024-12-30"
"46213","2024","COM","2022","183","4","187","2024-12-30"
"46214","2024","COM","2022","382","10","392","2024-12-30"
"46215","2024","COM","2022","666","15","681","2024-12-30"
"46216","2024","COM","2022","654","29","683","2024-12-30"
"46217","2024","COM","2022","426","11","437","2024-12-30"
"46218","2024","COM","2022","186","3","189","2024-12-30"
"46219","2024","COM","2022","346","10","356","2024-12-30"
"46220","2024","COM","2022","771","28","799","2024-12-30"
"46221","2024","COM","2022","549","16","565","2024-12-30"
"46222","2024","COM","2022","190","6","196","2024-12-30"
"46223","2024","COM","2022","182","3","185","2024-12-30"
"46224","2024","COM","2022","3600","103","3703","2024-12-30"
"46225","2024","COM","2022","2500","49","2549","2024-12-30"
"46226","2024","COM","2022","232","7","239","2024-12-30"
"46227","2024","COM","2022","229","5","234","2024-12-30"
"46228","2024","COM","2022","735","26","761","2024-12-30"
"46229","2024","COM","2022","993","22","1015","2024-12-30"
"46230","2024","COM","2022","90","4","94","2024-12-30"
"46231","2024","COM","2022","1870","25","1895","2024-12-30"
"46232","2024","COM","2022","955","21","976","2024-12-30"
"46233","2024","COM","2022","106","1","107","2024-12-30"
"46234","2024","COM","2022","102","1","103","2024-12-30"
"46235","2024","COM","2022","173","5","178","2024-12-30"
"46236","2024","COM","2022","151","0","151","2024-12-30"
"46237","2024","COM","2022","366","12","378","2024-12-30"
"46238","2024","COM","2022","292","9","301","2024-12-30"
"46239","2024","COM","2022","208","4","212","2024-12-30"
"46240","2024","COM","2022","604","17","621","2024-12-30"
"46241","2024","COM","2022","196","3","199","2024-12-30"
"46242","2024","COM","2022","185","2","187","2024-12-30"
"46243","2024","COM","2022","195","4","199","2024-12-30"
"46244","2024","COM","2022","93","1","94","2024-12-30"
"46245","2024","COM","2022","91","2","93","2024-12-30"
"46246","2024","COM","2022","74","1","75","2024-12-30"
"46247","2024","COM","2022","148","6","154","2024-12-30"
"46249","2024","COM","2022","122","5","127","2024-12-30"
"46250","2024","COM","2022","80","2","82","2024-12-30"
"46251","2024","COM","2022","3449","139","3588","2024-12-30"
"46252","2024","COM","2022","306","2","308","2024-12-30"
"46253","2024","COM","2022","186","5","191","2024-12-30"
"46254","2024","COM","2022","142","3","145","2024-12-30"
"46255","2024","COM","2022","323","11","334","2024-12-30"
"46256","2024","COM","2022","204","6","210","2024-12-30"
"46257","2024","COM","2022","154","1","155","2024-12-30"
"46258","2024","COM","2022","172","1","173","2024-12-30"
"46259","2024","COM","2022","141","1","142","2024-12-30"
"46260","2024","COM","2022","234","10","244","2024-12-30"
"46262","2024","COM","2022","620","12","632","2024-12-30"
"46263","2024","COM","2022","706","16","722","2024-12-30"
"46264","2024","COM","2022","203","7","210","2024-12-30"
"46265","2024","COM","2022","334","3","337","2024-12-30"
"46266","2024","COM","2022","523","21","544","2024-12-30"
"46267","2024","COM","2022","604","10","614","2024-12-30"
"46268","2024","COM","2022","912","22","934","2024-12-30"
"46269","2024","COM","2022","62","3","65","2024-12-30"
"46270","2024","COM","2022","247","1","248","2024-12-30"
"46271","2024","COM","2022","411","16","427","2024-12-30"
"46272","2024","COM","2022","309","3","312","2024-12-30"
"46273","2024","COM","2022","845","26","871","2024-12-30"
"46276","2024","COM","2022","196","2","198","2024-12-30"
"46277","2024","COM","2022","194","5","199","2024-12-30"
"46279","2024","COM","2022","205","3","208","2024-12-30"
"46280","2024","COM","2022","190","4","194","2024-12-30"
"46281","2024","COM","2022","201","3","204","2024-12-30"
"46282","2024","COM","2022","98","1","99","2024-12-30"
"46283","2024","COM","2022","341","11","352","2024-12-30"
"46284","2024","COM","2022","416","8","424","2024-12-30"
"46286","2024","COM","2022","174","4","178","2024-12-30"
"46288","2024","COM","2022","202","4","206","2024-12-30"
"46289","2024","COM","2022","164","4","168","2024-12-30"
"46290","2024","COM","2022","354","8","362","2024-12-30"
"46292","2024","COM","2022","194","6","200","2024-12-30"
"46293","2024","COM","2022","486","12","498","2024-12-30"
"46294","2024","COM","2022","134","3","137","2024-12-30"
"46295","2024","COM","2022","226","4","230","2024-12-30"
"46296","2024","COM","2022","432","9","441","2024-12-30"
"46297","2024","COM","2022","1218","26","1244","2024-12-30"
"46299","2024","COM","2022","116","3","119","2024-12-30"
"46301","2024","COM","2022","533","11","544","2024-12-30"
"46302","2024","COM","2022","129","2","131","2024-12-30"
"46303","2024","COM","2022","145","2","147","2024-12-30"
"46304","2024","COM","2022","144","3","147","2024-12-30"
"46305","2024","COM","2022","334","3","337","2024-12-30"
"46306","2024","COM","2022","93","1","94","2024-12-30"
"46307","2024","COM","2022","638","12","650","2024-12-30"
"46308","2024","COM","2022","103","3","106","2024-12-30"
"46309","2024","COM","2022","3199","313","3512","2024-12-30"
"46310","2024","COM","2022","133","3","136","2024-12-30"
"46311","2024","COM","2022","1335","20","1355","2024-12-30"
"46312","2024","COM","2022","264","6","270","2024-12-30"
"46313","2024","COM","2022","464","9","473","2024-12-30"
"46314","2024","COM","2022","175","39","214","2024-12-30"
"46315","2024","COM","2022","163","3","166","2024-12-30"
"46316","2024","COM","2022","298","7","305","2024-12-30"
"46317","2024","COM","2022","488","14","502","2024-12-30"
"46318","2024","COM","2022","242","12","254","2024-12-30"
"46319","2024","COM","2022","182","3","185","2024-12-30"
"46320","2024","COM","2022","320","14","334","2024-12-30"
"46321","2024","COM","2022","361","6","367","2024-12-30"
"46322","2024","COM","2022","828","21","849","2024-12-30"
"46323","2024","COM","2022","96","2","98","2024-12-30"
"46324","2024","COM","2022","201","2","203","2024-12-30"
"46328","2024","COM","2022","356","12","368","2024-12-30"
"46329","2024","COM","2022","327","2","329","2024-12-30"
"46330","2024","COM","2022","1279","23","1302","2024-12-30"
"46332","2024","COM","2022","339","15","354","2024-12-30"
"46333","2024","COM","2022","184","2","186","2024-12-30"
"46334","2024","COM","2022","1544","60","1604","2024-12-30"
"46335","2024","COM","2022","402","7","409","2024-12-30"
"46336","2024","COM","2022","344","33","377","2024-12-30"
"46337","2024","COM","2022","256","8","264","2024-12-30"
"46338","2024","COM","2022","74","1","75","2024-12-30"
"46339","2024","COM","2022","389","8","397","2024-12-30"
"46340","2024","COM","2022","398","4","402","2024-12-30"
"47001","2024","COM","2022","32193","795","32988","2024-12-30"
"47002","2024","COM","2022","106","4","110","2024-12-30"
"47003","2024","COM","2022","476","11","487","2024-12-30"
"47004","2024","COM","2022","3983","117","4100","2024-12-30"
"47005","2024","COM","2022","486","5","491","2024-12-30"
"47006","2024","COM","2022","609","13","622","2024-12-30"
"47007","2024","COM","2022","167","5","172","2024-12-30"
"47008","2024","COM","2022","109","5","114","2024-12-30"
"47009","2024","COM","2022","258","10","268","2024-12-30"
"47010","2024","COM","2022","222","2","224","2024-12-30"
"47011","2024","COM","2022","200","7","207","2024-12-30"
"47012","2024","COM","2022","325","6","331","2024-12-30"
"47013","2024","COM","2022","316","11","327","2024-12-30"
"47014","2024","COM","2022","207","7","214","2024-12-30"
"47015","2024","COM","2022","2002","36","2038","2024-12-30"
"47016","2024","COM","2022","1177","23","1200","2024-12-30"
"47017","2024","COM","2022","419","11","430","2024-12-30"
"47018","2024","COM","2022","174","5","179","2024-12-30"
"47019","2024","COM","2022","1000","16","1016","2024-12-30"
"47020","2024","COM","2022","188","8","196","2024-12-30"
"47021","2024","COM","2022","1498","70","1568","2024-12-30"
"47022","2024","COM","2022","504","10","514","2024-12-30"
"47023","2024","COM","2022","329","8","337","2024-12-30"
"47024","2024","COM","2022","1678","41","1719","2024-12-30"
"47025","2024","COM","2022","552","10","562","2024-12-30"
"47026","2024","COM","2022","236","7","243","2024-12-30"
"47027","2024","COM","2022","2965","45","3010","2024-12-30"
"47028","2024","COM","2022","831","22","853","2024-12-30"
"47029","2024","COM","2022","517","13","530","2024-12-30"
"47030","2024","COM","2022","215","5","220","2024-12-30"
"47031","2024","COM","2022","5784","91","5875","2024-12-30"
"47032","2024","COM","2022","6386","118","6504","2024-12-30"
"47033","2024","COM","2022","397","8","405","2024-12-30"
"47034","2024","COM","2022","651","15","666","2024-12-30"
"47035","2024","COM","2022","289","60","349","2024-12-30"
"47036","2024","COM","2022","373","7","380","2024-12-30"
"47037","2024","COM","2022","252","5","257","2024-12-30"
"47038","2024","COM","2022","612","25","637","2024-12-30"
"47039","2024","COM","2022","41","1","42","2024-12-30"
"47040","2024","COM","2022","2103","38","2141","2024-12-30"
"47041","2024","COM","2022","692","16","708","2024-12-30"
"47042","2024","COM","2022","179","3","182","2024-12-30"
"47043","2024","COM","2022","1246","30","1276","2024-12-30"
"47044","2024","COM","2022","310","6","316","2024-12-30"
"47045","2024","COM","2022","489","13","502","2024-12-30"
"47046","2024","COM","2022","589","13","602","2024-12-30"
"47047","2024","COM","2022","176","5","181","2024-12-30"
"47048","2024","COM","2022","1366","22","1388","2024-12-30"
"47049","2024","COM","2022","2340","46","2386","2024-12-30"
"47050","2024","COM","2022","128","2","130","2024-12-30"
"47051","2024","COM","2022","2383","52","2435","2024-12-30"
"47052","2024","COM","2022","4639","51","4690","2024-12-30"
"47053","2024","COM","2022","377","8","385","2024-12-30"
"47054","2024","COM","2022","1830","54","1884","2024-12-30"
"47055","2024","COM","2022","516","5","521","2024-12-30"
"47056","2024","COM","2022","914","32","946","2024-12-30"
"47057","2024","COM","2022","1359","20","1379","2024-12-30"
"47058","2024","COM","2022","273","10","283","2024-12-30"
"47059","2024","COM","2022","263","2","265","2024-12-30"
"47060","2024","COM","2022","1133","21","1154","2024-12-30"
"47061","2024","COM","2022","815","11","826","2024-12-30"
"47062","2024","COM","2022","413","4","417","2024-12-30"
"47063","2024","COM","2022","158","3","161","2024-12-30"
"47064","2024","COM","2022","246","6","252","2024-12-30"
"47065","2024","COM","2022","2576","198","2774","2024-12-30"
"47066","2024","COM","2022","810","16","826","2024-12-30"
"47067","2024","COM","2022","405","8","413","2024-12-30"
"47068","2024","COM","2022","1110","26","1136","2024-12-30"
"47069","2024","COM","2022","3106","45","3151","2024-12-30"
"47070","2024","COM","2022","837","19","856","2024-12-30"
"47071","2024","COM","2022","254","1","255","2024-12-30"
"47072","2024","COM","2022","108","5","113","2024-12-30"
"47073","2024","COM","2022","193","4","197","2024-12-30"
"47074","2024","COM","2022","366","7","373","2024-12-30"
"47075","2024","COM","2022","1081","20","1101","2024-12-30"
"47076","2024","COM","2022","280","5","285","2024-12-30"
"47077","2024","COM","2022","850","19","869","2024-12-30"
"47078","2024","COM","2022","1353","24","1377","2024-12-30"
"47079","2024","COM","2022","537","17","554","2024-12-30"
"47080","2024","COM","2022","157","2","159","2024-12-30"
"47081","2024","COM","2022","714","16","730","2024-12-30"
"47082","2024","COM","2022","216","2","218","2024-12-30"
"47083","2024","COM","2022","108","1","109","2024-12-30"
"47084","2024","COM","2022","261","5","266","2024-12-30"
"47085","2024","COM","2022","268","2","270","2024-12-30"
"47086","2024","COM","2022","1206","24","1230","2024-12-30"
"47087","2024","COM","2022","159","7","166","2024-12-30"
"47088","2024","COM","2022","654","7","661","2024-12-30"
"47089","2024","COM","2022","163","2","165","2024-12-30"
"47090","2024","COM","2022","358","8","366","2024-12-30"
"47091","2024","COM","2022","2392","45","2437","2024-12-30"
"47092","2024","COM","2022","405","6","411","2024-12-30"
"47093","2024","COM","2022","341","8","349","2024-12-30"
"47094","2024","COM","2022","827","14","841","2024-12-30"
"47095","2024","COM","2022","857","13","870","2024-12-30"
"47096","2024","COM","2022","202","7","209","2024-12-30"
"47097","2024","COM","2022","1015","18","1033","2024-12-30"
"47098","2024","COM","2022","327","14","341","2024-12-30"
"47099","2024","COM","2022","625","15","640","2024-12-30"
"47100","2024","COM","2022","5480","245","5725","2024-12-30"
"47101","2024","COM","2022","1307","25","1332","2024-12-30"
"47102","2024","COM","2022","732","12","744","2024-12-30"
"47103","2024","COM","2022","223","6","229","2024-12-30"
"47104","2024","COM","2022","272","5","277","2024-12-30"
"47105","2024","COM","2022","283","5","288","2024-12-30"
"47106","2024","COM","2022","4696","109","4805","2024-12-30"
"47107","2024","COM","2022","334","3","337","2024-12-30"
"47108","2024","COM","2022","241","7","248","2024-12-30"
"47109","2024","COM","2022","304","4","308","2024-12-30"
"47110","2024","COM","2022","1641","30","1671","2024-12-30"
"47111","2024","COM","2022","589","16","605","2024-12-30"
"47112","2024","COM","2022","470","10","480","2024-12-30"
"47113","2024","COM","2022","147","2","149","2024-12-30"
"47114","2024","COM","2022","403","8","411","2024-12-30"
"47115","2024","COM","2022","247","6","253","2024-12-30"
"47117","2024","COM","2022","1028","13","1041","2024-12-30"
"47118","2024","COM","2022","166","5","171","2024-12-30"
"47119","2024","COM","2022","550","10","560","2024-12-30"
"47120","2024","COM","2022","94","2","96","2024-12-30"
"47121","2024","COM","2022","317","3","320","2024-12-30"
"47122","2024","COM","2022","169","2","171","2024-12-30"
"47123","2024","COM","2022","399","10","409","2024-12-30"
"47124","2024","COM","2022","208","4","212","2024-12-30"
"47125","2024","COM","2022","316","7","323","2024-12-30"
"47126","2024","COM","2022","101","1","102","2024-12-30"
"47127","2024","COM","2022","814","12","826","2024-12-30"
"47128","2024","COM","2022","1079","30","1109","2024-12-30"
"47129","2024","COM","2022","274","4","278","2024-12-30"
"47130","2024","COM","2022","343","6","349","2024-12-30"
"47131","2024","COM","2022","686","10","696","2024-12-30"
"47132","2024","COM","2022","221","7","228","2024-12-30"
"47133","2024","COM","2022","555","10","565","2024-12-30"
"47134","2024","COM","2022","361","8","369","2024-12-30"
"47135","2024","COM","2022","395","8","403","2024-12-30"
"47136","2024","COM","2022","141","2","143","2024-12-30"
"47137","2024","COM","2022","1335","33","1368","2024-12-30"
"47138","2024","COM","2022","1589","23","1612","2024-12-30"
"47139","2024","COM","2022","98","1","99","2024-12-30"
"47140","2024","COM","2022","692","13","705","2024-12-30"
"47141","2024","COM","2022","275","6","281","2024-12-30"
"47142","2024","COM","2022","731","11","742","2024-12-30"
"47143","2024","COM","2022","2297","42","2339","2024-12-30"
"47144","2024","COM","2022","559","20","579","2024-12-30"
"47145","2024","COM","2022","3913","67","3980","2024-12-30"
"47146","2024","COM","2022","1430","28","1458","2024-12-30"
"47147","2024","COM","2022","678","13","691","2024-12-30"
"47148","2024","COM","2022","206","1","207","2024-12-30"
"47150","2024","COM","2022","375","6","381","2024-12-30"
"47151","2024","COM","2022","409","4","413","2024-12-30"
"47152","2024","COM","2022","422","5","427","2024-12-30"
"47154","2024","COM","2022","363","10","373","2024-12-30"
"47155","2024","COM","2022","664","16","680","2024-12-30"
"47156","2024","COM","2022","874","9","883","2024-12-30"
"47157","2024","COM","2022","17361","488","17849","2024-12-30"
"47158","2024","COM","2022","165","5","170","2024-12-30"
"47159","2024","COM","2022","1486","36","1522","2024-12-30"
"47160","2024","COM","2022","175","3","178","2024-12-30"
"47161","2024","COM","2022","118","1","119","2024-12-30"
"47162","2024","COM","2022","201","4","205","2024-12-30"
"47163","2024","COM","2022","611","11","622","2024-12-30"
"47164","2024","COM","2022","99","3","102","2024-12-30"
"47165","2024","COM","2022","1330","56","1386","2024-12-30"
"47167","2024","COM","2022","1455","24","1479","2024-12-30"
"47168","2024","COM","2022","3082","104","3186","2024-12-30"
"47169","2024","COM","2022","1199","55","1254","2024-12-30"
"47170","2024","COM","2022","628","22","650","2024-12-30"
"47171","2024","COM","2022","449","9","458","2024-12-30"
"47172","2024","COM","2022","573","18","591","2024-12-30"
"47173","2024","COM","2022","898","9","907","2024-12-30"
"47174","2024","COM","2022","741","13","754","2024-12-30"
"47175","2024","COM","2022","2358","54","2412","2024-12-30"
"47176","2024","COM","2022","167","11","178","2024-12-30"
"47177","2024","COM","2022","193","2","195","2024-12-30"
"47178","2024","COM","2022","400","5","405","2024-12-30"
"47179","2024","COM","2022","2104","35","2139","2024-12-30"
"47180","2024","COM","2022","641","15","656","2024-12-30"
"47181","2024","COM","2022","271","5","276","2024-12-30"
"47182","2024","COM","2022","233","2","235","2024-12-30"
"47183","2024","COM","2022","222","3","225","2024-12-30"
"47184","2024","COM","2022","255","7","262","2024-12-30"
"47185","2024","COM","2022","2667","47","2714","2024-12-30"
"47186","2024","COM","2022","744","11","755","2024-12-30"
"47187","2024","COM","2022","324","2","326","2024-12-30"
"47188","2024","COM","2022","286","3","289","2024-12-30"
"47189","2024","COM","2022","139","2","141","2024-12-30"
"47190","2024","COM","2022","562","20","582","2024-12-30"
"47191","2024","COM","2022","817","21","838","2024-12-30"
"47192","2024","COM","2022","77","1","78","2024-12-30"
"47193","2024","COM","2022","197","6","203","2024-12-30"
"47194","2024","COM","2022","318","7","325","2024-12-30"
"47195","2024","COM","2022","6937","426","7363","2024-12-30"
"47196","2024","COM","2022","239","0","239","2024-12-30"
"47197","2024","COM","2022","252","0","252","2024-12-30"
"47198","2024","COM","2022","314","5","319","2024-12-30"
"47199","2024","COM","2022","334","12","346","2024-12-30"
"47200","2024","COM","2022","115","1","116","2024-12-30"
"47201","2024","COM","2022","9360","168","9528","2024-12-30"
"47202","2024","COM","2022","307","7","314","2024-12-30"
"47203","2024","COM","2022","2495","39","2534","2024-12-30"
"47204","2024","COM","2022","290","4","294","2024-12-30"
"47205","2024","COM","2022","190","8","198","2024-12-30"
"47206","2024","COM","2022","572","6","578","2024-12-30"
"47207","2024","COM","2022","213","2","215","2024-12-30"
"47208","2024","COM","2022","195","6","201","2024-12-30"
"47209","2024","COM","2022","4192","120","4312","2024-12-30"
"47210","2024","COM","2022","1846","30","1876","2024-12-30"
"47211","2024","COM","2022","200","7","207","2024-12-30"
"47212","2024","COM","2022","307","6","313","2024-12-30"
"47213","2024","COM","2022","995","25","1020","2024-12-30"
"47214","2024","COM","2022","713","16","729","2024-12-30"
"47215","2024","COM","2022","3776","117","3893","2024-12-30"
"47216","2024","COM","2022","707","12","719","2024-12-30"
"47217","2024","COM","2022","903","15","918","2024-12-30"
"47218","2024","COM","2022","256","9","265","2024-12-30"
"47219","2024","COM","2022","174","3","177","2024-12-30"
"47220","2024","COM","2022","300","7","307","2024-12-30"
"47221","2024","COM","2022","594","12","606","2024-12-30"
"47222","2024","COM","2022","515","9","524","2024-12-30"
"47223","2024","COM","2022","195","6","201","2024-12-30"
"47224","2024","COM","2022","158","6","164","2024-12-30"
"47225","2024","COM","2022","2091","41","2132","2024-12-30"
"47226","2024","COM","2022","529","11","540","2024-12-30"
"47227","2024","COM","2022","180","6","186","2024-12-30"
"47228","2024","COM","2022","714","10","724","2024-12-30"
"47229","2024","COM","2022","213","3","216","2024-12-30"
"47230","2024","COM","2022","389","8","397","2024-12-30"
"47231","2024","COM","2022","183","3","186","2024-12-30"
"47232","2024","COM","2022","530","3","533","2024-12-30"
"47233","2024","COM","2022","3183","97","3280","2024-12-30"
"47234","2024","COM","2022","703","19","722","2024-12-30"
"47235","2024","COM","2022","474","8","482","2024-12-30"
"47236","2024","COM","2022","100","2","102","2024-12-30"
"47237","2024","COM","2022","498","6","504","2024-12-30"
"47238","2024","COM","2022","1552","53","1605","2024-12-30"
"47239","2024","COM","2022","862","13","875","2024-12-30"
"47240","2024","COM","2022","266","10","276","2024-12-30"
"47241","2024","COM","2022","683","6","689","2024-12-30"
"47242","2024","COM","2022","501","8","509","2024-12-30"
"47244","2024","COM","2022","383","4","387","2024-12-30"
"47245","2024","COM","2022","86","2","88","2024-12-30"
"47246","2024","COM","2022","1509","40","1549","2024-12-30"
"47247","2024","COM","2022","255","6","261","2024-12-30"
"47248","2024","COM","2022","560","10","570","2024-12-30"
"47249","2024","COM","2022","459","8","467","2024-12-30"
"47250","2024","COM","2022","157","3","160","2024-12-30"
"47251","2024","COM","2022","326","4","330","2024-12-30"
"47252","2024","COM","2022","6518","160","6678","2024-12-30"
"47253","2024","COM","2022","657","13","670","2024-12-30"
"47254","2024","COM","2022","305","7","312","2024-12-30"
"47255","2024","COM","2022","156","2","158","2024-12-30"
"47256","2024","COM","2022","105","4","109","2024-12-30"
"47257","2024","COM","2022","624","14","638","2024-12-30"
"47258","2024","COM","2022","305","12","317","2024-12-30"
"47259","2024","COM","2022","107","2","109","2024-12-30"
"47260","2024","COM","2022","383","5","388","2024-12-30"
"47262","2024","COM","2022","425","5","430","2024-12-30"
"47263","2024","COM","2022","618","13","631","2024-12-30"
"47264","2024","COM","2022","1101","20","1121","2024-12-30"
"47265","2024","COM","2022","377","3","380","2024-12-30"
"47266","2024","COM","2022","185","2","187","2024-12-30"
"47267","2024","COM","2022","276","2","278","2024-12-30"
"47269","2024","COM","2022","871","19","890","2024-12-30"
"47271","2024","COM","2022","358","5","363","2024-12-30"
"47272","2024","COM","2022","185","8","193","2024-12-30"
"47273","2024","COM","2022","192","6","198","2024-12-30"
"47274","2024","COM","2022","401","3","404","2024-12-30"
"47275","2024","COM","2022","200","1","201","2024-12-30"
"47276","2024","COM","2022","292","3","295","2024-12-30"
"47277","2024","COM","2022","344","1","345","2024-12-30"
"47278","2024","COM","2022","483","10","493","2024-12-30"
"47279","2024","COM","2022","356","5","361","2024-12-30"
"47280","2024","COM","2022","2388","37","2425","2024-12-30"
"47281","2024","COM","2022","245","4","249","2024-12-30"
"47282","2024","COM","2022","226","11","237","2024-12-30"
"47283","2024","COM","2022","1187","26","1213","2024-12-30"
"47284","2024","COM","2022","287","5","292","2024-12-30"
"47285","2024","COM","2022","855","12","867","2024-12-30"
"47286","2024","COM","2022","87","4","91","2024-12-30"
"47287","2024","COM","2022","242","8","250","2024-12-30"
"47288","2024","COM","2022","525","12","537","2024-12-30"
"47289","2024","COM","2022","482","7","489","2024-12-30"
"47290","2024","COM","2022","565","5","570","2024-12-30"
"47291","2024","COM","2022","638","16","654","2024-12-30"
"47292","2024","COM","2022","569","6","575","2024-12-30"
"47293","2024","COM","2022","385","8","393","2024-12-30"
"47294","2024","COM","2022","214","1","215","2024-12-30"
"47295","2024","COM","2022","317","2","319","2024-12-30"
"47296","2024","COM","2022","156","2","158","2024-12-30"
"47297","2024","COM","2022","142","3","145","2024-12-30"
"47298","2024","COM","2022","199","0","199","2024-12-30"
"47299","2024","COM","2022","176","2","178","2024-12-30"
"47300","2024","COM","2022","1178","22","1200","2024-12-30"
"47301","2024","COM","2022","1057","15","1072","2024-12-30"
"47302","2024","COM","2022","659","8","667","2024-12-30"
"47303","2024","COM","2022","224","3","227","2024-12-30"
"47304","2024","COM","2022","65","1","66","2024-12-30"
"47305","2024","COM","2022","380","8","388","2024-12-30"
"47306","2024","COM","2022","1112","20","1132","2024-12-30"
"47307","2024","COM","2022","209","5","214","2024-12-30"
"47308","2024","COM","2022","225","1","226","2024-12-30"
"47309","2024","COM","2022","448","8","456","2024-12-30"
"47310","2024","COM","2022","9461","164","9625","2024-12-30"
"47311","2024","COM","2022","140","2","142","2024-12-30"
"47312","2024","COM","2022","742","11","753","2024-12-30"
"47313","2024","COM","2022","140","1","141","2024-12-30"
"47314","2024","COM","2022","404","6","410","2024-12-30"
"47315","2024","COM","2022","866","14","880","2024-12-30"
"47316","2024","COM","2022","658","7","665","2024-12-30"
"47317","2024","COM","2022","544","5","549","2024-12-30"
"47318","2024","COM","2022","980","14","994","2024-12-30"
"47319","2024","COM","2022","109","2","111","2024-12-30"
"47320","2024","COM","2022","411","5","416","2024-12-30"
"47321","2024","COM","2022","321","6","327","2024-12-30"
"47323","2024","COM","2022","22004","736","22740","2024-12-30"
"47324","2024","COM","2022","1265","32","1297","2024-12-30"
"47325","2024","COM","2022","474","5","479","2024-12-30"
"47326","2024","COM","2022","1696","38","1734","2024-12-30"
"47327","2024","COM","2022","378","11","389","2024-12-30"
"47328","2024","COM","2022","510","9","519","2024-12-30"
"48001","2024","COM","2022","139","1","140","2024-12-30"
"48002","2024","COM","2022","557","17","574","2024-12-30"
"48003","2024","COM","2022","264","10","274","2024-12-30"
"48004","2024","COM","2022","216","6","222","2024-12-30"
"48005","2024","COM","2022","330","5","335","2024-12-30"
"48007","2024","COM","2022","51","0","51","2024-12-30"
"48008","2024","COM","2022","189","5","194","2024-12-30"
"48009","2024","COM","2022","2304","113","2417","2024-12-30"
"48010","2024","COM","2022","365","6","371","2024-12-30"
"48012","2024","COM","2022","315","8","323","2024-12-30"
"48013","2024","COM","2022","960","42","1002","2024-12-30"
"48015","2024","COM","2022","197","2","199","2024-12-30"
"48016","2024","COM","2022","587","15","602","2024-12-30"
"48017","2024","COM","2022","1069","37","1106","2024-12-30"
"48018","2024","COM","2022","791","18","809","2024-12-30"
"48019","2024","COM","2022","200","7","207","2024-12-30"
"48020","2024","COM","2022","63","0","63","2024-12-30"
"48021","2024","COM","2022","178","5","183","2024-12-30"
"48025","2024","COM","2022","424","21","445","2024-12-30"
"48026","2024","COM","2022","257","7","264","2024-12-30"
"48027","2024","COM","2022","1107","28","1135","2024-12-30"
"48028","2024","COM","2022","141","7","148","2024-12-30"
"48029","2024","COM","2022","156","3","159","2024-12-30"
"48030","2024","COM","2022","388","8","396","2024-12-30"
"48031","2024","COM","2022","86","4","90","2024-12-30"
"48032","2024","COM","2022","221","6","227","2024-12-30"
"48034","2024","COM","2022","2095","94","2189","2024-12-30"
"48036","2024","COM","2022","125","2","127","2024-12-30"
"48037","2024","COM","2022","122","4","126","2024-12-30"
"48038","2024","COM","2022","540","8","548","2024-12-30"
"48039","2024","COM","2022","1421","43","1464","2024-12-30"
"48041","2024","COM","2022","78","2","80","2024-12-30"
"48042","2024","COM","2022","932","36","968","2024-12-30"
"48043","2024","COM","2022","518","7","525","2024-12-30"
"48044","2024","COM","2022","80","3","83","2024-12-30"
"48045","2024","COM","2022","288","8","296","2024-12-30"
"48046","2024","COM","2022","59","3","62","2024-12-30"
"48048","2024","COM","2022","64","1","65","2024-12-30"
"48050","2024","COM","2022","448","12","460","2024-12-30"
"48051","2024","COM","2022","678","48","726","2024-12-30"
"48053","2024","COM","2022","189","10","199","2024-12-30"
"48054","2024","COM","2022","45","5","50","2024-12-30"
"48055","2024","COM","2022","197","4","201","2024-12-30"
"48056","2024","COM","2022","428","10","438","2024-12-30"
"48058","2024","COM","2022","133","3","136","2024-12-30"
"48059","2024","COM","2022","303","7","310","2024-12-30"
"48061","2024","COM","2022","2111","52","2163","2024-12-30"
"48063","2024","COM","2022","227","8","235","2024-12-30"
"48064","2024","COM","2022","369","7","376","2024-12-30"
"48065","2024","COM","2022","82","1","83","2024-12-30"
"48067","2024","COM","2022","102","2","104","2024-12-30"
"48068","2024","COM","2022","159","2","161","2024-12-30"
"48069","2024","COM","2022","52","0","52","2024-12-30"
"48070","2024","COM","2022","742","22","764","2024-12-30"
"48071","2024","COM","2022","59","1","60","2024-12-30"
"48072","2024","COM","2022","209","10","219","2024-12-30"
"48073","2024","COM","2022","103","2","105","2024-12-30"
"48074","2024","COM","2022","232","5","237","2024-12-30"
"48075","2024","COM","2022","897","27","924","2024-12-30"
"48077","2024","COM","2022","48","1","49","2024-12-30"
"48079","2024","COM","2022","117","2","119","2024-12-30"
"48080","2024","COM","2022","2860","195","3055","2024-12-30"
"48081","2024","COM","2022","370","9","379","2024-12-30"
"48082","2024","COM","2022","102","3","105","2024-12-30"
"48083","2024","COM","2022","151","4","155","2024-12-30"
"48085","2024","COM","2022","103","0","103","2024-12-30"
"48086","2024","COM","2022","207","5","212","2024-12-30"
"48087","2024","COM","2022","250","8","258","2024-12-30"
"48088","2024","COM","2022","131","7","138","2024-12-30"
"48089","2024","COM","2022","491","21","512","2024-12-30"
"48090","2024","COM","2022","743","19","762","2024-12-30"
"48091","2024","COM","2022","45","4","49","2024-12-30"
"48092","2024","COM","2022","4752","222","4974","2024-12-30"
"48094","2024","COM","2022","936","28","964","2024-12-30"
"48095","2024","COM","2022","12322","799","13121","2024-12-30"
"48096","2024","COM","2022","778","114","892","2024-12-30"
"48097","2024","COM","2022","217","6","223","2024-12-30"
"48098","2024","COM","2022","97","5","102","2024-12-30"
"48099","2024","COM","2022","2077","45","2122","2024-12-30"
"48100","2024","COM","2022","147","0","147","2024-12-30"
"48103","2024","COM","2022","1168","75","1243","2024-12-30"
"48104","2024","COM","2022","576","33","609","2024-12-30"
"48105","2024","COM","2022","368","16","384","2024-12-30"
"48106","2024","COM","2022","95","7","102","2024-12-30"
"48107","2024","COM","2022","192","5","197","2024-12-30"
"48108","2024","COM","2022","86","0","86","2024-12-30"
"48110","2024","COM","2022","92","2","94","2024-12-30"
"48111","2024","COM","2022","229","2","231","2024-12-30"
"48112","2024","COM","2022","160","3","163","2024-12-30"
"48115","2024","COM","2022","182","3","185","2024-12-30"
"48116","2024","COM","2022","537","16","553","2024-12-30"
"48117","2024","COM","2022","128","4","132","2024-12-30"
"48119","2024","COM","2022","270","6","276","2024-12-30"
"48121","2024","COM","2022","226","11","237","2024-12-30"
"48123","2024","COM","2022","164","5","169","2024-12-30"
"48124","2024","COM","2022","99","3","102","2024-12-30"
"48126","2024","COM","2022","375","10","385","2024-12-30"
"48127","2024","COM","2022","1209","23","1232","2024-12-30"
"48128","2024","COM","2022","614","17","631","2024-12-30"
"48129","2024","COM","2022","242","8","250","2024-12-30"
"48130","2024","COM","2022","119","3","122","2024-12-30"
"48131","2024","COM","2022","128","6","134","2024-12-30"
"48132","2024","COM","2022","1378","37","1415","2024-12-30"
"48135","2024","COM","2022","205","2","207","2024-12-30"
"48136","2024","COM","2022","163","2","165","2024-12-30"
"48137","2024","COM","2022","590","20","610","2024-12-30"
"48138","2024","COM","2022","72","1","73","2024-12-30"
"48139","2024","COM","2022","258","1","259","2024-12-30"
"48140","2024","COM","2022","4025","555","4580","2024-12-30"
"48141","2024","COM","2022","102","6","108","2024-12-30"
"48144","2024","COM","2022","305","5","310","2024-12-30"
"48145","2024","COM","2022","142","8","150","2024-12-30"
"48146","2024","COM","2022","901","36","937","2024-12-30"
"48147","2024","COM","2022","641","46","687","2024-12-30"
"48148","2024","COM","2022","494","23","517","2024-12-30"
"48149","2024","COM","2022","36","1","37","2024-12-30"
"48150","2024","COM","2022","185","13","198","2024-12-30"
"48151","2024","COM","2022","61","3","64","2024-12-30"
"48152","2024","COM","2022","258","5","263","2024-12-30"
"48153","2024","COM","2022","89","3","92","2024-12-30"
"48155","2024","COM","2022","477","9","486","2024-12-30"
"48156","2024","COM","2022","860","22","882","2024-12-30"
"48157","2024","COM","2022","97","2","99","2024-12-30"
"48158","2024","COM","2022","101","3","104","2024-12-30"
"48160","2024","COM","2022","126","5","131","2024-12-30"
"48161","2024","COM","2022","54","2","56","2024-12-30"
"48163","2024","COM","2022","119","3","122","2024-12-30"
"48165","2024","COM","2022","191","5","196","2024-12-30"
"48166","2024","COM","2022","288","13","301","2024-12-30"
"48167","2024","COM","2022","34","2","36","2024-12-30"
"48168","2024","COM","2022","188","2","190","2024-12-30"
"48169","2024","COM","2022","211","10","221","2024-12-30"
"48170","2024","COM","2022","194","6","200","2024-12-30"
"48171","2024","COM","2022","192","2","194","2024-12-30"
"48173","2024","COM","2022","227","4","231","2024-12-30"
"48174","2024","COM","2022","134","2","136","2024-12-30"
"48175","2024","COM","2022","174","11","185","2024-12-30"
"48176","2024","COM","2022","96","3","99","2024-12-30"
"48177","2024","COM","2022","314","12","326","2024-12-30"
"48178","2024","COM","2022","248","3","251","2024-12-30"
"48179","2024","COM","2022","113","5","118","2024-12-30"
"48181","2024","COM","2022","58","3","61","2024-12-30"
"48182","2024","COM","2022","60","0","60","2024-12-30"
"48185","2024","COM","2022","166","5","171","2024-12-30"
"48187","2024","COM","2022","90","0","90","2024-12-30"
"48188","2024","COM","2022","249","4","253","2024-12-30"
"48190","2024","COM","2022","219","2","221","2024-12-30"
"48191","2024","COM","2022","95","3","98","2024-12-30"
"48192","2024","COM","2022","89","1","90","2024-12-30"
"48193","2024","COM","2022","225","0","225","2024-12-30"
"48194","2024","COM","2022","447","32","479","2024-12-30"
"48198","2024","COM","2022","617","18","635","2024-12-30"
"49002","2024","COM","2022","2925","48","2973","2024-12-30"
"49003","2024","COM","2022","1734","36","1770","2024-12-30"
"49007","2024","COM","2022","157555","3275","160830","2024-12-30"
"49008","2024","COM","2022","917","25","942","2024-12-30"
"49009","2024","COM","2022","450","11","461","2024-12-30"
"49010","2024","COM","2022","317","4","321","2024-12-30"
"49011","2024","COM","2022","410","7","417","2024-12-30"
"49012","2024","COM","2022","349","7","356","2024-12-30"
"49015","2024","COM","2022","15225","412","15637","2024-12-30"
"49017","2024","COM","2022","629","5","634","2024-12-30"
"49018","2024","COM","2022","11747","237","11984","2024-12-30"
"49020","2024","COM","2022","5618","112","5730","2024-12-30"
"49021","2024","COM","2022","6893","156","7049","2024-12-30"
"49022","2024","COM","2022","1346","20","1366","2024-12-30"
"49023","2024","COM","2022","23887","728","24615","2024-12-30"
"49026","2024","COM","2022","2781","91","2872","2024-12-30"
"49027","2024","COM","2022","2115","49","2164","2024-12-30"
"49028","2024","COM","2022","119","2","121","2024-12-30"
"49029","2024","COM","2022","1317","29","1346","2024-12-30"
"49030","2024","COM","2022","938","32","970","2024-12-30"
"49035","2024","COM","2022","6635","141","6776","2024-12-30"
"49036","2024","COM","2022","775","10","785","2024-12-30"
"49038","2024","COM","2022","236","4","240","2024-12-30"
"49041","2024","COM","2022","2078","37","2115","2024-12-30"
"49045","2024","COM","2022","617","12","629","2024-12-30"
"49048","2024","COM","2022","3193","53","3246","2024-12-30"
"49050","2024","COM","2022","11000","262","11262","2024-12-30"
"49053","2024","COM","2022","348","4","352","2024-12-30"
"49054","2024","COM","2022","2815","47","2862","2024-12-30"
"49055","2024","COM","2022","2397","31","2428","2024-12-30"
"49056","2024","COM","2022","276","3","279","2024-12-30"
"49057","2024","COM","2022","329","6","335","2024-12-30"
"49058","2024","COM","2022","892","15","907","2024-12-30"
"49060","2024","COM","2022","3450","56","3506","2024-12-30"
"49061","2024","COM","2022","811","14","825","2024-12-30"
"49063","2024","COM","2022","6541","175","6716","2024-12-30"
"49064","2024","COM","2022","409","12","421","2024-12-30"
"49067","2024","COM","2022","341","6","347","2024-12-30"
"49068","2024","COM","2022","1837","25","1862","2024-12-30"
"49069","2024","COM","2022","16975","324","17299","2024-12-30"
"49070","2024","COM","2022","712","22","734","2024-12-30"
"49076","2024","COM","2022","820","12","832","2024-12-30"
"49080","2024","COM","2022","8712","153","8865","2024-12-30"
"49082","2024","COM","2022","941","25","966","2024-12-30"
"49086","2024","COM","2022","3885","66","3951","2024-12-30"
"49089","2024","COM","2022","1067","14","1081","2024-12-30"
"49090","2024","COM","2022","1036","8","1044","2024-12-30"
"49092","2024","COM","2022","21550","613","22163","2024-12-30"
"49099","2024","COM","2022","54074","1945","56019","2024-12-30"
"49100","2024","COM","2022","473","18","491","2024-12-30"
"49102","2024","COM","2022","345","2","347","2024-12-30"
"49107","2024","COM","2022","481","10","491","2024-12-30"
"49109","2024","COM","2022","1575","30","1605","2024-12-30"
"49110","2024","COM","2022","1982","33","2015","2024-12-30"
"49112","2024","COM","2022","935","32","967","2024-12-30"
"49113","2024","COM","2022","530","10","540","2024-12-30"
"49114","2024","COM","2022","140","4","144","2024-12-30"
"49120","2024","COM","2022","1448","27","1475","2024-12-30"
"49121","2024","COM","2022","442","8","450","2024-12-30"
"49123","2024","COM","2022","1812","54","1866","2024-12-30"
"49125","2024","COM","2022","11227","228","11455","2024-12-30"
"49127","2024","COM","2022","3376","74","3450","2024-12-30"
"49129","2024","COM","2022","4614","72","4686","2024-12-30"
"49130","2024","COM","2022","661","20","681","2024-12-30"
"49131","2024","COM","2022","719","6","725","2024-12-30"
"49132","2024","COM","2022","1567","26","1593","2024-12-30"
"49135","2024","COM","2022","2216","51","2267","2024-12-30"
"49138","2024","COM","2022","2531","54","2585","2024-12-30"
"49140","2024","COM","2022","1477","18","1495","2024-12-30"
"49155","2024","COM","2022","1437","30","1467","2024-12-30"
"49160","2024","COM","2022","3069","61","3130","2024-12-30"
"49161","2024","COM","2022","343","6","349","2024-12-30"
"49163","2024","COM","2022","2792","40","2832","2024-12-30"
"49167","2024","COM","2022","4670","111","4781","2024-12-30"
"49170","2024","COM","2022","828","11","839","2024-12-30"
"49171","2024","COM","2022","119","2","121","2024-12-30"
"49174","2024","COM","2022","1304","24","1328","2024-12-30"
"49176","2024","COM","2022","5343","76","5419","2024-12-30"
"49178","2024","COM","2022","884","21","905","2024-12-30"
"49180","2024","COM","2022","6583","104","6687","2024-12-30"
"49182","2024","COM","2022","895","18","913","2024-12-30"
"49183","2024","COM","2022","4967","81","5048","2024-12-30"
"49188","2024","COM","2022","846","26","872","2024-12-30"
"49192","2024","COM","2022","3206","80","3286","2024-12-30"
"49193","2024","COM","2022","3878","92","3970","2024-12-30"
"49194","2024","COM","2022","5770","91","5861","2024-12-30"
"49195","2024","COM","2022","1257","30","1287","2024-12-30"
"49200","2024","COM","2022","6453","134","6587","2024-12-30"
"49201","2024","COM","2022","2057","42","2099","2024-12-30"
"49205","2024","COM","2022","1050","9","1059","2024-12-30"
"49209","2024","COM","2022","433","8","441","2024-12-30"
"49211","2024","COM","2022","1229","20","1249","2024-12-30"
"49214","2024","COM","2022","7811","108","7919","2024-12-30"
"49215","2024","COM","2022","3716","231","3947","2024-12-30"
"49216","2024","COM","2022","565","9","574","2024-12-30"
"49217","2024","COM","2022","792","7","799","2024-12-30"
"49218","2024","COM","2022","15684","318","16002","2024-12-30"
"49219","2024","COM","2022","416","6","422","2024-12-30"
"49220","2024","COM","2022","3694","45","3739","2024-12-30"
"49221","2024","COM","2022","800","22","822","2024-12-30"
"49222","2024","COM","2022","2033","44","2077","2024-12-30"
"49223","2024","COM","2022","6172","94","6266","2024-12-30"
"49224","2024","COM","2022","1011","13","1024","2024-12-30"
"49228","2024","COM","2022","5473","106","5579","2024-12-30"
"49231","2024","COM","2022","1454","46","1500","2024-12-30"
"49235","2024","COM","2022","377","7","384","2024-12-30"
"49236","2024","COM","2022","128","2","130","2024-12-30"
"49237","2024","COM","2022","137","3","140","2024-12-30"
"49240","2024","COM","2022","1016","12","1028","2024-12-30"
"49241","2024","COM","2022","2649","52","2701","2024-12-30"
"49244","2024","COM","2022","18514","469","18983","2024-12-30"
"49246","2024","COM","2022","12863","552","13415","2024-12-30"
"49247","2024","COM","2022","2478","58","2536","2024-12-30"
"49248","2024","COM","2022","8811","193","9004","2024-12-30"
"49253","2024","COM","2022","1089","23","1112","2024-12-30"
"49257","2024","COM","2022","1043","13","1056","2024-12-30"
"49259","2024","COM","2022","2332","58","2390","2024-12-30"
"49260","2024","COM","2022","2012","83","2095","2024-12-30"
"49261","2024","COM","2022","8452","165","8617","2024-12-30"
"49262","2024","COM","2022","644","24","668","2024-12-30"
"49266","2024","COM","2022","1283","14","1297","2024-12-30"
"49267","2024","COM","2022","9496","231","9727","2024-12-30"
"49269","2024","COM","2022","2843","63","2906","2024-12-30"
"49271","2024","COM","2022","2139","41","2180","2024-12-30"
"49272","2024","COM","2022","1127","16","1143","2024-12-30"
"49278","2024","COM","2022","3617","243","3860","2024-12-30"
"49283","2024","COM","2022","3787","54","3841","2024-12-30"
"49284","2024","COM","2022","1396","25","1421","2024-12-30"
"49288","2024","COM","2022","225","5","230","2024-12-30"
"49291","2024","COM","2022","386","6","392","2024-12-30"
"49292","2024","COM","2022","3508","48","3556","2024-12-30"
"49294","2024","COM","2022","2961","51","3012","2024-12-30"
"49298","2024","COM","2022","3860","66","3926","2024-12-30"
"49299","2024","COM","2022","3099","71","3170","2024-12-30"
"49301","2024","COM","2022","25764","662","26426","2024-12-30"
"49302","2024","COM","2022","442","8","450","2024-12-30"
"49306","2024","COM","2022","1693","43","1736","2024-12-30"
"49307","2024","COM","2022","16588","583","17171","2024-12-30"
"49308","2024","COM","2022","2209","57","2266","2024-12-30"
"49310","2024","COM","2022","600","19","619","2024-12-30"
"49311","2024","COM","2022","1319","25","1344","2024-12-30"
"49323","2024","COM","2022","7946","303","8249","2024-12-30"
"49326","2024","COM","2022","891","15","906","2024-12-30"
"49328","2024","COM","2022","26074","883","26957","2024-12-30"
"49329","2024","COM","2022","1351","49","1400","2024-12-30"
"49330","2024","COM","2022","1161","16","1177","2024-12-30"
"49331","2024","COM","2022","17617","740","18357","2024-12-30"
"49332","2024","COM","2022","4199","116","4315","2024-12-30"
"49333","2024","COM","2022","2853","57","2910","2024-12-30"
"49334","2024","COM","2022","341","5","346","2024-12-30"
"49336","2024","COM","2022","875","21","896","2024-12-30"
"49338","2024","COM","2022","1344","20","1364","2024-12-30"
"49339","2024","COM","2022","1477","37","1514","2024-12-30"
"49341","2024","COM","2022","691","15","706","2024-12-30"
"49343","2024","COM","2022","3178","69","3247","2024-12-30"
"49344","2024","COM","2022","1238","27","1265","2024-12-30"
"49345","2024","COM","2022","5874","123","5997","2024-12-30"
"49347","2024","COM","2022","4498","72","4570","2024-12-30"
"49352","2024","COM","2022","1316","34","1350","2024-12-30"
"49353","2024","COM","2022","15620","195","15815","2024-12-30"
"49355","2024","COM","2022","3078","80","3158","2024-12-30"
"49358","2024","COM","2022","569","9","578","2024-12-30"
"49359","2024","COM","2022","553","15","568","2024-12-30"
"49361","2024","COM","2022","1924","30","1954","2024-12-30"
"49362","2024","COM","2022","1282","31","1313","2024-12-30"
"49364","2024","COM","2022","1122","16","1138","2024-12-30"
"49367","2024","COM","2022","5784","80","5864","2024-12-30"
"49368","2024","COM","2022","2006","34","2040","2024-12-30"
"49369","2024","COM","2022","1330","16","1346","2024-12-30"
"49370","2024","COM","2022","459","9","468","2024-12-30"
"49371","2024","COM","2022","1750","26","1776","2024-12-30"
"49373","2024","COM","2022","7722","168","7890","2024-12-30"
"49374","2024","COM","2022","1462","31","1493","2024-12-30"
"49377","2024","COM","2022","5642","101","5743","2024-12-30"
"49378","2024","COM","2022","2599","33","2632","2024-12-30"
"49381","2024","COM","2022","1829","33","1862","2024-12-30"
"50002","2024","COM","2022","4266","428","4694","2024-12-30"
"50003","2024","COM","2022","3013","63","3076","2024-12-30"
"50004","2024","COM","2022","527","7","534","2024-12-30"
"50006","2024","COM","2022","153","5","158","2024-12-30"
"50008","2024","COM","2022","438","21","459","2024-12-30"
"50013","2024","COM","2022","376","8","384","2024-12-30"
"50016","2024","COM","2022","193","2","195","2024-12-30"
"50019","2024","COM","2022","413","6","419","2024-12-30"
"50021","2024","COM","2022","76","1","77","2024-12-30"
"50022","2024","COM","2022","125","2","127","2024-12-30"
"50023","2024","COM","2022","689","18","707","2024-12-30"
"50024","2024","COM","2022","173","4","177","2024-12-30"
"50025","2024","COM","2022","10225","503","10728","2024-12-30"
"50026","2024","COM","2022","77","2","79","2024-12-30"
"50027","2024","COM","2022","935","25","960","2024-12-30"
"50028","2024","COM","2022","106","3","109","2024-12-30"
"50029","2024","COM","2022","1166","31","1197","2024-12-30"
"50030","2024","COM","2022","545","10","555","2024-12-30"
"50031","2024","COM","2022","2181","51","2232","2024-12-30"
"50032","2024","COM","2022","1033","31","1064","2024-12-30"
"50033","2024","COM","2022","134","4","138","2024-12-30"
"50034","2024","COM","2022","595","18","613","2024-12-30"
"50036","2024","COM","2022","428","11","439","2024-12-30"
"50038","2024","COM","2022","438","13","451","2024-12-30"
"50039","2024","COM","2022","136","3","139","2024-12-30"
"50040","2024","COM","2022","119","1","120","2024-12-30"
"50041","2024","COM","2022","11444","284","11728","2024-12-30"
"50042","2024","COM","2022","435","6","441","2024-12-30"
"50044","2024","COM","2022","334","10","344","2024-12-30"
"50045","2024","COM","2022","612","23","635","2024-12-30"
"50046","2024","COM","2022","442","8","450","2024-12-30"
"50048","2024","COM","2022","550","9","559","2024-12-30"
"50049","2024","COM","2022","662","17","679","2024-12-30"
"50050","2024","COM","2022","130","5","135","2024-12-30"
"50052","2024","COM","2022","147","2","149","2024-12-30"
"50054","2024","COM","2022","196","4","200","2024-12-30"
"50055","2024","COM","2022","116","0","116","2024-12-30"
"50058","2024","COM","2022","1604","43","1647","2024-12-30"
"50059","2024","COM","2022","322","8","330","2024-12-30"
"50060","2024","COM","2022","430","7","437","2024-12-30"
"50062","2024","COM","2022","100","2","102","2024-12-30"
"50064","2024","COM","2022","176","4","180","2024-12-30"
"50066","2024","COM","2022","2401","84","2485","2024-12-30"
"50069","2024","COM","2022","343","10","353","2024-12-30"
"50070","2024","COM","2022","59","1","60","2024-12-30"
"50072","2024","COM","2022","213","9","222","2024-12-30"
"50074","2024","COM","2022","2166","130","2296","2024-12-30"
"50076","2024","COM","2022","3480","73","3553","2024-12-30"
"50077","2024","COM","2022","1006","42","1048","2024-12-30"
"50078","2024","COM","2022","436","6","442","2024-12-30"
"50079","2024","COM","2022","405","10","415","2024-12-30"
"50081","2024","COM","2022","785","29","814","2024-12-30"
"50082","2024","COM","2022","5888","93","5981","2024-12-30"
"50083","2024","COM","2022","638","11","649","2024-12-30"
"50084","2024","COM","2022","533","18","551","2024-12-30"
"50085","2024","COM","2022","1263","27","1290","2024-12-30"
"50086","2024","COM","2022","321","8","329","2024-12-30"
"50087","2024","COM","2022","2146","48","2194","2024-12-30"
"50088","2024","COM","2022","140","3","143","2024-12-30"
"50090","2024","COM","2022","612","11","623","2024-12-30"
"50092","2024","COM","2022","693","16","709","2024-12-30"
"50093","2024","COM","2022","435","7","442","2024-12-30"
"50094","2024","COM","2022","386","3","389","2024-12-30"
"50095","2024","COM","2022","1723","54","1777","2024-12-30"
"50096","2024","COM","2022","216","6","222","2024-12-30"
"50097","2024","COM","2022","119","2","121","2024-12-30"
"50098","2024","COM","2022","619","16","635","2024-12-30"
"50099","2024","COM","2022","10220","155","10375","2024-12-30"
"50101","2024","COM","2022","240","5","245","2024-12-30"
"50102","2024","COM","2022","768","16","784","2024-12-30"
"50105","2024","COM","2022","103","3","106","2024-12-30"
"50106","2024","COM","2022","268","6","274","2024-12-30"
"50108","2024","COM","2022","413","10","423","2024-12-30"
"50109","2024","COM","2022","1806","26","1832","2024-12-30"
"50110","2024","COM","2022","1014","18","1032","2024-12-30"
"50111","2024","COM","2022","1026","17","1043","2024-12-30"
"50112","2024","COM","2022","443","3","446","2024-12-30"
"50115","2024","COM","2022","390","5","395","2024-12-30"
"50117","2024","COM","2022","341","11","352","2024-12-30"
"50118","2024","COM","2022","322","5","327","2024-12-30"
"50120","2024","COM","2022","393","4","397","2024-12-30"
"50121","2024","COM","2022","244","5","249","2024-12-30"
"50124","2024","COM","2022","171","3","174","2024-12-30"
"50126","2024","COM","2022","130","11","141","2024-12-30"
"50129","2024","COM","2022","78028","2114","80142","2024-12-30"
"50130","2024","COM","2022","438","10","448","2024-12-30"
"50135","2024","COM","2022","228","4","232","2024-12-30"
"50137","2024","COM","2022","627","10","637","2024-12-30"
"50138","2024","COM","2022","566","8","574","2024-12-30"
"50139","2024","COM","2022","4136","135","4271","2024-12-30"
"50142","2024","COM","2022","1083","17","1100","2024-12-30"
"50143","2024","COM","2022","873","30","903","2024-12-30"
"50144","2024","COM","2022","529","4","533","2024-12-30"
"50145","2024","COM","2022","623","20","643","2024-12-30"
"50146","2024","COM","2022","219","4","223","2024-12-30"
"50147","2024","COM","2022","8372","1170","9542","2024-12-30"
"50148","2024","COM","2022","577","4","581","2024-12-30"
"50149","2024","COM","2022","1228","18","1246","2024-12-30"
"50150","2024","COM","2022","223","2","225","2024-12-30"
"50151","2024","COM","2022","2079","33","2112","2024-12-30"
"50152","2024","COM","2022","230","4","234","2024-12-30"
"50155","2024","COM","2022","298","11","309","2024-12-30"
"50156","2024","COM","2022","62","0","62","2024-12-30"
"50158","2024","COM","2022","263","3","266","2024-12-30"
"50159","2024","COM","2022","660","7","667","2024-12-30"
"50161","2024","COM","2022","605","3","608","2024-12-30"
"50162","2024","COM","2022","1665","42","1707","2024-12-30"
"50164","2024","COM","2022","998","18","1016","2024-12-30"
"50165","2024","COM","2022","3133","72","3205","2024-12-30"
"50166","2024","COM","2022","326","15","341","2024-12-30"
"50167","2024","COM","2022","789","20","809","2024-12-30"
"50168","2024","COM","2022","2829","60","2889","2024-12-30"
"50169","2024","COM","2022","112","2","114","2024-12-30"
"50172","2024","COM","2022","342","8","350","2024-12-30"
"50174","2024","COM","2022","194","6","200","2024-12-30"
"50175","2024","COM","2022","180","7","187","2024-12-30"
"50176","2024","COM","2022","344","15","359","2024-12-30"
"50177","2024","COM","2022","376","3","379","2024-12-30"
"50178","2024","COM","2022","1291","32","1323","2024-12-30"
"50181","2024","COM","2022","353","15","368","2024-12-30"
"50182","2024","COM","2022","299","6","305","2024-12-30"
"50183","2024","COM","2022","349","7","356","2024-12-30"
"50184","2024","COM","2022","1682","23","1705","2024-12-30"
"50185","2024","COM","2022","1085","20","1105","2024-12-30"
"50186","2024","COM","2022","227","8","235","2024-12-30"
"50188","2024","COM","2022","1109","20","1129","2024-12-30"
"50190","2024","COM","2022","164","3","167","2024-12-30"
"50192","2024","COM","2022","131","0","131","2024-12-30"
"50193","2024","COM","2022","222","3","225","2024-12-30"
"50194","2024","COM","2022","377","7","384","2024-12-30"
"50195","2024","COM","2022","268","0","268","2024-12-30"
"50196","2024","COM","2022","468","9","477","2024-12-30"
"50197","2024","COM","2022","2028","29","2057","2024-12-30"
"50198","2024","COM","2022","498","12","510","2024-12-30"
"50199","2024","COM","2022","453","4","457","2024-12-30"
"50200","2024","COM","2022","818","16","834","2024-12-30"
"50205","2024","COM","2022","295","12","307","2024-12-30"
"50207","2024","COM","2022","165","4","169","2024-12-30"
"50208","2024","COM","2022","162","1","163","2024-12-30"
"50209","2024","COM","2022","1504","45","1549","2024-12-30"
"50210","2024","COM","2022","347","3","350","2024-12-30"
"50214","2024","COM","2022","291","4","295","2024-12-30"
"50215","2024","COM","2022","3266","73","3339","2024-12-30"
"50216","2024","COM","2022","800","94","894","2024-12-30"
"50217","2024","COM","2022","595","12","607","2024-12-30"
"50218","2024","COM","2022","12799","660","13459","2024-12-30"
"50219","2024","COM","2022","674","18","692","2024-12-30"
"50221","2024","COM","2022","70","0","70","2024-12-30"
"50222","2024","COM","2022","804","23","827","2024-12-30"
"50225","2024","COM","2022","139","3","142","2024-12-30"
"50227","2024","COM","2022","312","6","318","2024-12-30"
"50228","2024","COM","2022","1077","34","1111","2024-12-30"
"50229","2024","COM","2022","109","0","109","2024-12-30"
"50230","2024","COM","2022","924","30","954","2024-12-30"
"50231","2024","COM","2022","707","20","727","2024-12-30"
"50232","2024","COM","2022","452","14","466","2024-12-30"
"50233","2024","COM","2022","154","5","159","2024-12-30"
"50234","2024","COM","2022","67","1","68","2024-12-30"
"50235","2024","COM","2022","285","5","290","2024-12-30"
"50236","2024","COM","2022","3986","126","4112","2024-12-30"
"50237","2024","COM","2022","1261","25","1286","2024-12-30"
"50238","2024","COM","2022","462","6","468","2024-12-30"
"50239","2024","COM","2022","1781","53","1834","2024-12-30"
"50240","2024","COM","2022","563","8","571","2024-12-30"
"50241","2024","COM","2022","186","3","189","2024-12-30"
"50243","2024","COM","2022","462","16","478","2024-12-30"
"50246","2024","COM","2022","72","1","73","2024-12-30"
"50247","2024","COM","2022","194","7","201","2024-12-30"
"50251","2024","COM","2022","361","8","369","2024-12-30"
"50252","2024","COM","2022","926","17","943","2024-12-30"
"50253","2024","COM","2022","168","7","175","2024-12-30"
"50256","2024","COM","2022","3187","97","3284","2024-12-30"
"50258","2024","COM","2022","85","1","86","2024-12-30"
"50259","2024","COM","2022","664","22","686","2024-12-30"
"50260","2024","COM","2022","1678","42","1720","2024-12-30"
"50261","2024","COM","2022","167","3","170","2024-12-30"
"50262","2024","COM","2022","535","6","541","2024-12-30"
"50263","2024","COM","2022","382","10","392","2024-12-30"
"50265","2024","COM","2022","185","1","186","2024-12-30"
"50266","2024","COM","2022","463","3","466","2024-12-30"
"50267","2024","COM","2022","2255","54","2309","2024-12-30"
"50268","2024","COM","2022","244","3","247","2024-12-30"
"50269","2024","COM","2022","214","5","219","2024-12-30"
"50270","2024","COM","2022","400","12","412","2024-12-30"
"50271","2024","COM","2022","88","1","89","2024-12-30"
"50272","2024","COM","2022","1668","30","1698","2024-12-30"
"50273","2024","COM","2022","1438","24","1462","2024-12-30"
"50274","2024","COM","2022","1028","154","1182","2024-12-30"
"50275","2024","COM","2022","117","1","118","2024-12-30"
"50276","2024","COM","2022","608","23","631","2024-12-30"
"50277","2024","COM","2022","612","17","629","2024-12-30"
"50278","2024","COM","2022","262","5","267","2024-12-30"
"50279","2024","COM","2022","570","10","580","2024-12-30"
"50281","2024","COM","2022","847","15","862","2024-12-30"
"50282","2024","COM","2022","285","6","291","2024-12-30"
"50283","2024","COM","2022","81","1","82","2024-12-30"
"50285","2024","COM","2022","311","4","315","2024-12-30"
"50288","2024","COM","2022","1286","37","1323","2024-12-30"
"50289","2024","COM","2022","684","17","701","2024-12-30"
"50290","2024","COM","2022","353","10","363","2024-12-30"
"50291","2024","COM","2022","117","4","121","2024-12-30"
"50292","2024","COM","2022","2754","78","2832","2024-12-30"
"50294","2024","COM","2022","1340","38","1378","2024-12-30"
"50295","2024","COM","2022","147","3","150","2024-12-30"
"50296","2024","COM","2022","229","6","235","2024-12-30"
"50297","2024","COM","2022","998","21","1019","2024-12-30"
"50298","2024","COM","2022","648","14","662","2024-12-30"
"50299","2024","COM","2022","204","9","213","2024-12-30"
"50300","2024","COM","2022","158","7","165","2024-12-30"
"50302","2024","COM","2022","287","8","295","2024-12-30"
"50304","2024","COM","2022","195","3","198","2024-12-30"
"50305","2024","COM","2022","727","15","742","2024-12-30"
"50310","2024","COM","2022","180","1","181","2024-12-30"
"50311","2024","COM","2022","222","4","226","2024-12-30"
"50312","2024","COM","2022","142","4","146","2024-12-30"
"50315","2024","COM","2022","251","10","261","2024-12-30"
"50317","2024","COM","2022","269","6","275","2024-12-30"
"50321","2024","COM","2022","470","12","482","2024-12-30"
"50324","2024","COM","2022","108","2","110","2024-12-30"
"50326","2024","COM","2022","237","3","240","2024-12-30"
"50327","2024","COM","2022","195","6","201","2024-12-30"
"50328","2024","COM","2022","760","13","773","2024-12-30"
"50332","2024","COM","2022","730","14","744","2024-12-30"
"50334","2024","COM","2022","272","6","278","2024-12-30"
"50335","2024","COM","2022","499","10","509","2024-12-30"
"50336","2024","COM","2022","208","3","211","2024-12-30"
"50338","2024","COM","2022","325","5","330","2024-12-30"
"50340","2024","COM","2022","185","3","188","2024-12-30"
"50341","2024","COM","2022","1951","153","2104","2024-12-30"
"50342","2024","COM","2022","798","27","825","2024-12-30"
"50345","2024","COM","2022","702","20","722","2024-12-30"
"50347","2024","COM","2022","250","5","255","2024-12-30"
"50349","2024","COM","2022","1413","30","1443","2024-12-30"
"50350","2024","COM","2022","543","7","550","2024-12-30"
"50351","2024","COM","2022","79","1","80","2024-12-30"
"50352","2024","COM","2022","345","7","352","2024-12-30"
"50353","2024","COM","2022","23","1","24","2024-12-30"
"50356","2024","COM","2022","779","21","800","2024-12-30"
"50357","2024","COM","2022","70","1","71","2024-12-30"
"50359","2024","COM","2022","2954","169","3123","2024-12-30"
"50360","2024","COM","2022","278","9","287","2024-12-30"
"50361","2024","COM","2022","246","5","251","2024-12-30"
"50362","2024","COM","2022","281","7","288","2024-12-30"
"50363","2024","COM","2022","1465","33","1498","2024-12-30"
"50364","2024","COM","2022","730","12","742","2024-12-30"
"50365","2024","COM","2022","494","13","507","2024-12-30"
"50368","2024","COM","2022","68","1","69","2024-12-30"
"50369","2024","COM","2022","844","26","870","2024-12-30"
"50370","2024","COM","2022","608","3","611","2024-12-30"
"50371","2024","COM","2022","399","13","412","2024-12-30"
"50372","2024","COM","2022","174","3","177","2024-12-30"
"50373","2024","COM","2022","84","3","87","2024-12-30"
"50374","2024","COM","2022","25","0","25","2024-12-30"
"50376","2024","COM","2022","361","14","375","2024-12-30"
"50378","2024","COM","2022","631","8","639","2024-12-30"
"50379","2024","COM","2022","166","3","169","2024-12-30"
"50382","2024","COM","2022","620","15","635","2024-12-30"
"50384","2024","COM","2022","233","7","240","2024-12-30"
"50387","2024","COM","2022","349","7","356","2024-12-30"
"50388","2024","COM","2022","1222","34","1256","2024-12-30"
"50389","2024","COM","2022","447","10","457","2024-12-30"
"50390","2024","COM","2022","156","4","160","2024-12-30"
"50391","2024","COM","2022","2623","74","2697","2024-12-30"
"50393","2024","COM","2022","2628","95","2723","2024-12-30"
"50394","2024","COM","2022","2355","33","2388","2024-12-30"
"50395","2024","COM","2022","287","4","291","2024-12-30"
"50397","2024","COM","2022","207","6","213","2024-12-30"
"50398","2024","COM","2022","193","3","196","2024-12-30"
"50399","2024","COM","2022","175","2","177","2024-12-30"
"50400","2024","COM","2022","3222","43","3265","2024-12-30"
"50401","2024","COM","2022","759","15","774","2024-12-30"
"50402","2024","COM","2022","3266","87","3353","2024-12-30"
"50403","2024","COM","2022","1486","31","1517","2024-12-30"
"50405","2024","COM","2022","238","10","248","2024-12-30"
"50407","2024","COM","2022","968","37","1005","2024-12-30"
"50408","2024","COM","2022","576","15","591","2024-12-30"
"50409","2024","COM","2022","1902","190","2092","2024-12-30"
"50410","2024","COM","2022","4319","69","4388","2024-12-30"
"50411","2024","COM","2022","684","11","695","2024-12-30"
"50412","2024","COM","2022","2522","69","2591","2024-12-30"
"50413","2024","COM","2022","567","11","578","2024-12-30"
"50417","2024","COM","2022","1798","22","1820","2024-12-30"
"50419","2024","COM","2022","3181","69","3250","2024-12-30"
"50420","2024","COM","2022","842","23","865","2024-12-30"
"50421","2024","COM","2022","260","3","263","2024-12-30"
"50422","2024","COM","2022","208","3","211","2024-12-30"
"50423","2024","COM","2022","227","7","234","2024-12-30"
"50425","2024","COM","2022","1091","25","1116","2024-12-30"
"50426","2024","COM","2022","388","4","392","2024-12-30"
"50428","2024","COM","2022","537","3","540","2024-12-30"
"50429","2024","COM","2022","731","31","762","2024-12-30"
"50430","2024","COM","2022","38","1","39","2024-12-30"
"50431","2024","COM","2022","1064","11","1075","2024-12-30"
"50433","2024","COM","2022","1038","24","1062","2024-12-30"
"50435","2024","COM","2022","608","13","621","2024-12-30"
"50436","2024","COM","2022","1247","44","1291","2024-12-30"
"50437","2024","COM","2022","776","10","786","2024-12-30"
"50442","2024","COM","2022","244","4","248","2024-12-30"
"50443","2024","COM","2022","512","11","523","2024-12-30"
"50444","2024","COM","2022","2523","61","2584","2024-12-30"
"50445","2024","COM","2022","369","13","382","2024-12-30"
"50446","2024","COM","2022","553","9","562","2024-12-30"
"50447","2024","COM","2022","475","19","494","2024-12-30"
"50448","2024","COM","2022","651","17","668","2024-12-30"
"50450","2024","COM","2022","338","10","348","2024-12-30"
"50451","2024","COM","2022","136","1","137","2024-12-30"
"50452","2024","COM","2022","651","23","674","2024-12-30"
"50453","2024","COM","2022","785","18","803","2024-12-30"
"50454","2024","COM","2022","412","8","420","2024-12-30"
"50455","2024","COM","2022","973","21","994","2024-12-30"
"50456","2024","COM","2022","548","12","560","2024-12-30"
"50457","2024","COM","2022","181","5","186","2024-12-30"
"50461","2024","COM","2022","211","9","220","2024-12-30"
"50462","2024","COM","2022","349","10","359","2024-12-30"
"50463","2024","COM","2022","527","17","544","2024-12-30"
"50464","2024","COM","2022","605","6","611","2024-12-30"
"50467","2024","COM","2022","490","14","504","2024-12-30"
"50468","2024","COM","2022","749","16","765","2024-12-30"
"50469","2024","COM","2022","309","7","316","2024-12-30"
"50471","2024","COM","2022","253","4","257","2024-12-30"
"50472","2024","COM","2022","205","8","213","2024-12-30"
"50473","2024","COM","2022","378","6","384","2024-12-30"
"50474","2024","COM","2022","529","5","534","2024-12-30"
"50475","2024","COM","2022","983","19","1002","2024-12-30"
"50476","2024","COM","2022","209","7","216","2024-12-30"
"50478","2024","COM","2022","418","6","424","2024-12-30"
"50479","2024","COM","2022","109","1","110","2024-12-30"
"50480","2024","COM","2022","795","15","810","2024-12-30"
"50481","2024","COM","2022","920","18","938","2024-12-30"
"50482","2024","COM","2022","174","6","180","2024-12-30"
"50483","2024","COM","2022","987","28","1015","2024-12-30"
"50484","2024","COM","2022","5735","307","6042","2024-12-30"
"50486","2024","COM","2022","629","9","638","2024-12-30"
"50487","2024","COM","2022","4966","87","5053","2024-12-30"
"50488","2024","COM","2022","645","14","659","2024-12-30"
"50489","2024","COM","2022","538","17","555","2024-12-30"
"50490","2024","COM","2022","366","13","379","2024-12-30"
"50491","2024","COM","2022","422","11","433","2024-12-30"
"50492","2024","COM","2022","2535","53","2588","2024-12-30"
"50493","2024","COM","2022","1521","46","1567","2024-12-30"
"50495","2024","COM","2022","75","4","79","2024-12-30"
"50496","2024","COM","2022","395","8","403","2024-12-30"
"50498","2024","COM","2022","817","25","842","2024-12-30"
"50499","2024","COM","2022","499","13","512","2024-12-30"
"50500","2024","COM","2022","645","9","654","2024-12-30"
"50502","2024","COM","2022","19352","773","20125","2024-12-30"
"50504","2024","COM","2022","209","5","214","2024-12-30"
"50505","2024","COM","2022","678","34","712","2024-12-30"
"50506","2024","COM","2022","462","11","473","2024-12-30"
"50507","2024","COM","2022","353","6","359","2024-12-30"
"50509","2024","COM","2022","694","6","700","2024-12-30"
"50510","2024","COM","2022","606","10","616","2024-12-30"
"50511","2024","COM","2022","153","0","153","2024-12-30"
"50512","2024","COM","2022","536","8","544","2024-12-30"
"50513","2024","COM","2022","206","3","209","2024-12-30"
"50514","2024","COM","2022","287","6","293","2024-12-30"
"50517","2024","COM","2022","170","4","174","2024-12-30"
"50518","2024","COM","2022","312","6","318","2024-12-30"
"50519","2024","COM","2022","618","10","628","2024-12-30"
"50521","2024","COM","2022","157","4","161","2024-12-30"
"50522","2024","COM","2022","248","7","255","2024-12-30"
"50523","2024","COM","2022","2910","47","2957","2024-12-30"
"50525","2024","COM","2022","344","2","346","2024-12-30"
"50528","2024","COM","2022","299","9","308","2024-12-30"
"50529","2024","COM","2022","92","1","93","2024-12-30"
"50531","2024","COM","2022","763","29","792","2024-12-30"
"50532","2024","COM","2022","4372","98","4470","2024-12-30"
"50533","2024","COM","2022","177","2","179","2024-12-30"
"50535","2024","COM","2022","907","22","929","2024-12-30"
"50536","2024","COM","2022","169","0","169","2024-12-30"
"50537","2024","COM","2022","396","9","405","2024-12-30"
"50538","2024","COM","2022","428","11","439","2024-12-30"
"50539","2024","COM","2022","1797","28","1825","2024-12-30"
"50540","2024","COM","2022","621","10","631","2024-12-30"
"50541","2024","COM","2022","1451","50","1501","2024-12-30"
"50542","2024","COM","2022","462","7","469","2024-12-30"
"50543","2024","COM","2022","1340","45","1385","2024-12-30"
"50546","2024","COM","2022","3319","71","3390","2024-12-30"
"50548","2024","COM","2022","122","1","123","2024-12-30"
"50549","2024","COM","2022","401","4","405","2024-12-30"
"50550","2024","COM","2022","3250","118","3368","2024-12-30"
"50551","2024","COM","2022","2088","46","2134","2024-12-30"
"50552","2024","COM","2022","325","9","334","2024-12-30"
"50553","2024","COM","2022","329","3","332","2024-12-30"
"50554","2024","COM","2022","1426","31","1457","2024-12-30"
"50556","2024","COM","2022","694","14","708","2024-12-30"
"50562","2024","COM","2022","1666","17","1683","2024-12-30"
"50563","2024","COM","2022","283","7","290","2024-12-30"
"50564","2024","COM","2022","1288","19","1307","2024-12-30"
"50565","2024","COM","2022","2843","56","2899","2024-12-30"
"50567","2024","COM","2022","912","25","937","2024-12-30"
"50568","2024","COM","2022","458","10","468","2024-12-30"
"50569","2024","COM","2022","433","13","446","2024-12-30"
"50570","2024","COM","2022","402","8","410","2024-12-30"
"50571","2024","COM","2022","34","1","35","2024-12-30"
"50572","2024","COM","2022","191","3","194","2024-12-30"
"50574","2024","COM","2022","257","10","267","2024-12-30"
"50575","2024","COM","2022","840","19","859","2024-12-30"
"50576","2024","COM","2022","936","31","967","2024-12-30"
"50577","2024","COM","2022","302","5","307","2024-12-30"
"50578","2024","COM","2022","78","1","79","2024-12-30"
"50579","2024","COM","2022","1455","37","1492","2024-12-30"
"50580","2024","COM","2022","483","17","500","2024-12-30"
"50582","2024","COM","2022","3040","60","3100","2024-12-30"
"50584","2024","COM","2022","377","7","384","2024-12-30"
"50585","2024","COM","2022","1169","27","1196","2024-12-30"
"50587","2024","COM","2022","17","1","18","2024-12-30"
"50588","2024","COM","2022","693","20","713","2024-12-30"
"50589","2024","COM","2022","273","5","278","2024-12-30"
"50590","2024","COM","2022","421","6","427","2024-12-30"
"50591","2024","COM","2022","1692","29","1721","2024-12-30"
"50592","2024","COM","2022","2219","47","2266","2024-12-30"
"50593","2024","COM","2022","594","10","604","2024-12-30"
"50594","2024","COM","2022","1029","21","1050","2024-12-30"
"50596","2024","COM","2022","311","8","319","2024-12-30"
"50597","2024","COM","2022","953","13","966","2024-12-30"
"50598","2024","COM","2022","257","3","260","2024-12-30"
"50599","2024","COM","2022","1650","37","1687","2024-12-30"
"50601","2024","COM","2022","4441","61","4502","2024-12-30"
"50603","2024","COM","2022","772","22","794","2024-12-30"
"50604","2024","COM","2022","727","19","746","2024-12-30"
"50606","2024","COM","2022","511","7","518","2024-12-30"
"50607","2024","COM","2022","401","3","404","2024-12-30"
"50609","2024","COM","2022","127","2","129","2024-12-30"
"50610","2024","COM","2022","196","7","203","2024-12-30"
"50612","2024","COM","2022","760","85","845","2024-12-30"
"50613","2024","COM","2022","391","8","399","2024-12-30"
"50615","2024","COM","2022","6896","244","7140","2024-12-30"
"50616","2024","COM","2022","1914","66","1980","2024-12-30"
"50617","2024","COM","2022","329","4","333","2024-12-30"
"50618","2024","COM","2022","222","10","232","2024-12-30"
"50619","2024","COM","2022","325","4","329","2024-12-30"
"50621","2024","COM","2022","72","0","72","2024-12-30"
"50624","2024","COM","2022","468","23","491","2024-12-30"
"50626","2024","COM","2022","384","8","392","2024-12-30"
"50628","2024","COM","2022","155","5","160","2024-12-30"
"50629","2024","COM","2022","732","10","742","2024-12-30"
"50633","2024","COM","2022","119","3","122","2024-12-30"
"50634","2024","COM","2022","88","1","89","2024-12-30"
"50637","2024","COM","2022","325","5","330","2024-12-30"
"50639","2024","COM","2022","3845","64","3909","2024-12-30"
"50641","2024","COM","2022","644","19","663","2024-12-30"
"50643","2024","COM","2022","771","24","795","2024-12-30"
"50647","2024","COM","2022","1186","47","1233","2024-12-30"
"50648","2024","COM","2022","1188","33","1221","2024-12-30"
"51001","2024","COM","2022","165","5","170","2024-12-30"
"51002","2024","COM","2022","1355","37","1392","2024-12-30"
"51003","2024","COM","2022","287","5","292","2024-12-30"
"51004","2024","COM","2022","118","3","121","2024-12-30"
"51005","2024","COM","2022","184","4","188","2024-12-30"
"51006","2024","COM","2022","151","4","155","2024-12-30"
"51007","2024","COM","2022","962","25","987","2024-12-30"
"51008","2024","COM","2022","212","7","219","2024-12-30"
"51009","2024","COM","2022","789","8","797","2024-12-30"
"51010","2024","COM","2022","143","1","144","2024-12-30"
"51012","2024","COM","2022","71","0","71","2024-12-30"
"51013","2024","COM","2022","101","2","103","2024-12-30"
"51014","2024","COM","2022","287","7","294","2024-12-30"
"51015","2024","COM","2022","109","1","110","2024-12-30"
"51016","2024","COM","2022","233","3","236","2024-12-30"
"51017","2024","COM","2022","326","6","332","2024-12-30"
"51018","2024","COM","2022","888","11","899","2024-12-30"
"51019","2024","COM","2022","247","1","248","2024-12-30"
"51020","2024","COM","2022","51","2","53","2024-12-30"
"51022","2024","COM","2022","176","2","178","2024-12-30"
"51023","2024","COM","2022","276","3","279","2024-12-30"
"51025","2024","COM","2022","1118","16","1134","2024-12-30"
"51027","2024","COM","2022","313","42","355","2024-12-30"
"51028","2024","COM","2022","961","17","978","2024-12-30"
"51029","2024","COM","2022","1751","123","1874","2024-12-30"
"51030","2024","COM","2022","5148","90","5238","2024-12-30"
"51031","2024","COM","2022","292","13","305","2024-12-30"
"51032","2024","COM","2022","408","5","413","2024-12-30"
"51033","2024","COM","2022","271","5","276","2024-12-30"
"51034","2024","COM","2022","23","0","23","2024-12-30"
"51035","2024","COM","2022","248","6","254","2024-12-30"
"51036","2024","COM","2022","481","10","491","2024-12-30"
"51037","2024","COM","2022","342","7","349","2024-12-30"
"51038","2024","COM","2022","175","0","175","2024-12-30"
"51039","2024","COM","2022","94","2","96","2024-12-30"
"51040","2024","COM","2022","239","2","241","2024-12-30"
"51041","2024","COM","2022","99","4","103","2024-12-30"
"51042","2024","COM","2022","390","6","396","2024-12-30"
"51043","2024","COM","2022","2441","20","2461","2024-12-30"
"51044","2024","COM","2022","770","16","786","2024-12-30"
"51045","2024","COM","2022","103","1","104","2024-12-30"
"51046","2024","COM","2022","987","18","1005","2024-12-30"
"51047","2024","COM","2022","44","2","46","2024-12-30"
"51048","2024","COM","2022","171","0","171","2024-12-30"
"51049","2024","COM","2022","580","4","584","2024-12-30"
"51050","2024","COM","2022","145","2","147","2024-12-30"
"51051","2024","COM","2022","263","3","266","2024-12-30"
"51052","2024","COM","2022","618","9","627","2024-12-30"
"51053","2024","COM","2022","71","1","72","2024-12-30"
"51054","2024","COM","2022","1270","17","1287","2024-12-30"
"51055","2024","COM","2022","7030","117","7147","2024-12-30"
"51056","2024","COM","2022","228","3","231","2024-12-30"
"51057","2024","COM","2022","75","0","75","2024-12-30"
"51058","2024","COM","2022","4456","92","4548","2024-12-30"
"51059","2024","COM","2022","373","5","378","2024-12-30"
"51060","2024","COM","2022","156","3","159","2024-12-30"
"51061","2024","COM","2022","139","1","140","2024-12-30"
"51062","2024","COM","2022","87","3","90","2024-12-30"
"51065","2024","COM","2022","618","13","631","2024-12-30"
"51066","2024","COM","2022","318","4","322","2024-12-30"
"51068","2024","COM","2022","197","2","199","2024-12-30"
"51069","2024","COM","2022","115","1","116","2024-12-30"
"51070","2024","COM","2022","233","0","233","2024-12-30"
"51071","2024","COM","2022","210","4","214","2024-12-30"
"51072","2024","COM","2022","229","2","231","2024-12-30"
"51073","2024","COM","2022","226","4","230","2024-12-30"
"51074","2024","COM","2022","1793","32","1825","2024-12-30"
"51075","2024","COM","2022","1454","34","1488","2024-12-30"
"51076","2024","COM","2022","407","6","413","2024-12-30"
"51077","2024","COM","2022","175","3","178","2024-12-30"
"51078","2024","COM","2022","536","8","544","2024-12-30"
"51079","2024","COM","2022","833","24","857","2024-12-30"
"51080","2024","COM","2022","196","1","197","2024-12-30"
"51081","2024","COM","2022","315","9","324","2024-12-30"
"51082","2024","COM","2022","94","2","96","2024-12-30"
"51083","2024","COM","2022","81","3","84","2024-12-30"
"51084","2024","COM","2022","84","1","85","2024-12-30"
"51085","2024","COM","2022","377","3","380","2024-12-30"
"51086","2024","COM","2022","326","11","337","2024-12-30"
"51087","2024","COM","2022","210","7","217","2024-12-30"
"51088","2024","COM","2022","453","10","463","2024-12-30"
"51089","2024","COM","2022","60","3","63","2024-12-30"
"51090","2024","COM","2022","312","7","319","2024-12-30"
"51091","2024","COM","2022","137","5","142","2024-12-30"
"51092","2024","COM","2022","341","10","351","2024-12-30"
"51093","2024","COM","2022","437","11","448","2024-12-30"
"51094","2024","COM","2022","187","4","191","2024-12-30"
"51095","2024","COM","2022","84","0","84","2024-12-30"
"51097","2024","COM","2022","184","4","188","2024-12-30"
"51098","2024","COM","2022","136","6","142","2024-12-30"
"51099","2024","COM","2022","315","9","324","2024-12-30"
"51100","2024","COM","2022","99","1","100","2024-12-30"
"51101","2024","COM","2022","696","10","706","2024-12-30"
"51102","2024","COM","2022","504","10","514","2024-12-30"
"51103","2024","COM","2022","137","3","140","2024-12-30"
"51104","2024","COM","2022","134","4","138","2024-12-30"
"51105","2024","COM","2022","1566","31","1597","2024-12-30"
"51106","2024","COM","2022","126","5","131","2024-12-30"
"51107","2024","COM","2022","344","3","347","2024-12-30"
"51108","2024","COM","2022","43218","967","44185","2024-12-30"
"51109","2024","COM","2022","202","5","207","2024-12-30"
"51110","2024","COM","2022","60","0","60","2024-12-30"
"51111","2024","COM","2022","147","1","148","2024-12-30"
"51112","2024","COM","2022","455","4","459","2024-12-30"
"51113","2024","COM","2022","123","1","124","2024-12-30"
"51115","2024","COM","2022","603","5","608","2024-12-30"
"51116","2024","COM","2022","296","4","300","2024-12-30"
"51117","2024","COM","2022","323","8","331","2024-12-30"
"51118","2024","COM","2022","1616","42","1658","2024-12-30"
"51119","2024","COM","2022","511","7","518","2024-12-30"
"51120","2024","COM","2022","147","0","147","2024-12-30"
"51121","2024","COM","2022","253","3","256","2024-12-30"
"51122","2024","COM","2022","116","3","119","2024-12-30"
"51124","2024","COM","2022","49","3","52","2024-12-30"
"51125","2024","COM","2022","50","1","51","2024-12-30"
"51126","2024","COM","2022","45","3","48","2024-12-30"
"51127","2024","COM","2022","85","0","85","2024-12-30"
"51128","2024","COM","2022","57","2","59","2024-12-30"
"51129","2024","COM","2022","260","8","268","2024-12-30"
"51130","2024","COM","2022","236","5","241","2024-12-30"
"51132","2024","COM","2022","119","0","119","2024-12-30"
"51133","2024","COM","2022","63","1","64","2024-12-30"
"51134","2024","COM","2022","253","8","261","2024-12-30"
"51135","2024","COM","2022","85","1","86","2024-12-30"
"51136","2024","COM","2022","621","9","630","2024-12-30"
"51137","2024","COM","2022","208","3","211","2024-12-30"
"51138","2024","COM","2022","36","1","37","2024-12-30"
"51139","2024","COM","2022","312","4","316","2024-12-30"
"51140","2024","COM","2022","348","8","356","2024-12-30"
"51141","2024","COM","2022","764","21","785","2024-12-30"
"51142","2024","COM","2022","337","13","350","2024-12-30"
"51143","2024","COM","2022","62","0","62","2024-12-30"
"51144","2024","COM","2022","595","11","606","2024-12-30"
"51145","2024","COM","2022","223","5","228","2024-12-30"
"51146","2024","COM","2022","120","3","123","2024-12-30"
"51147","2024","COM","2022","326","12","338","2024-12-30"
"51148","2024","COM","2022","141","2","143","2024-12-30"
"51149","2024","COM","2022","456","9","465","2024-12-30"
"51150","2024","COM","2022","84","2","86","2024-12-30"
"51151","2024","COM","2022","170","3","173","2024-12-30"
"51152","2024","COM","2022","525","10","535","2024-12-30"
"51153","2024","COM","2022","1062","21","1083","2024-12-30"
"51154","2024","COM","2022","225","3","228","2024-12-30"
"51155","2024","COM","2022","631","9","640","2024-12-30"
"51156","2024","COM","2022","124","2","126","2024-12-30"
"51157","2024","COM","2022","91","0","91","2024-12-30"
"51158","2024","COM","2022","561","19","580","2024-12-30"
"51160","2024","COM","2022","1307","47","1354","2024-12-30"
"51161","2024","COM","2022","749","14","763","2024-12-30"
"51162","2024","COM","2022","621","13","634","2024-12-30"
"51163","2024","COM","2022","256","3","259","2024-12-30"
"51164","2024","COM","2022","137","2","139","2024-12-30"
"51165","2024","COM","2022","1006","29","1035","2024-12-30"
"51166","2024","COM","2022","67","1","68","2024-12-30"
"51167","2024","COM","2022","156","3","159","2024-12-30"
"51168","2024","COM","2022","230","1","231","2024-12-30"
"51169","2024","COM","2022","99","4","103","2024-12-30"
"51170","2024","COM","2022","109","1","110","2024-12-30"
"51171","2024","COM","2022","1504","16","1520","2024-12-30"
"51172","2024","COM","2022","6454","77","6531","2024-12-30"
"51173","2024","COM","2022","128","1","129","2024-12-30"
"51174","2024","COM","2022","64","1","65","2024-12-30"
"51175","2024","COM","2022","208","3","211","2024-12-30"
"51176","2024","COM","2022","149","7","156","2024-12-30"
"51177","2024","COM","2022","207","3","210","2024-12-30"
"51178","2024","COM","2022","84","1","85","2024-12-30"
"51179","2024","COM","2022","168","2","170","2024-12-30"
"51181","2024","COM","2022","395","11","406","2024-12-30"
"51182","2024","COM","2022","87","1","88","2024-12-30"
"51183","2024","COM","2022","1262","17","1279","2024-12-30"
"51184","2024","COM","2022","388","5","393","2024-12-30"
"51185","2024","COM","2022","277","1","278","2024-12-30"
"51186","2024","COM","2022","49","0","49","2024-12-30"
"51187","2024","COM","2022","302","6","308","2024-12-30"
"51188","2024","COM","2022","225","6","231","2024-12-30"
"51190","2024","COM","2022","74","0","74","2024-12-30"
"51191","2024","COM","2022","62","3","65","2024-12-30"
"51192","2024","COM","2022","344","4","348","2024-12-30"
"51193","2024","COM","2022","2345","95","2440","2024-12-30"
"51194","2024","COM","2022","454","9","463","2024-12-30"
"51195","2024","COM","2022","796","16","812","2024-12-30"
"51196","2024","COM","2022","877","11","888","2024-12-30"
"51197","2024","COM","2022","86","2","88","2024-12-30"
"51198","2024","COM","2022","675","5","680","2024-12-30"
"51199","2024","COM","2022","414","5","419","2024-12-30"
"51200","2024","COM","2022","368","12","380","2024-12-30"
"51201","2024","COM","2022","127","3","130","2024-12-30"
"51202","2024","COM","2022","716","11","727","2024-12-30"
"51203","2024","COM","2022","219","9","228","2024-12-30"
"51204","2024","COM","2022","1329","27","1356","2024-12-30"
"51205","2024","COM","2022","270","4","274","2024-12-30"
"51206","2024","COM","2022","117","1","118","2024-12-30"
"51208","2024","COM","2022","110","1","111","2024-12-30"
"51210","2024","COM","2022","1485","25","1510","2024-12-30"
"51211","2024","COM","2022","75","1","76","2024-12-30"
"51212","2024","COM","2022","163","1","164","2024-12-30"
"51213","2024","COM","2022","45","3","48","2024-12-30"
"51214","2024","COM","2022","136","4","140","2024-12-30"
"51215","2024","COM","2022","116","3","119","2024-12-30"
"51216","2024","COM","2022","259","4","263","2024-12-30"
"51217","2024","COM","2022","2898","46","2944","2024-12-30"
"51218","2024","COM","2022","131","2","133","2024-12-30"
"51219","2024","COM","2022","195","4","199","2024-12-30"
"51220","2024","COM","2022","144","6","150","2024-12-30"
"51222","2024","COM","2022","86","2","88","2024-12-30"
"51223","2024","COM","2022","63","1","64","2024-12-30"
"51224","2024","COM","2022","166","5","171","2024-12-30"
"51225","2024","COM","2022","349","5","354","2024-12-30"
"51226","2024","COM","2022","62","1","63","2024-12-30"
"51227","2024","COM","2022","491","22","513","2024-12-30"
"51228","2024","COM","2022","81","0","81","2024-12-30"
"51229","2024","COM","2022","123","6","129","2024-12-30"
"51230","2024","COM","2022","22022","462","22484","2024-12-30"
"51231","2024","COM","2022","676","9","685","2024-12-30"
"51232","2024","COM","2022","417","6","423","2024-12-30"
"51233","2024","COM","2022","64","3","67","2024-12-30"
"51234","2024","COM","2022","644","12","656","2024-12-30"
"51235","2024","COM","2022","242","11","253","2024-12-30"
"51236","2024","COM","2022","135","5","140","2024-12-30"
"51237","2024","COM","2022","1776","30","1806","2024-12-30"
"51238","2024","COM","2022","417","3","420","2024-12-30"
"51239","2024","COM","2022","102","1","103","2024-12-30"
"51240","2024","COM","2022","115","3","118","2024-12-30"
"51241","2024","COM","2022","79","1","80","2024-12-30"
"51242","2024","COM","2022","4886","108","4994","2024-12-30"
"51243","2024","COM","2022","330","8","338","2024-12-30"
"51244","2024","COM","2022","239","7","246","2024-12-30"
"51245","2024","COM","2022","597","10","607","2024-12-30"
"51246","2024","COM","2022","219","2","221","2024-12-30"
"51247","2024","COM","2022","136","4","140","2024-12-30"
"51248","2024","COM","2022","2181","36","2217","2024-12-30"
"51249","2024","COM","2022","392","9","401","2024-12-30"
"51250","2024","COM","2022","5884","58","5942","2024-12-30"
"51251","2024","COM","2022","177","5","182","2024-12-30"
"51252","2024","COM","2022","520","4","524","2024-12-30"
"51253","2024","COM","2022","217","2","219","2024-12-30"
"51254","2024","COM","2022","235","4","239","2024-12-30"
"51255","2024","COM","2022","15","1","16","2024-12-30"
"51256","2024","COM","2022","315","7","322","2024-12-30"
"51258","2024","COM","2022","206","11","217","2024-12-30"
"51259","2024","COM","2022","192","6","198","2024-12-30"
"51260","2024","COM","2022","75","3","78","2024-12-30"
"51262","2024","COM","2022","1751","34","1785","2024-12-30"
"51263","2024","COM","2022","379","8","387","2024-12-30"
"51264","2024","COM","2022","503","15","518","2024-12-30"
"51265","2024","COM","2022","581","18","599","2024-12-30"
"51266","2024","COM","2022","529","17","546","2024-12-30"
"51267","2024","COM","2022","184","4","188","2024-12-30"
"51268","2024","COM","2022","188","5","193","2024-12-30"
"51269","2024","COM","2022","286","2","288","2024-12-30"
"51270","2024","COM","2022","227","4","231","2024-12-30"
"51272","2024","COM","2022","451","7","458","2024-12-30"
"51273","2024","COM","2022","73","0","73","2024-12-30"
"51274","2024","COM","2022","116","3","119","2024-12-30"
"51275","2024","COM","2022","184","2","186","2024-12-30"
"51276","2024","COM","2022","146","3","149","2024-12-30"
"51277","2024","COM","2022","273","7","280","2024-12-30"
"51278","2024","COM","2022","285","5","290","2024-12-30"
"51279","2024","COM","2022","182","6","188","2024-12-30"
"51280","2024","COM","2022","21","0","21","2024-12-30"
"51281","2024","COM","2022","618","13","631","2024-12-30"
"51282","2024","COM","2022","1901","48","1949","2024-12-30"
"51283","2024","COM","2022","122","6","128","2024-12-30"
"51284","2024","COM","2022","311","2","313","2024-12-30"
"51285","2024","COM","2022","139","2","141","2024-12-30"
"51286","2024","COM","2022","233","5","238","2024-12-30"
"51287","2024","COM","2022","628","11","639","2024-12-30"
"51288","2024","COM","2022","235","8","243","2024-12-30"
"51289","2024","COM","2022","435","9","444","2024-12-30"
"51290","2024","COM","2022","278","6","284","2024-12-30"
"51291","2024","COM","2022","1409","29","1438","2024-12-30"
"51292","2024","COM","2022","122","4","126","2024-12-30"
"51293","2024","COM","2022","504","7","511","2024-12-30"
"51294","2024","COM","2022","84","0","84","2024-12-30"
"51295","2024","COM","2022","302","7","309","2024-12-30"
"51296","2024","COM","2022","75","0","75","2024-12-30"
"51298","2024","COM","2022","436","5","441","2024-12-30"
"51299","2024","COM","2022","979","12","991","2024-12-30"
"51300","2024","COM","2022","96","2","98","2024-12-30"
"51301","2024","COM","2022","109","4","113","2024-12-30"
"51302","2024","COM","2022","90","1","91","2024-12-30"
"51303","2024","COM","2022","550","10","560","2024-12-30"
"51304","2024","COM","2022","159","6","165","2024-12-30"
"51305","2024","COM","2022","146","1","147","2024-12-30"
"51306","2024","COM","2022","107","1","108","2024-12-30"
"51307","2024","COM","2022","228","2","230","2024-12-30"
"51308","2024","COM","2022","1815","57","1872","2024-12-30"
"51309","2024","COM","2022","114","1","115","2024-12-30"
"51310","2024","COM","2022","208","3","211","2024-12-30"
"51311","2024","COM","2022","199","3","202","2024-12-30"
"51312","2024","COM","2022","959","29","988","2024-12-30"
"51313","2024","COM","2022","347","12","359","2024-12-30"
"51314","2024","COM","2022","234","5","239","2024-12-30"
"51315","2024","COM","2022","135","4","139","2024-12-30"
"51316","2024","COM","2022","270","1","271","2024-12-30"
"51317","2024","COM","2022","49","0","49","2024-12-30"
"51318","2024","COM","2022","573","12","585","2024-12-30"
"51319","2024","COM","2022","109","3","112","2024-12-30"
"51320","2024","COM","2022","302","7","309","2024-12-30"
"51321","2024","COM","2022","89","2","91","2024-12-30"
"51322","2024","COM","2022","119","1","120","2024-12-30"
"51323","2024","COM","2022","105","2","107","2024-12-30"
"51324","2024","COM","2022","111","1","112","2024-12-30"
"51325","2024","COM","2022","107","1","108","2024-12-30"
"51326","2024","COM","2022","1083","15","1098","2024-12-30"
"51327","2024","COM","2022","173","2","175","2024-12-30"
"51328","2024","COM","2022","1114","19","1133","2024-12-30"
"51329","2024","COM","2022","1438","19","1457","2024-12-30"
"51333","2024","COM","2022","691","16","707","2024-12-30"
"51334","2024","COM","2022","444","18","462","2024-12-30"
"51336","2024","COM","2022","57","1","58","2024-12-30"
"51337","2024","COM","2022","266","2","268","2024-12-30"
"51338","2024","COM","2022","622","15","637","2024-12-30"
"51339","2024","COM","2022","565","16","581","2024-12-30"
"51340","2024","COM","2022","551","14","565","2024-12-30"
"51341","2024","COM","2022","37","0","37","2024-12-30"
"51342","2024","COM","2022","237","7","244","2024-12-30"
"51343","2024","COM","2022","627","20","647","2024-12-30"
"51344","2024","COM","2022","1463","20","1483","2024-12-30"
"51345","2024","COM","2022","289","5","294","2024-12-30"
"51346","2024","COM","2022","1151","17","1168","2024-12-30"
"51348","2024","COM","2022","111","2","113","2024-12-30"
"51349","2024","COM","2022","181","6","187","2024-12-30"
"51350","2024","COM","2022","123","1","124","2024-12-30"
"51351","2024","COM","2022","115","1","116","2024-12-30"
"51352","2024","COM","2022","803","18","821","2024-12-30"
"51353","2024","COM","2022","46","1","47","2024-12-30"
"51354","2024","COM","2022","278","11","289","2024-12-30"
"51355","2024","COM","2022","43","0","43","2024-12-30"
"51356","2024","COM","2022","156","3","159","2024-12-30"
"51357","2024","COM","2022","628","14","642","2024-12-30"
"51358","2024","COM","2022","534","8","542","2024-12-30"
"51359","2024","COM","2022","208","4","212","2024-12-30"
"51360","2024","COM","2022","295","7","302","2024-12-30"
"51361","2024","COM","2022","167","1","168","2024-12-30"
"51362","2024","COM","2022","603","8","611","2024-12-30"
"51363","2024","COM","2022","271","5","276","2024-12-30"
"51364","2024","COM","2022","67","1","68","2024-12-30"
"51365","2024","COM","2022","963","17","980","2024-12-30"
"51367","2024","COM","2022","1001","33","1034","2024-12-30"
"51368","2024","COM","2022","46","0","46","2024-12-30"
"51369","2024","COM","2022","318","14","332","2024-12-30"
"51370","2024","COM","2022","189","4","193","2024-12-30"
"51371","2024","COM","2022","54","1","55","2024-12-30"
"51372","2024","COM","2022","569","12","581","2024-12-30"
"51373","2024","COM","2022","88","2","90","2024-12-30"
"51374","2024","COM","2022","28","1","29","2024-12-30"
"51375","2024","COM","2022","380","6","386","2024-12-30"
"51376","2024","COM","2022","159","1","160","2024-12-30"
"51377","2024","COM","2022","46","2","48","2024-12-30"
"51378","2024","COM","2022","346","5","351","2024-12-30"
"51379","2024","COM","2022","537","5","542","2024-12-30"
"51380","2024","COM","2022","3551","49","3600","2024-12-30"
"51381","2024","COM","2022","650","9","659","2024-12-30"
"51382","2024","COM","2022","117","5","122","2024-12-30"
"51384","2024","COM","2022","367","12","379","2024-12-30"
"51386","2024","COM","2022","149","2","151","2024-12-30"
"51387","2024","COM","2022","285","7","292","2024-12-30"
"51388","2024","COM","2022","4984","53","5037","2024-12-30"
"51389","2024","COM","2022","806","8","814","2024-12-30"
"51390","2024","COM","2022","744","15","759","2024-12-30"
"51391","2024","COM","2022","2072","61","2133","2024-12-30"
"51392","2024","COM","2022","206","4","210","2024-12-30"
"51393","2024","COM","2022","300","3","303","2024-12-30"
"51395","2024","COM","2022","91","0","91","2024-12-30"
"51396","2024","COM","2022","138","0","138","2024-12-30"
"51397","2024","COM","2022","138","0","138","2024-12-30"
"51398","2024","COM","2022","192","1","193","2024-12-30"
"51399","2024","COM","2022","489","18","507","2024-12-30"
"51402","2024","COM","2022","272","5","277","2024-12-30"
"51403","2024","COM","2022","540","11","551","2024-12-30"
"51404","2024","COM","2022","110","5","115","2024-12-30"
"51406","2024","COM","2022","152","2","154","2024-12-30"
"51407","2024","COM","2022","377","7","384","2024-12-30"
"51409","2024","COM","2022","385","6","391","2024-12-30"
"51410","2024","COM","2022","595","4","599","2024-12-30"
"51412","2024","COM","2022","60","1","61","2024-12-30"
"51413","2024","COM","2022","886","12","898","2024-12-30"
"51414","2024","COM","2022","142","5","147","2024-12-30"
"51415","2024","COM","2022","201","5","206","2024-12-30"
"51416","2024","COM","2022","523","13","536","2024-12-30"
"51417","2024","COM","2022","366","4","370","2024-12-30"
"51418","2024","COM","2022","537","9","546","2024-12-30"
"51419","2024","COM","2022","131","1","132","2024-12-30"
"51420","2024","COM","2022","76","0","76","2024-12-30"
"51421","2024","COM","2022","106","0","106","2024-12-30"
"51422","2024","COM","2022","496","9","505","2024-12-30"
"51423","2024","COM","2022","1700","15","1715","2024-12-30"
"51424","2024","COM","2022","177","7","184","2024-12-30"
"51425","2024","COM","2022","373","10","383","2024-12-30"
"51426","2024","COM","2022","65","2","67","2024-12-30"
"51428","2024","COM","2022","483","9","492","2024-12-30"
"51429","2024","COM","2022","226","5","231","2024-12-30"
"51430","2024","COM","2022","92","1","93","2024-12-30"
"51431","2024","COM","2022","1254","19","1273","2024-12-30"
"51432","2024","COM","2022","826","12","838","2024-12-30"
"51433","2024","COM","2022","250","6","256","2024-12-30"
"51434","2024","COM","2022","751","16","767","2024-12-30"
"51435","2024","COM","2022","177","1","178","2024-12-30"
"51436","2024","COM","2022","906","28","934","2024-12-30"
"51437","2024","COM","2022","95","0","95","2024-12-30"
"51438","2024","COM","2022","71","1","72","2024-12-30"
"51439","2024","COM","2022","530","6","536","2024-12-30"
"51440","2024","COM","2022","1738","19","1757","2024-12-30"
"51441","2024","COM","2022","103","2","105","2024-12-30"
"51442","2024","COM","2022","124","0","124","2024-12-30"
"51443","2024","COM","2022","115","3","118","2024-12-30"
"51444","2024","COM","2022","521","8","529","2024-12-30"
"51445","2024","COM","2022","192","3","195","2024-12-30"
"51446","2024","COM","2022","432","10","442","2024-12-30"
"51447","2024","COM","2022","485","13","498","2024-12-30"
"51448","2024","COM","2022","549","10","559","2024-12-30"
"51449","2024","COM","2022","1032","14","1046","2024-12-30"
"51450","2024","COM","2022","452","10","462","2024-12-30"
"51451","2024","COM","2022","82","4","86","2024-12-30"
"51452","2024","COM","2022","33","0","33","2024-12-30"
"51453","2024","COM","2022","1077","22","1099","2024-12-30"
"51454","2024","COM","2022","178478","2944","181422","2024-12-30"
"51455","2024","COM","2022","217","10","227","2024-12-30"
"51456","2024","COM","2022","57","1","58","2024-12-30"
"51457","2024","COM","2022","645","6","651","2024-12-30"
"51458","2024","COM","2022","60","0","60","2024-12-30"
"51459","2024","COM","2022","105","1","106","2024-12-30"
"51460","2024","COM","2022","194","5","199","2024-12-30"
"51461","2024","COM","2022","1009","16","1025","2024-12-30"
"51463","2024","COM","2022","158","5","163","2024-12-30"
"51464","2024","COM","2022","325","2","327","2024-12-30"
"51465","2024","COM","2022","160","2","162","2024-12-30"
"51466","2024","COM","2022","210","4","214","2024-12-30"
"51468","2024","COM","2022","403","11","414","2024-12-30"
"51469","2024","COM","2022","110","5","115","2024-12-30"
"51470","2024","COM","2022","3","0","3","2024-12-30"
"51471","2024","COM","2022","370","3","373","2024-12-30"
"51472","2024","COM","2022","1018","27","1045","2024-12-30"
"51473","2024","COM","2022","94","6","100","2024-12-30"
"51474","2024","COM","2022","3546","40","3586","2024-12-30"
"51475","2024","COM","2022","63","1","64","2024-12-30"
"51476","2024","COM","2022","786","20","806","2024-12-30"
"51477","2024","COM","2022","349","4","353","2024-12-30"
"51478","2024","COM","2022","419","9","428","2024-12-30"
"51479","2024","COM","2022","245","5","250","2024-12-30"
"51480","2024","COM","2022","134","2","136","2024-12-30"
"51482","2024","COM","2022","669","14","683","2024-12-30"
"51483","2024","COM","2022","548","7","555","2024-12-30"
"51484","2024","COM","2022","274","5","279","2024-12-30"
"51485","2024","COM","2022","304","7","311","2024-12-30"
"51486","2024","COM","2022","359","4","363","2024-12-30"
"51487","2024","COM","2022","353","7","360","2024-12-30"
"51488","2024","COM","2022","331","36","367","2024-12-30"
"51489","2024","COM","2022","29","3","32","2024-12-30"
"51490","2024","COM","2022","200","2","202","2024-12-30"
"51491","2024","COM","2022","90","0","90","2024-12-30"
"51492","2024","COM","2022","1425","23","1448","2024-12-30"
"51493","2024","COM","2022","100","2","102","2024-12-30"
"51495","2024","COM","2022","75","0","75","2024-12-30"
"51496","2024","COM","2022","266","8","274","2024-12-30"
"51497","2024","COM","2022","41","0","41","2024-12-30"
"51498","2024","COM","2022","64","0","64","2024-12-30"
"51499","2024","COM","2022","152","7","159","2024-12-30"
"51500","2024","COM","2022","114","2","116","2024-12-30"
"51501","2024","COM","2022","195","8","203","2024-12-30"
"51502","2024","COM","2022","106","0","106","2024-12-30"
"51503","2024","COM","2022","91","0","91","2024-12-30"
"51504","2024","COM","2022","794","14","808","2024-12-30"
"51505","2024","COM","2022","527","5","532","2024-12-30"
"51506","2024","COM","2022","5439","87","5526","2024-12-30"
"51507","2024","COM","2022","4166","108","4274","2024-12-30"
"51508","2024","COM","2022","201","3","204","2024-12-30"
"51509","2024","COM","2022","300","7","307","2024-12-30"
"51510","2024","COM","2022","118","0","118","2024-12-30"
"51511","2024","COM","2022","112","1","113","2024-12-30"
"51512","2024","COM","2022","104","2","106","2024-12-30"
"51513","2024","COM","2022","474","10","484","2024-12-30"
"51514","2024","COM","2022","111","1","112","2024-12-30"
"51515","2024","COM","2022","329","5","334","2024-12-30"
"51516","2024","COM","2022","48","0","48","2024-12-30"
"51517","2024","COM","2022","129","4","133","2024-12-30"
"51518","2024","COM","2022","603","15","618","2024-12-30"
"51519","2024","COM","2022","37","2","39","2024-12-30"
"51520","2024","COM","2022","72","1","73","2024-12-30"
"51521","2024","COM","2022","227","5","232","2024-12-30"
"51522","2024","COM","2022","387","8","395","2024-12-30"
"51523","2024","COM","2022","268","2","270","2024-12-30"
"51524","2024","COM","2022","270","6","276","2024-12-30"
"51525","2024","COM","2022","2028","49","2077","2024-12-30"
"51526","2024","COM","2022","392","10","402","2024-12-30"
"51527","2024","COM","2022","255","5","260","2024-12-30"
"51528","2024","COM","2022","124","3","127","2024-12-30"
"51529","2024","COM","2022","446","5","451","2024-12-30"
"51530","2024","COM","2022","689","9","698","2024-12-30"
"51531","2024","COM","2022","1752","32","1784","2024-12-30"
"51532","2024","COM","2022","565","19","584","2024-12-30"
"51533","2024","COM","2022","89","5","94","2024-12-30"
"51534","2024","COM","2022","212","6","218","2024-12-30"
"51535","2024","COM","2022","4679","123","4802","2024-12-30"
"51536","2024","COM","2022","1830","27","1857","2024-12-30"
"51537","2024","COM","2022","178","4","182","2024-12-30"
"51538","2024","COM","2022","110","2","112","2024-12-30"
"51539","2024","COM","2022","76","1","77","2024-12-30"
"51542","2024","COM","2022","191","0","191","2024-12-30"
"51543","2024","COM","2022","68","7","75","2024-12-30"
"51544","2024","COM","2022","656","17","673","2024-12-30"
"51545","2024","COM","2022","474","16","490","2024-12-30"
"51546","2024","COM","2022","511","149","660","2024-12-30"
"51547","2024","COM","2022","141","1","142","2024-12-30"
"51548","2024","COM","2022","346","242","588","2024-12-30"
"51549","2024","COM","2022","112","3","115","2024-12-30"
"51550","2024","COM","2022","264","15","279","2024-12-30"
"51551","2024","COM","2022","192","2","194","2024-12-30"
"51552","2024","COM","2022","267","4","271","2024-12-30"
"51553","2024","COM","2022","260","3","263","2024-12-30"
"51555","2024","COM","2022","152","0","152","2024-12-30"
"51556","2024","COM","2022","299","4","303","2024-12-30"
"51557","2024","COM","2022","457","9","466","2024-12-30"
"51558","2024","COM","2022","141","3","144","2024-12-30"
"51559","2024","COM","2022","3898","36","3934","2024-12-30"
"51560","2024","COM","2022","106","4","110","2024-12-30"
"51562","2024","COM","2022","2202","37","2239","2024-12-30"
"51563","2024","COM","2022","105","2","107","2024-12-30"
"51564","2024","COM","2022","591","17","608","2024-12-30"
"51565","2024","COM","2022","102","0","102","2024-12-30"
"51566","2024","COM","2022","292","4","296","2024-12-30"
"51567","2024","COM","2022","512","8","520","2024-12-30"
"51568","2024","COM","2022","318","7","325","2024-12-30"
"51569","2024","COM","2022","519","69","588","2024-12-30"
"51570","2024","COM","2022","105","2","107","2024-12-30"
"51571","2024","COM","2022","992","15","1007","2024-12-30"
"51572","2024","COM","2022","234","11","245","2024-12-30"
"51573","2024","COM","2022","10662","122","10784","2024-12-30"
"51574","2024","COM","2022","138","3","141","2024-12-30"
"51576","2024","COM","2022","1371","28","1399","2024-12-30"
"51577","2024","COM","2022","151","3","154","2024-12-30"
"51578","2024","COM","2022","87","7","94","2024-12-30"
"51579","2024","COM","2022","174","1","175","2024-12-30"
"51580","2024","COM","2022","434","3","437","2024-12-30"
"51581","2024","COM","2022","262","2","264","2024-12-30"
"51582","2024","COM","2022","613","11","624","2024-12-30"
"51583","2024","COM","2022","195","1","196","2024-12-30"
"51584","2024","COM","2022","159","2","161","2024-12-30"
"51585","2024","COM","2022","802","46","848","2024-12-30"
"51586","2024","COM","2022","188","6","194","2024-12-30"
"51587","2024","COM","2022","236","6","242","2024-12-30"
"51588","2024","COM","2022","240","6","246","2024-12-30"
"51589","2024","COM","2022","164","4","168","2024-12-30"
"51590","2024","COM","2022","369","9","378","2024-12-30"
"51591","2024","COM","2022","176","6","182","2024-12-30"
"51592","2024","COM","2022","302","5","307","2024-12-30"
"51594","2024","COM","2022","62","0","62","2024-12-30"
"51595","2024","COM","2022","146","1","147","2024-12-30"
"51596","2024","COM","2022","341","2","343","2024-12-30"
"51597","2024","COM","2022","325","1","326","2024-12-30"
"51598","2024","COM","2022","498","9","507","2024-12-30"
"51599","2024","COM","2022","340","5","345","2024-12-30"
"51600","2024","COM","2022","106","2","108","2024-12-30"
"51601","2024","COM","2022","170","3","173","2024-12-30"
"51602","2024","COM","2022","61","0","61","2024-12-30"
"51603","2024","COM","2022","227","6","233","2024-12-30"
"51604","2024","COM","2022","254","3","257","2024-12-30"
"51605","2024","COM","2022","483","14","497","2024-12-30"
"51607","2024","COM","2022","198","2","200","2024-12-30"
"51608","2024","COM","2022","82","2","84","2024-12-30"
"51609","2024","COM","2022","840","13","853","2024-12-30"
"51610","2024","COM","2022","406","8","414","2024-12-30"
"51611","2024","COM","2022","285","6","291","2024-12-30"
"51612","2024","COM","2022","3120","166","3286","2024-12-30"
"51613","2024","COM","2022","999","15","1014","2024-12-30"
"51614","2024","COM","2022","958","16","974","2024-12-30"
"51616","2024","COM","2022","236","4","240","2024-12-30"
"51617","2024","COM","2022","603","17","620","2024-12-30"
"51618","2024","COM","2022","184","3","187","2024-12-30"
"51619","2024","COM","2022","106","2","108","2024-12-30"
"51620","2024","COM","2022","162","5","167","2024-12-30"
"51621","2024","COM","2022","515","8","523","2024-12-30"
"51622","2024","COM","2022","405","8","413","2024-12-30"
"51623","2024","COM","2022","296","43","339","2024-12-30"
"51624","2024","COM","2022","648","7","655","2024-12-30"
"51625","2024","COM","2022","273","7","280","2024-12-30"
"51626","2024","COM","2022","119","5","124","2024-12-30"
"51627","2024","COM","2022","325","11","336","2024-12-30"
"51628","2024","COM","2022","121","4","125","2024-12-30"
"51629","2024","COM","2022","934","23","957","2024-12-30"
"51630","2024","COM","2022","321","11","332","2024-12-30"
"51631","2024","COM","2022","323","6","329","2024-12-30"
"51632","2024","COM","2022","215","8","223","2024-12-30"
"51633","2024","COM","2022","299","15","314","2024-12-30"
"51634","2024","COM","2022","297","10","307","2024-12-30"
"51635","2024","COM","2022","109","0","109","2024-12-30"
"51636","2024","COM","2022","558","12","570","2024-12-30"
"51638","2024","COM","2022","201","8","209","2024-12-30"
"51639","2024","COM","2022","40","1","41","2024-12-30"
"51640","2024","COM","2022","214","0","214","2024-12-30"
"51641","2024","COM","2022","194","5","199","2024-12-30"
"51642","2024","COM","2022","113","5","118","2024-12-30"
"51643","2024","COM","2022","535","6","541","2024-12-30"
"51644","2024","COM","2022","326","9","335","2024-12-30"
"51645","2024","COM","2022","106","2","108","2024-12-30"
"51646","2024","COM","2022","83","3","86","2024-12-30"
"51647","2024","COM","2022","851","19","870","2024-12-30"
"51648","2024","COM","2022","368","12","380","2024-12-30"
"51649","2024","COM","2022","11349","187","11536","2024-12-30"
"51650","2024","COM","2022","47","1","48","2024-12-30"
"51652","2024","COM","2022","61","0","61","2024-12-30"
"51654","2024","COM","2022","259","2","261","2024-12-30"
"51655","2024","COM","2022","296","4","300","2024-12-30"
"51656","2024","COM","2022","462","19","481","2024-12-30"
"51657","2024","COM","2022","240","2","242","2024-12-30"
"51658","2024","COM","2022","104","0","104","2024-12-30"
"51659","2024","COM","2022","46","0","46","2024-12-30"
"51660","2024","COM","2022","2689","28","2717","2024-12-30"
"51662","2024","COM","2022","4958","73","5031","2024-12-30"
"51663","2024","COM","2022","1686","10","1696","2024-12-30"
"52001","2024","COM","2022","302","7","309","2024-12-30"
"52002","2024","COM","2022","26","0","26","2024-12-30"
"52003","2024","COM","2022","142","2","144","2024-12-30"
"52004","2024","COM","2022","11","1","12","2024-12-30"
"52005","2024","COM","2022","27","1","28","2024-12-30"
"52006","2024","COM","2022","362","4","366","2024-12-30"
"52007","2024","COM","2022","85","3","88","2024-12-30"
"52008","2024","COM","2022","831","18","849","2024-12-30"
"52009","2024","COM","2022","106","2","108","2024-12-30"
"52011","2024","COM","2022","94","1","95","2024-12-30"
"52012","2024","COM","2022","29","1","30","2024-12-30"
"52013","2024","COM","2022","125","2","127","2024-12-30"
"52014","2024","COM","2022","189","3","192","2024-12-30"
"52015","2024","COM","2022","86","1","87","2024-12-30"
"52016","2024","COM","2022","64","2","66","2024-12-30"
"52017","2024","COM","2022","688","12","700","2024-12-30"
"52019","2024","COM","2022","82","1","83","2024-12-30"
"52021","2024","COM","2022","275","4","279","2024-12-30"
"52022","2024","COM","2022","185","6","191","2024-12-30"
"52023","2024","COM","2022","156","2","158","2024-12-30"
"52025","2024","COM","2022","80","1","81","2024-12-30"
"52027","2024","COM","2022","67","2","69","2024-12-30"
"52028","2024","COM","2022","58","0","58","2024-12-30"
"52029","2024","COM","2022","130","4","134","2024-12-30"
"52030","2024","COM","2022","55","3","58","2024-12-30"
"52031","2024","COM","2022","376","8","384","2024-12-30"
"52033","2024","COM","2022","113","2","115","2024-12-30"
"52034","2024","COM","2022","133","4","137","2024-12-30"
"52035","2024","COM","2022","172","2","174","2024-12-30"
"52037","2024","COM","2022","364","8","372","2024-12-30"
"52038","2024","COM","2022","63","3","66","2024-12-30"
"52039","2024","COM","2022","85","1","86","2024-12-30"
"52040","2024","COM","2022","46","0","46","2024-12-30"
"52042","2024","COM","2022","111","6","117","2024-12-30"
"52043","2024","COM","2022","48","1","49","2024-12-30"
"52044","2024","COM","2022","527","14","541","2024-12-30"
"52045","2024","COM","2022","1797","33","1830","2024-12-30"
"52047","2024","COM","2022","102","0","102","2024-12-30"
"52050","2024","COM","2022","1334","20","1354","2024-12-30"
"52051","2024","COM","2022","80","4","84","2024-12-30"
"52053","2024","COM","2022","67","1","68","2024-12-30"
"52055","2024","COM","2022","115","1","116","2024-12-30"
"52056","2024","COM","2022","176","8","184","2024-12-30"
"52057","2024","COM","2022","100","4","104","2024-12-30"
"52058","2024","COM","2022","1836","33","1869","2024-12-30"
"52059","2024","COM","2022","131","11","142","2024-12-30"
"52060","2024","COM","2022","1969","53","2022","2024-12-30"
"52061","2024","COM","2022","293","4","297","2024-12-30"
"52062","2024","COM","2022","169","4","173","2024-12-30"
"52063","2024","COM","2022","85","1","86","2024-12-30"
"52064","2024","COM","2022","751","33","784","2024-12-30"
"52065","2024","COM","2022","71","2","73","2024-12-30"
"52066","2024","COM","2022","62","1","63","2024-12-30"
"52067","2024","COM","2022","69","1","70","2024-12-30"
"52069","2024","COM","2022","126","3","129","2024-12-30"
"52070","2024","COM","2022","124","2","126","2024-12-30"
"52072","2024","COM","2022","391","11","402","2024-12-30"
"52074","2024","COM","2022","652","15","667","2024-12-30"
"52075","2024","COM","2022","170","5","175","2024-12-30"
"52076","2024","COM","2022","413","8","421","2024-12-30"
"52079","2024","COM","2022","625","11","636","2024-12-30"
"52082","2024","COM","2022","157","5","162","2024-12-30"
"52083","2024","COM","2022","721","14","735","2024-12-30"
"52084","2024","COM","2022","46","0","46","2024-12-30"
"52085","2024","COM","2022","26","2","28","2024-12-30"
"52087","2024","COM","2022","219","23","242","2024-12-30"
"52088","2024","COM","2022","658","16","674","2024-12-30"
"52089","2024","COM","2022","72","1","73","2024-12-30"
"52090","2024","COM","2022","92","3","95","2024-12-30"
"52091","2024","COM","2022","85","6","91","2024-12-30"
"52092","2024","COM","2022","116","2","118","2024-12-30"
"52093","2024","COM","2022","2347","52","2399","2024-12-30"
"52094","2024","COM","2022","182","3","185","2024-12-30"
"52095","2024","COM","2022","196","2","198","2024-12-30"
"52097","2024","COM","2022","48","1","49","2024-12-30"
"52099","2024","COM","2022","725","6","731","2024-12-30"
"52101","2024","COM","2022","39","1","40","2024-12-30"
"52102","2024","COM","2022","406","6","412","2024-12-30"
"52103","2024","COM","2022","132","2","134","2024-12-30"
"52104","2024","COM","2022","1013","24","1037","2024-12-30"
"52105","2024","COM","2022","290","6","296","2024-12-30"
"52106","2024","COM","2022","128","2","130","2024-12-30"
"52107","2024","COM","2022","201","4","205","2024-12-30"
"52108","2024","COM","2022","149","4","153","2024-12-30"
"52109","2024","COM","2022","6","1","7","2024-12-30"
"52110","2024","COM","2022","160","2","162","2024-12-30"
"52113","2024","COM","2022","246","4","250","2024-12-30"
"52114","2024","COM","2022","1512","22","1534","2024-12-30"
"52115","2024","COM","2022","96","5","101","2024-12-30"
"52116","2024","COM","2022","46","2","48","2024-12-30"
"52118","2024","COM","2022","266","5","271","2024-12-30"
"52119","2024","COM","2022","340","8","348","2024-12-30"
"52120","2024","COM","2022","181","7","188","2024-12-30"
"52121","2024","COM","2022","21418","1119","22537","2024-12-30"
"52122","2024","COM","2022","114","1","115","2024-12-30"
"52123","2024","COM","2022","1277","31","1308","2024-12-30"
"52124","2024","COM","2022","78","0","78","2024-12-30"
"52125","2024","COM","2022","1034","184","1218","2024-12-30"
"52126","2024","COM","2022","158","5","163","2024-12-30"
"52127","2024","COM","2022","78","3","81","2024-12-30"
"52128","2024","COM","2022","152","4","156","2024-12-30"
"52129","2024","COM","2022","109","1","110","2024-12-30"
"52130","2024","COM","2022","183","3","186","2024-12-30"
"52131","2024","COM","2022","88","2","90","2024-12-30"
"52132","2024","COM","2022","155","3","158","2024-12-30"
"52133","2024","COM","2022","71","1","72","2024-12-30"
"52134","2024","COM","2022","208","1","209","2024-12-30"
"52135","2024","COM","2022","85","2","87","2024-12-30"
"52136","2024","COM","2022","105","1","106","2024-12-30"
"52137","2024","COM","2022","22","0","22","2024-12-30"
"52138","2024","COM","2022","62","2","64","2024-12-30"
"52140","2024","COM","2022","666","16","682","2024-12-30"
"52141","2024","COM","2022","293","6","299","2024-12-30"
"52142","2024","COM","2022","77","2","79","2024-12-30"
"52145","2024","COM","2022","119","3","122","2024-12-30"
"52146","2024","COM","2022","169","4","173","2024-12-30"
"52147","2024","COM","2022","93","2","95","2024-12-30"
"52149","2024","COM","2022","87","1","88","2024-12-30"
"52151","2024","COM","2022","148","4","152","2024-12-30"
"52155","2024","COM","2022","527","13","540","2024-12-30"
"52156","2024","COM","2022","407","7","414","2024-12-30"
"52157","2024","COM","2022","12","0","12","2024-12-30"
"52158","2024","COM","2022","286","4","290","2024-12-30"
"52159","2024","COM","2022","25","0","25","2024-12-30"
"52160","2024","COM","2022","61","3","64","2024-12-30"
"52161","2024","COM","2022","72","0","72","2024-12-30"
"52162","2024","COM","2022","203","3","206","2024-12-30"
"52163","2024","COM","2022","385","6","391","2024-12-30"
"52164","2024","COM","2022","198","7","205","2024-12-30"
"52165","2024","COM","2022","197","5","202","2024-12-30"
"52167","2024","COM","2022","243","11","254","2024-12-30"
"52168","2024","COM","2022","66","3","69","2024-12-30"
"52169","2024","COM","2022","83","1","84","2024-12-30"
"52170","2024","COM","2022","176","6","182","2024-12-30"
"52171","2024","COM","2022","243","2","245","2024-12-30"
"52172","2024","COM","2022","273","7","280","2024-12-30"
"52173","2024","COM","2022","75","1","76","2024-12-30"
"52174","2024","COM","2022","39","1","40","2024-12-30"
"52175","2024","COM","2022","381","5","386","2024-12-30"
"52177","2024","COM","2022","753","37","790","2024-12-30"
"52178","2024","COM","2022","367","8","375","2024-12-30"
"52179","2024","COM","2022","16","2","18","2024-12-30"
"52181","2024","COM","2022","94","1","95","2024-12-30"
"52182","2024","COM","2022","2011","31","2042","2024-12-30"
"52183","2024","COM","2022","39","0","39","2024-12-30"
"52184","2024","COM","2022","56","5","61","2024-12-30"
"52185","2024","COM","2022","71","0","71","2024-12-30"
"52187","2024","COM","2022","156","2","158","2024-12-30"
"52189","2024","COM","2022","367","11","378","2024-12-30"
"52190","2024","COM","2022","303","7","310","2024-12-30"
"52193","2024","COM","2022","299","3","302","2024-12-30"
"52194","2024","COM","2022","2001","45","2046","2024-12-30"
"52195","2024","COM","2022","35","0","35","2024-12-30"
"52196","2024","COM","2022","96","5","101","2024-12-30"
"52197","2024","COM","2022","1290","80","1370","2024-12-30"
"52198","2024","COM","2022","62","2","64","2024-12-30"
"52199","2024","COM","2022","51","1","52","2024-12-30"
"52200","2024","COM","2022","70","5","75","2024-12-30"
"52201","2024","COM","2022","71","0","71","2024-12-30"
"52203","2024","COM","2022","146","2","148","2024-12-30"
"52204","2024","COM","2022","60","2","62","2024-12-30"
"52205","2024","COM","2022","681","16","697","2024-12-30"
"52206","2024","COM","2022","155","4","159","2024-12-30"
"52207","2024","COM","2022","88","4","92","2024-12-30"
"52208","2024","COM","2022","161","3","164","2024-12-30"
"52211","2024","COM","2022","1375","25","1400","2024-12-30"
"52212","2024","COM","2022","300","6","306","2024-12-30"
"52213","2024","COM","2022","124","4","128","2024-12-30"
"52214","2024","COM","2022","29","0","29","2024-12-30"
"52216","2024","COM","2022","50","1","51","2024-12-30"
"52217","2024","COM","2022","84","1","85","2024-12-30"
"52218","2024","COM","2022","49","0","49","2024-12-30"
"52219","2024","COM","2022","17","0","17","2024-12-30"
"52220","2024","COM","2022","145","1","146","2024-12-30"
"52221","2024","COM","2022","126","2","128","2024-12-30"
"52222","2024","COM","2022","31","0","31","2024-12-30"
"52223","2024","COM","2022","67","2","69","2024-12-30"
"52227","2024","COM","2022","198","10","208","2024-12-30"
"52228","2024","COM","2022","69","2","71","2024-12-30"
"52229","2024","COM","2022","150","0","150","2024-12-30"
"52230","2024","COM","2022","279","7","286","2024-12-30"
"52231","2024","COM","2022","94","1","95","2024-12-30"
"52232","2024","COM","2022","55","0","55","2024-12-30"
"52233","2024","COM","2022","90","3","93","2024-12-30"
"52234","2024","COM","2022","41","3","44","2024-12-30"
"52235","2024","COM","2022","241","4","245","2024-12-30"
"52237","2024","COM","2022","267","8","275","2024-12-30"
"52240","2024","COM","2022","190","7","197","2024-12-30"
"52242","2024","COM","2022","959","16","975","2024-12-30"
"52243","2024","COM","2022","115","1","116","2024-12-30"
"52244","2024","COM","2022","755","8","763","2024-12-30"
"52245","2024","COM","2022","58","2","60","2024-12-30"
"52246","2024","COM","2022","592","12","604","2024-12-30"
"52247","2024","COM","2022","199","9","208","2024-12-30"
"52248","2024","COM","2022","538","16","554","2024-12-30"
"52249","2024","COM","2022","147","0","147","2024-12-30"
"52250","2024","COM","2022","2944","81","3025","2024-12-30"
"52251","2024","COM","2022","960","18","978","2024-12-30"
"52253","2024","COM","2022","199","3","202","2024-12-30"
"52254","2024","COM","2022","84","4","88","2024-12-30"
"52256","2024","COM","2022","74","2","76","2024-12-30"
"52257","2024","COM","2022","108","1","109","2024-12-30"
"52258","2024","COM","2022","310","2","312","2024-12-30"
"52260","2024","COM","2022","124","2","126","2024-12-30"
"52264","2024","COM","2022","64","1","65","2024-12-30"
"52265","2024","COM","2022","1269","30","1299","2024-12-30"
"52266","2024","COM","2022","66","2","68","2024-12-30"
"52267","2024","COM","2022","233","3","236","2024-12-30"
"52269","2024","COM","2022","7683","401","8084","2024-12-30"
"52271","2024","COM","2022","212","6","218","2024-12-30"
"52272","2024","COM","2022","114","2","116","2024-12-30"
"52273","2024","COM","2022","122","5","127","2024-12-30"
"52274","2024","COM","2022","275","8","283","2024-12-30"
"52275","2024","COM","2022","75","2","77","2024-12-30"
"52276","2024","COM","2022","238","8","246","2024-12-30"
"52277","2024","COM","2022","57","1","58","2024-12-30"
"52278","2024","COM","2022","68","2","70","2024-12-30"
"52280","2024","COM","2022","193","3","196","2024-12-30"
"52282","2024","COM","2022","344","6","350","2024-12-30"
"52284","2024","COM","2022","88","3","91","2024-12-30"
"52285","2024","COM","2022","72","2","74","2024-12-30"
"52286","2024","COM","2022","77","0","77","2024-12-30"
"52287","2024","COM","2022","91","3","94","2024-12-30"
"52288","2024","COM","2022","108","3","111","2024-12-30"
"52289","2024","COM","2022","320","12","332","2024-12-30"
"52290","2024","COM","2022","123","2","125","2024-12-30"
"52291","2024","COM","2022","59","1","60","2024-12-30"
"52292","2024","COM","2022","695","10","705","2024-12-30"
"52294","2024","COM","2022","697","11","708","2024-12-30"
"52295","2024","COM","2022","90","0","90","2024-12-30"
"52297","2024","COM","2022","279","9","288","2024-12-30"
"52298","2024","COM","2022","71","1","72","2024-12-30"
"52300","2024","COM","2022","154","4","158","2024-12-30"
"52301","2024","COM","2022","58","1","59","2024-12-30"
"52302","2024","COM","2022","184","3","187","2024-12-30"
"52303","2024","COM","2022","97","1","98","2024-12-30"
"52304","2024","COM","2022","49","0","49","2024-12-30"
"52305","2024","COM","2022","558","8","566","2024-12-30"
"52306","2024","COM","2022","459","9","468","2024-12-30"
"52307","2024","COM","2022","210","9","219","2024-12-30"
"52308","2024","COM","2022","402","8","410","2024-12-30"
"52310","2024","COM","2022","100","2","102","2024-12-30"
"52311","2024","COM","2022","223","3","226","2024-12-30"
"52312","2024","COM","2022","57","3","60","2024-12-30"
"52313","2024","COM","2022","136","1","137","2024-12-30"
"52315","2024","COM","2022","333","8","341","2024-12-30"
"52316","2024","COM","2022","69","3","72","2024-12-30"
"52318","2024","COM","2022","243","5","248","2024-12-30"
"52319","2024","COM","2022","65","1","66","2024-12-30"
"52320","2024","COM","2022","92","2","94","2024-12-30"
"52321","2024","COM","2022","182","1","183","2024-12-30"
"52322","2024","COM","2022","131","5","136","2024-12-30"
"52325","2024","COM","2022","116","5","121","2024-12-30"
"52326","2024","COM","2022","37","1","38","2024-12-30"
"52327","2024","COM","2022","461","9","470","2024-12-30"
"52328","2024","COM","2022","40","0","40","2024-12-30"
"52330","2024","COM","2022","71","1","72","2024-12-30"
"52331","2024","COM","2022","2112","55","2167","2024-12-30"
"52332","2024","COM","2022","1807","50","1857","2024-12-30"
"52335","2024","COM","2022","111","1","112","2024-12-30"
"52336","2024","COM","2022","132","3","135","2024-12-30"
"52337","2024","COM","2022","65","1","66","2024-12-30"
"52341","2024","COM","2022","132","4","136","2024-12-30"
"52342","2024","COM","2022","25","1","26","2024-12-30"
"52344","2024","COM","2022","30","1","31","2024-12-30"
"52346","2024","COM","2022","368","5","373","2024-12-30"
"52347","2024","COM","2022","211","7","218","2024-12-30"
"52348","2024","COM","2022","591","10","601","2024-12-30"
"52349","2024","COM","2022","292","9","301","2024-12-30"
"52350","2024","COM","2022","67","1","68","2024-12-30"
"52352","2024","COM","2022","59","4","63","2024-12-30"
"52353","2024","COM","2022","3562","64","3626","2024-12-30"
"52354","2024","COM","2022","81","0","81","2024-12-30"
"52355","2024","COM","2022","162","2","164","2024-12-30"
"52356","2024","COM","2022","112","2","114","2024-12-30"
"52357","2024","COM","2022","173","1","174","2024-12-30"
"52358","2024","COM","2022","95","1","96","2024-12-30"
"52359","2024","COM","2022","143","2","145","2024-12-30"
"52360","2024","COM","2022","172","4","176","2024-12-30"
"52362","2024","COM","2022","135","2","137","2024-12-30"
"52363","2024","COM","2022","96","6","102","2024-12-30"
"52364","2024","COM","2022","96","3","99","2024-12-30"
"52365","2024","COM","2022","351","7","358","2024-12-30"
"52366","2024","COM","2022","75","1","76","2024-12-30"
"52367","2024","COM","2022","40","0","40","2024-12-30"
"52369","2024","COM","2022","69","0","69","2024-12-30"
"52370","2024","COM","2022","256","2","258","2024-12-30"
"52371","2024","COM","2022","140","2","142","2024-12-30"
"52372","2024","COM","2022","78","1","79","2024-12-30"
"52373","2024","COM","2022","33","4","37","2024-12-30"
"52374","2024","COM","2022","272","5","277","2024-12-30"
"52375","2024","COM","2022","51","0","51","2024-12-30"
"52376","2024","COM","2022","93","0","93","2024-12-30"
"52377","2024","COM","2022","285","9","294","2024-12-30"
"52378","2024","COM","2022","44","2","46","2024-12-30"
"52380","2024","COM","2022","386","12","398","2024-12-30"
"52383","2024","COM","2022","295","6","301","2024-12-30"
"52384","2024","COM","2022","109","0","109","2024-12-30"
"52385","2024","COM","2022","29","1","30","2024-12-30"
"52386","2024","COM","2022","517","4","521","2024-12-30"
"52388","2024","COM","2022","151","3","154","2024-12-30"
"52390","2024","COM","2022","61","1","62","2024-12-30"
"52391","2024","COM","2022","315","9","324","2024-12-30"
"52392","2024","COM","2022","109","4","113","2024-12-30"
"52393","2024","COM","2022","55","0","55","2024-12-30"
"52394","2024","COM","2022","207","9","216","2024-12-30"
"52395","2024","COM","2022","58","0","58","2024-12-30"
"52396","2024","COM","2022","142","2","144","2024-12-30"
"52397","2024","COM","2022","71","3","74","2024-12-30"
"52398","2024","COM","2022","611","11","622","2024-12-30"
"52399","2024","COM","2022","108","5","113","2024-12-30"
"52400","2024","COM","2022","156","3","159","2024-12-30"
"52401","2024","COM","2022","358","9","367","2024-12-30"
"52403","2024","COM","2022","82","1","83","2024-12-30"
"52405","2024","COM","2022","1140","20","1160","2024-12-30"
"52406","2024","COM","2022","200","5","205","2024-12-30"
"52407","2024","COM","2022","275","9","284","2024-12-30"
"52411","2024","COM","2022","1306","41","1347","2024-12-30"
"52413","2024","COM","2022","106","2","108","2024-12-30"
"52414","2024","COM","2022","740","9","749","2024-12-30"
"52415","2024","COM","2022","124","0","124","2024-12-30"
"52416","2024","COM","2022","62","0","62","2024-12-30"
"52419","2024","COM","2022","119","5","124","2024-12-30"
"52420","2024","COM","2022","129","0","129","2024-12-30"
"52421","2024","COM","2022","409","13","422","2024-12-30"
"52422","2024","COM","2022","248","6","254","2024-12-30"
"52423","2024","COM","2022","615","13","628","2024-12-30"
"52424","2024","COM","2022","69","0","69","2024-12-30"
"52425","2024","COM","2022","184","3","187","2024-12-30"
"52426","2024","COM","2022","129","1","130","2024-12-30"
"52428","2024","COM","2022","65","1","66","2024-12-30"
"52429","2024","COM","2022","583","11","594","2024-12-30"
"52431","2024","COM","2022","156","2","158","2024-12-30"
"52432","2024","COM","2022","1364","28","1392","2024-12-30"
"52433","2024","COM","2022","88","4","92","2024-12-30"
"52436","2024","COM","2022","49","1","50","2024-12-30"
"52437","2024","COM","2022","25","0","25","2024-12-30"
"52438","2024","COM","2022","114","2","116","2024-12-30"
"52439","2024","COM","2022","69","1","70","2024-12-30"
"52440","2024","COM","2022","368","6","374","2024-12-30"
"52442","2024","COM","2022","351","12","363","2024-12-30"
"52443","2024","COM","2022","33","0","33","2024-12-30"
"52444","2024","COM","2022","335","9","344","2024-12-30"
"52445","2024","COM","2022","71","1","72","2024-12-30"
"52446","2024","COM","2022","236","2","238","2024-12-30"
"52447","2024","COM","2022","179","2","181","2024-12-30"
"52448","2024","COM","2022","22811","400","23211","2024-12-30"
"52449","2024","COM","2022","1097","31","1128","2024-12-30"
"52450","2024","COM","2022","129","4","133","2024-12-30"
"52452","2024","COM","2022","106","0","106","2024-12-30"
"52453","2024","COM","2022","127","2","129","2024-12-30"
"52455","2024","COM","2022","250","6","256","2024-12-30"
"52456","2024","COM","2022","605","16","621","2024-12-30"
"52457","2024","COM","2022","173","2","175","2024-12-30"
"52459","2024","COM","2022","99","2","101","2024-12-30"
"52461","2024","COM","2022","369","12","381","2024-12-30"
"52463","2024","COM","2022","42","2","44","2024-12-30"
"52464","2024","COM","2022","52","2","54","2024-12-30"
"52465","2024","COM","2022","134","3","137","2024-12-30"
"52467","2024","COM","2022","58","0","58","2024-12-30"
"52468","2024","COM","2022","99","2","101","2024-12-30"
"52469","2024","COM","2022","723","18","741","2024-12-30"
"52470","2024","COM","2022","367","16","383","2024-12-30"
"52472","2024","COM","2022","151","1","152","2024-12-30"
"52473","2024","COM","2022","88","2","90","2024-12-30"
"52474","2024","COM","2022","33","0","33","2024-12-30"
"52475","2024","COM","2022","55","6","61","2024-12-30"
"52476","2024","COM","2022","77","3","80","2024-12-30"
"52479","2024","COM","2022","648","15","663","2024-12-30"
"52480","2024","COM","2022","330","6","336","2024-12-30"
"52482","2024","COM","2022","98","1","99","2024-12-30"
"52483","2024","COM","2022","68","1","69","2024-12-30"
"52484","2024","COM","2022","361","15","376","2024-12-30"
"52486","2024","COM","2022","60","2","62","2024-12-30"
"52487","2024","COM","2022","62","2","64","2024-12-30"
"52488","2024","COM","2022","276","2","278","2024-12-30"
"52489","2024","COM","2022","30","1","31","2024-12-30"
"52490","2024","COM","2022","703","12","715","2024-12-30"
"52491","2024","COM","2022","107","1","108","2024-12-30"
"52492","2024","COM","2022","553","12","565","2024-12-30"
"52493","2024","COM","2022","29","0","29","2024-12-30"
"52494","2024","COM","2022","217","7","224","2024-12-30"
"52495","2024","COM","2022","83","1","84","2024-12-30"
"52497","2024","COM","2022","432","13","445","2024-12-30"
"52499","2024","COM","2022","46","0","46","2024-12-30"
"52500","2024","COM","2022","608","5","613","2024-12-30"
"52502","2024","COM","2022","63","1","64","2024-12-30"
"52503","2024","COM","2022","24","0","24","2024-12-30"
"52504","2024","COM","2022","257","3","260","2024-12-30"
"52505","2024","COM","2022","32","0","32","2024-12-30"
"52506","2024","COM","2022","83","1","84","2024-12-30"
"52507","2024","COM","2022","53","0","53","2024-12-30"
"52510","2024","COM","2022","347","6","353","2024-12-30"
"52511","2024","COM","2022","56","1","57","2024-12-30"
"52512","2024","COM","2022","506","12","518","2024-12-30"
"52513","2024","COM","2022","62","1","63","2024-12-30"
"52514","2024","COM","2022","319","14","333","2024-12-30"
"52515","2024","COM","2022","111","3","114","2024-12-30"
"52516","2024","COM","2022","48","4","52","2024-12-30"
"52517","2024","COM","2022","122","3","125","2024-12-30"
"52518","2024","COM","2022","103","2","105","2024-12-30"
"52519","2024","COM","2022","47","0","47","2024-12-30"
"52520","2024","COM","2022","161","4","165","2024-12-30"
"52522","2024","COM","2022","336","10","346","2024-12-30"
"52523","2024","COM","2022","66","1","67","2024-12-30"
"52524","2024","COM","2022","219","4","223","2024-12-30"
"52525","2024","COM","2022","62","2","64","2024-12-30"
"52526","2024","COM","2022","79","1","80","2024-12-30"
"52528","2024","COM","2022","148","5","153","2024-12-30"
"52529","2024","COM","2022","993","18","1011","2024-12-30"
"52534","2024","COM","2022","1477","32","1509","2024-12-30"
"52535","2024","COM","2022","739","13","752","2024-12-30"
"52536","2024","COM","2022","47","1","48","2024-12-30"
"52538","2024","COM","2022","258","5","263","2024-12-30"
"52539","2024","COM","2022","64","0","64","2024-12-30"
"52540","2024","COM","2022","29","0","29","2024-12-30"
"52541","2024","COM","2022","217","3","220","2024-12-30"
"52542","2024","COM","2022","51","2","53","2024-12-30"
"52543","2024","COM","2022","515","10","525","2024-12-30"
"52544","2024","COM","2022","275","2","277","2024-12-30"
"52545","2024","COM","2022","102","2","104","2024-12-30"
"52546","2024","COM","2022","17","0","17","2024-12-30"
"52547","2024","COM","2022","208","9","217","2024-12-30"
"52548","2024","COM","2022","84","3","87","2024-12-30"
"52549","2024","COM","2022","27","0","27","2024-12-30"
"52550","2024","COM","2022","2776","106","2882","2024-12-30"
"53001","2024","COM","2022","1864","61","1925","2024-12-30"
"53002","2024","COM","2022","612","12","624","2024-12-30"
"53003","2024","COM","2022","2603","68","2671","2024-12-30"
"53005","2024","COM","2022","2324","64","2388","2024-12-30"
"53007","2024","COM","2022","2908","72","2980","2024-12-30"
"53008","2024","COM","2022","1830","41","1871","2024-12-30"
"53009","2024","COM","2022","672","13","685","2024-12-30"
"53010","2024","COM","2022","419","6","425","2024-12-30"
"53011","2024","COM","2022","887","19","906","2024-12-30"
"53012","2024","COM","2022","453","25","478","2024-12-30"
"53013","2024","COM","2022","555","19","574","2024-12-30"
"53015","2024","COM","2022","1964","40","2004","2024-12-30"
"53016","2024","COM","2022","1220","17","1237","2024-12-30"
"53017","2024","COM","2022","971","26","997","2024-12-30"
"53018","2024","COM","2022","1298","42","1340","2024-12-30"
"53019","2024","COM","2022","119","2","121","2024-12-30"
"53021","2024","COM","2022","966","35","1001","2024-12-30"
"53022","2024","COM","2022","495","11","506","2024-12-30"
"53023","2024","COM","2022","550","12","562","2024-12-30"
"53025","2024","COM","2022","1086","21","1107","2024-12-30"
"53026","2024","COM","2022","500","12","512","2024-12-30"
"53027","2024","COM","2022","203","2","205","2024-12-30"
"53028","2024","COM","2022","560","11","571","2024-12-30"
"53029","2024","COM","2022","1280","28","1308","2024-12-30"
"53030","2024","COM","2022","320","4","324","2024-12-30"
"53031","2024","COM","2022","490","4","494","2024-12-30"
"53033","2024","COM","2022","116","4","120","2024-12-30"
"53034","2024","COM","2022","6294","196","6490","2024-12-30"
"53035","2024","COM","2022","611","9","620","2024-12-30"
"53036","2024","COM","2022","1066","17","1083","2024-12-30"
"53037","2024","COM","2022","718","25","743","2024-12-30"
"53038","2024","COM","2022","136","6","142","2024-12-30"
"53039","2024","COM","2022","1726","34","1760","2024-12-30"
"53040","2024","COM","2022","618","10","628","2024-12-30"
"53041","2024","COM","2022","276","7","283","2024-12-30"
"53042","2024","COM","2022","833","12","845","2024-12-30"
"53043","2024","COM","2022","584","9","593","2024-12-30"
"53045","2024","COM","2022","674","19","693","2024-12-30"
"53046","2024","COM","2022","313","12","325","2024-12-30"
"53047","2024","COM","2022","254","8","262","2024-12-30"
"53048","2024","COM","2022","1173","25","1198","2024-12-30"
"53049","2024","COM","2022","691","15","706","2024-12-30"
"53051","2024","COM","2022","624","13","637","2024-12-30"
"53052","2024","COM","2022","282","6","288","2024-12-30"
"53053","2024","COM","2022","495","9","504","2024-12-30"
"53054","2024","COM","2022","6482","160","6642","2024-12-30"
"53055","2024","COM","2022","599","16","615","2024-12-30"
"53056","2024","COM","2022","963","26","989","2024-12-30"
"53057","2024","COM","2022","503","7","510","2024-12-30"
"53058","2024","COM","2022","315","12","327","2024-12-30"
"53059","2024","COM","2022","413","17","430","2024-12-30"
"53061","2024","COM","2022","455","12","467","2024-12-30"
"53062","2024","COM","2022","16539","669","17208","2024-12-30"
"53063","2024","COM","2022","464","9","473","2024-12-30"
"53064","2024","COM","2022","960","24","984","2024-12-30"
"53066","2024","COM","2022","1363","34","1397","2024-12-30"
"53067","2024","COM","2022","433","11","444","2024-12-30"
"53068","2024","COM","2022","155","0","155","2024-12-30"
"53069","2024","COM","2022","152","2","154","2024-12-30"
"53071","2024","COM","2022","477","23","500","2024-12-30"
"53072","2024","COM","2022","1289","27","1316","2024-12-30"
"53073","2024","COM","2022","919","15","934","2024-12-30"
"53074","2024","COM","2022","840","36","876","2024-12-30"
"53075","2024","COM","2022","298","3","301","2024-12-30"
"53076","2024","COM","2022","307","10","317","2024-12-30"
"53077","2024","COM","2022","3208","76","3284","2024-12-30"
"53078","2024","COM","2022","867","17","884","2024-12-30"
"53079","2024","COM","2022","377","8","385","2024-12-30"
"53080","2024","COM","2022","114","1","115","2024-12-30"
"53082","2024","COM","2022","633","12","645","2024-12-30"
"53083","2024","COM","2022","808","29","837","2024-12-30"
"53084","2024","COM","2022","4415","148","4563","2024-12-30"
"53085","2024","COM","2022","197","2","199","2024-12-30"
"53086","2024","COM","2022","633","13","646","2024-12-30"
"53087","2024","COM","2022","226","10","236","2024-12-30"
"53088","2024","COM","2022","853","11","864","2024-12-30"
"53089","2024","COM","2022","533","9","542","2024-12-30"
"53090","2024","COM","2022","184","4","188","2024-12-30"
"53091","2024","COM","2022","461","9","470","2024-12-30"
"53093","2024","COM","2022","288","4","292","2024-12-30"
"53094","2024","COM","2022","2278","43","2321","2024-12-30"
"53096","2024","COM","2022","5511","100","5611","2024-12-30"
"53097","2024","COM","2022","8380","178","8558","2024-12-30"
"53098","2024","COM","2022","423","10","433","2024-12-30"
"53099","2024","COM","2022","1096","25","1121","2024-12-30"
"53100","2024","COM","2022","1186","19","1205","2024-12-30"
"53101","2024","COM","2022","838","8","846","2024-12-30"
"53102","2024","COM","2022","166","4","170","2024-12-30"
"53103","2024","COM","2022","2127","61","2188","2024-12-30"
"53104","2024","COM","2022","1351","29","1380","2024-12-30"
"53105","2024","COM","2022","238","5","243","2024-12-30"
"53106","2024","COM","2022","541","10","551","2024-12-30"
"53107","2024","COM","2022","2475","46","2521","2024-12-30"
"53108","2024","COM","2022","570","11","581","2024-12-30"
"53109","2024","COM","2022","626","20","646","2024-12-30"
"53110","2024","COM","2022","977","17","994","2024-12-30"
"53111","2024","COM","2022","466","19","485","2024-12-30"
"53112","2024","COM","2022","343","10","353","2024-12-30"
"53113","2024","COM","2022","625","10","635","2024-12-30"
"53114","2024","COM","2022","172","3","175","2024-12-30"
"53115","2024","COM","2022","305","7","312","2024-12-30"
"53116","2024","COM","2022","721","18","739","2024-12-30"
"53117","2024","COM","2022","496","12","508","2024-12-30"
"53118","2024","COM","2022","228","7","235","2024-12-30"
"53119","2024","COM","2022","4554","106","4660","2024-12-30"
"53120","2024","COM","2022","458","10","468","2024-12-30"
"53121","2024","COM","2022","1343","24","1367","2024-12-30"
"53122","2024","COM","2022","756","21","777","2024-12-30"
"53123","2024","COM","2022","1332","27","1359","2024-12-30"
"53124","2024","COM","2022","1392","43","1435","2024-12-30"
"53125","2024","COM","2022","1100","26","1126","2024-12-30"
"53126","2024","COM","2022","1012","24","1036","2024-12-30"
"53127","2024","COM","2022","2243","32","2275","2024-12-30"
"53128","2024","COM","2022","322","8","330","2024-12-30"
"53129","2024","COM","2022","358","9","367","2024-12-30"
"53130","2024","COM","2022","49474","2429","51903","2024-12-30"
"53131","2024","COM","2022","184","5","189","2024-12-30"
"53132","2024","COM","2022","274","7","281","2024-12-30"
"53133","2024","COM","2022","710","8","718","2024-12-30"
"53134","2024","COM","2022","187","1","188","2024-12-30"
"53135","2024","COM","2022","728","23","751","2024-12-30"
"53136","2024","COM","2022","1227","33","1260","2024-12-30"
"53137","2024","COM","2022","2724","48","2772","2024-12-30"
"53139","2024","COM","2022","410","8","418","2024-12-30"
"53140","2024","COM","2022","4345","112","4457","2024-12-30"
"53141","2024","COM","2022","1182","32","1214","2024-12-30"
"53142","2024","COM","2022","284","3","287","2024-12-30"
"53143","2024","COM","2022","510","13","523","2024-12-30"
"53144","2024","COM","2022","750","25","775","2024-12-30"
"53145","2024","COM","2022","543","11","554","2024-12-30"
"53146","2024","COM","2022","1884","36","1920","2024-12-30"
"53147","2024","COM","2022","12854","703","13557","2024-12-30"
"53148","2024","COM","2022","230","6","236","2024-12-30"
"53150","2024","COM","2022","907","22","929","2024-12-30"
"53151","2024","COM","2022","1075","20","1095","2024-12-30"
"53152","2024","COM","2022","2784","71","2855","2024-12-30"
"53153","2024","COM","2022","625","17","642","2024-12-30"
"53154","2024","COM","2022","883","19","902","2024-12-30"
"53155","2024","COM","2022","1307","23","1330","2024-12-30"
"53156","2024","COM","2022","250","6","256","2024-12-30"
"53157","2024","COM","2022","1342","55","1397","2024-12-30"
"53158","2024","COM","2022","1030","13","1043","2024-12-30"
"53160","2024","COM","2022","374","7","381","2024-12-30"
"53161","2024","COM","2022","3192","58","3250","2024-12-30"
"53162","2024","COM","2022","977","18","995","2024-12-30"
"53163","2024","COM","2022","757","11","768","2024-12-30"
"53164","2024","COM","2022","345","8","353","2024-12-30"
"53165","2024","COM","2022","347","3","350","2024-12-30"
"53168","2024","COM","2022","1250","24","1274","2024-12-30"
"53169","2024","COM","2022","406","10","416","2024-12-30"
"53170","2024","COM","2022","1124","20","1144","2024-12-30"
"53172","2024","COM","2022","394","8","402","2024-12-30"
"53173","2024","COM","2022","177","6","183","2024-12-30"
"53174","2024","COM","2022","841","24","865","2024-12-30"
"53175","2024","COM","2022","1384","49","1433","2024-12-30"
"53176","2024","COM","2022","522","8","530","2024-12-30"
"53177","2024","COM","2022","296","6","302","2024-12-30"
"53178","2024","COM","2022","228","7","235","2024-12-30"
"53179","2024","COM","2022","354","5","359","2024-12-30"
"53180","2024","COM","2022","659","17","676","2024-12-30"
"53181","2024","COM","2022","808","7","815","2024-12-30"
"53182","2024","COM","2022","1816","18","1834","2024-12-30"
"53184","2024","COM","2022","161","5","166","2024-12-30"
"53185","2024","COM","2022","2300","79","2379","2024-12-30"
"53186","2024","COM","2022","2141","59","2200","2024-12-30"
"53187","2024","COM","2022","230","7","237","2024-12-30"
"53188","2024","COM","2022","2506","57","2563","2024-12-30"
"53189","2024","COM","2022","111","0","111","2024-12-30"
"53190","2024","COM","2022","464","12","476","2024-12-30"
"53191","2024","COM","2022","250","5","255","2024-12-30"
"53192","2024","COM","2022","311","4","315","2024-12-30"
"53193","2024","COM","2022","575","11","586","2024-12-30"
"53195","2024","COM","2022","484","14","498","2024-12-30"
"53196","2024","COM","2022","350","11","361","2024-12-30"
"53197","2024","COM","2022","934","18","952","2024-12-30"
"53198","2024","COM","2022","223","7","230","2024-12-30"
"53199","2024","COM","2022","212","4","216","2024-12-30"
"53200","2024","COM","2022","1181","59","1240","2024-12-30"
"53201","2024","COM","2022","7384","246","7630","2024-12-30"
"53202","2024","COM","2022","294","4","298","2024-12-30"
"53203","2024","COM","2022","524","14","538","2024-12-30"
"53204","2024","COM","2022","399","10","409","2024-12-30"
"53206","2024","COM","2022","219","7","226","2024-12-30"
"53208","2024","COM","2022","502","12","514","2024-12-30"
"53209","2024","COM","2022","559","11","570","2024-12-30"
"53210","2024","COM","2022","1512","25","1537","2024-12-30"
"53211","2024","COM","2022","1440","27","1467","2024-12-30"
"53212","2024","COM","2022","456","9","465","2024-12-30"
"53213","2024","COM","2022","496","16","512","2024-12-30"
"53214","2024","COM","2022","154","4","158","2024-12-30"
"53216","2024","COM","2022","946","27","973","2024-12-30"
"53218","2024","COM","2022","770","25","795","2024-12-30"
"53219","2024","COM","2022","1381","36","1417","2024-12-30"
"53220","2024","COM","2022","378","7","385","2024-12-30"
"53221","2024","COM","2022","394","7","401","2024-12-30"
"53222","2024","COM","2022","365","8","373","2024-12-30"
"53223","2024","COM","2022","329","6","335","2024-12-30"
"53224","2024","COM","2022","1179","39","1218","2024-12-30"
"53225","2024","COM","2022","513","11","524","2024-12-30"
"53226","2024","COM","2022","808","32","840","2024-12-30"
"53228","2024","COM","2022","556","12","568","2024-12-30"
"53229","2024","COM","2022","1689","31","1720","2024-12-30"
"53230","2024","COM","2022","257","4","261","2024-12-30"
"53232","2024","COM","2022","323","3","326","2024-12-30"
"53233","2024","COM","2022","335","2","337","2024-12-30"
"53234","2024","COM","2022","321","8","329","2024-12-30"
"53235","2024","COM","2022","228","5","233","2024-12-30"
"53236","2024","COM","2022","166","2","168","2024-12-30"
"53237","2024","COM","2022","440","12","452","2024-12-30"
"53238","2024","COM","2022","521","16","537","2024-12-30"
"53240","2024","COM","2022","425","6","431","2024-12-30"
"53242","2024","COM","2022","255","3","258","2024-12-30"
"53243","2024","COM","2022","1782","39","1821","2024-12-30"
"53245","2024","COM","2022","927","23","950","2024-12-30"
"53246","2024","COM","2022","1761","36","1797","2024-12-30"
"53247","2024","COM","2022","2313","30","2343","2024-12-30"
"53248","2024","COM","2022","132","3","135","2024-12-30"
"53249","2024","COM","2022","1107","19","1126","2024-12-30"
"53250","2024","COM","2022","391","2","393","2024-12-30"
"53251","2024","COM","2022","475","8","483","2024-12-30"
"53253","2024","COM","2022","518","3","521","2024-12-30"
"53255","2024","COM","2022","1197","13","1210","2024-12-30"
"53256","2024","COM","2022","162","4","166","2024-12-30"
"53257","2024","COM","2022","328","9","337","2024-12-30"
"53258","2024","COM","2022","901","27","928","2024-12-30"
"53259","2024","COM","2022","376","7","383","2024-12-30"
"53260","2024","COM","2022","386","1","387","2024-12-30"
"53261","2024","COM","2022","149","0","149","2024-12-30"
"53262","2024","COM","2022","1060","29","1089","2024-12-30"
"53263","2024","COM","2022","270","5","275","2024-12-30"
"53264","2024","COM","2022","190","4","194","2024-12-30"
"53265","2024","COM","2022","770","13","783","2024-12-30"
"53266","2024","COM","2022","227","4","231","2024-12-30"
"53267","2024","COM","2022","1164","33","1197","2024-12-30"
"53269","2024","COM","2022","612","11","623","2024-12-30"
"53270","2024","COM","2022","110","6","116","2024-12-30"
"53271","2024","COM","2022","2682","44","2726","2024-12-30"
"53272","2024","COM","2022","192","1","193","2024-12-30"
"53273","2024","COM","2022","1080","22","1102","2024-12-30"
"53276","2024","COM","2022","905","18","923","2024-12-30"
"54001","2024","COM","2022","327","5","332","2024-12-30"
"54002","2024","COM","2022","237","4","241","2024-12-30"
"54003","2024","COM","2022","90","5","95","2024-12-30"
"54004","2024","COM","2022","176","3","179","2024-12-30"
"54005","2024","COM","2022","114","2","116","2024-12-30"
"54006","2024","COM","2022","436","5","441","2024-12-30"
"54007","2024","COM","2022","538","5","543","2024-12-30"
"54008","2024","COM","2022","490","6","496","2024-12-30"
"54009","2024","COM","2022","159","2","161","2024-12-30"
"54010","2024","COM","2022","501","6","507","2024-12-30"
"54011","2024","COM","2022","634","10","644","2024-12-30"
"54012","2024","COM","2022","361","3","364","2024-12-30"
"54013","2024","COM","2022","87","2","89","2024-12-30"
"54014","2024","COM","2022","247","7","254","2024-12-30"
"54015","2024","COM","2022","255","6","261","2024-12-30"
"54016","2024","COM","2022","281","7","288","2024-12-30"
"54017","2024","COM","2022","75","0","75","2024-12-30"
"54018","2024","COM","2022","271","4","275","2024-12-30"
"54019","2024","COM","2022","76","1","77","2024-12-30"
"54020","2024","COM","2022","442","9","451","2024-12-30"
"54021","2024","COM","2022","238","1","239","2024-12-30"
"54022","2024","COM","2022","561","10","571","2024-12-30"
"54023","2024","COM","2022","252","6","258","2024-12-30"
"54024","2024","COM","2022","368","3","371","2024-12-30"
"54025","2024","COM","2022","1696","181","1877","2024-12-30"
"54026","2024","COM","2022","167","3","170","2024-12-30"
"54027","2024","COM","2022","899","10","909","2024-12-30"
"54028","2024","COM","2022","2641","18","2659","2024-12-30"
"54029","2024","COM","2022","2477","49","2526","2024-12-30"
"54030","2024","COM","2022","77","2","79","2024-12-30"
"54031","2024","COM","2022","264","3","267","2024-12-30"
"54032","2024","COM","2022","194","4","198","2024-12-30"
"54033","2024","COM","2022","137","0","137","2024-12-30"
"54034","2024","COM","2022","215","5","220","2024-12-30"
"54035","2024","COM","2022","390","4","394","2024-12-30"
"54036","2024","COM","2022","1223","30","1253","2024-12-30"
"54037","2024","COM","2022","417","9","426","2024-12-30"
"54038","2024","COM","2022","770","6","776","2024-12-30"
"54039","2024","COM","2022","4107","55","4162","2024-12-30"
"54040","2024","COM","2022","1533","32","1565","2024-12-30"
"54041","2024","COM","2022","130","7","137","2024-12-30"
"54042","2024","COM","2022","289","5","294","2024-12-30"
"54043","2024","COM","2022","1443","17","1460","2024-12-30"
"54044","2024","COM","2022","202","2","204","2024-12-30"
"54045","2024","COM","2022","431","5","436","2024-12-30"
"54046","2024","COM","2022","392","7","399","2024-12-30"
"54047","2024","COM","2022","270","4","274","2024-12-30"
"54048","2024","COM","2022","329","3","332","2024-12-30"
"54049","2024","COM","2022","520","14","534","2024-12-30"
"54050","2024","COM","2022","69","0","69","2024-12-30"
"54051","2024","COM","2022","1315","28","1343","2024-12-30"
"54052","2024","COM","2022","145","2","147","2024-12-30"
"54053","2024","COM","2022","155","4","159","2024-12-30"
"54054","2024","COM","2022","1556","19","1575","2024-12-30"
"54055","2024","COM","2022","330","4","334","2024-12-30"
"54056","2024","COM","2022","148","3","151","2024-12-30"
"54057","2024","COM","2022","69","2","71","2024-12-30"
"54058","2024","COM","2022","82","0","82","2024-12-30"
"54059","2024","COM","2022","752","10","762","2024-12-30"
"54060","2024","COM","2022","1503","14","1517","2024-12-30"
"54061","2024","COM","2022","590","7","597","2024-12-30"
"54062","2024","COM","2022","642","11","653","2024-12-30"
"54063","2024","COM","2022","175","2","177","2024-12-30"
"54064","2024","COM","2022","318","5","323","2024-12-30"
"54065","2024","COM","2022","1067","14","1081","2024-12-30"
"54066","2024","COM","2022","386","6","392","2024-12-30"
"54067","2024","COM","2022","780","17","797","2024-12-30"
"54068","2024","COM","2022","88","2","90","2024-12-30"
"54069","2024","COM","2022","528","9","537","2024-12-30"
"54070","2024","COM","2022","189","2","191","2024-12-30"
"54071","2024","COM","2022","166","1","167","2024-12-30"
"54072","2024","COM","2022","259","0","259","2024-12-30"
"54073","2024","COM","2022","927","15","942","2024-12-30"
"54074","2024","COM","2022","37","0","37","2024-12-30"
"54075","2024","COM","2022","114","1","115","2024-12-30"
"54076","2024","COM","2022","3885","48","3933","2024-12-30"
"54077","2024","COM","2022","1046","8","1054","2024-12-30"
"54078","2024","COM","2022","54","1","55","2024-12-30"
"54079","2024","COM","2022","4649","28","4677","2024-12-30"
"54080","2024","COM","2022","1028","16","1044","2024-12-30"
"54081","2024","COM","2022","414","6","420","2024-12-30"
"54082","2024","COM","2022","176","1","177","2024-12-30"
"54083","2024","COM","2022","180","3","183","2024-12-30"
"54084","2024","COM","2022","940","14","954","2024-12-30"
"54085","2024","COM","2022","86","2","88","2024-12-30"
"54086","2024","COM","2022","357","8","365","2024-12-30"
"54087","2024","COM","2022","146","1","147","2024-12-30"
"54088","2024","COM","2022","211","6","217","2024-12-30"
"54089","2024","COM","2022","1412","26","1438","2024-12-30"
"54090","2024","COM","2022","4122","40","4162","2024-12-30"
"54091","2024","COM","2022","420","3","423","2024-12-30"
"54092","2024","COM","2022","64","1","65","2024-12-30"
"54093","2024","COM","2022","169","2","171","2024-12-30"
"54094","2024","COM","2022","167","3","170","2024-12-30"
"54095","2024","COM","2022","47","0","47","2024-12-30"
"54096","2024","COM","2022","451","8","459","2024-12-30"
"54097","2024","COM","2022","94","2","96","2024-12-30"
"54098","2024","COM","2022","167","4","171","2024-12-30"
"54099","2024","COM","2022","7906","227","8133","2024-12-30"
"54100","2024","COM","2022","774","9","783","2024-12-30"
"54101","2024","COM","2022","121","3","124","2024-12-30"
"54102","2024","COM","2022","616","16","632","2024-12-30"
"54103","2024","COM","2022","218","4","222","2024-12-30"
"54104","2024","COM","2022","258","1","259","2024-12-30"
"54105","2024","COM","2022","534","12","546","2024-12-30"
"54106","2024","COM","2022","65","1","66","2024-12-30"
"54107","2024","COM","2022","71","1","72","2024-12-30"
"54108","2024","COM","2022","153","6","159","2024-12-30"
"54109","2024","COM","2022","911","21","932","2024-12-30"
"54110","2024","COM","2022","541","10","551","2024-12-30"
"54111","2024","COM","2022","2756","36","2792","2024-12-30"
"54112","2024","COM","2022","732","8","740","2024-12-30"
"54113","2024","COM","2022","1566","15","1581","2024-12-30"
"54114","2024","COM","2022","316","7","323","2024-12-30"
"54115","2024","COM","2022","6588","58","6646","2024-12-30"
"54116","2024","COM","2022","2124","34","2158","2024-12-30"
"54117","2024","COM","2022","113","3","116","2024-12-30"
"54118","2024","COM","2022","616","12","628","2024-12-30"
"54119","2024","COM","2022","89","1","90","2024-12-30"
"54120","2024","COM","2022","321","8","329","2024-12-30"
"54121","2024","COM","2022","197","5","202","2024-12-30"
"54122","2024","COM","2022","730","17","747","2024-12-30"
"54123","2024","COM","2022","1686","14","1700","2024-12-30"
"54124","2024","COM","2022","49","3","52","2024-12-30"
"54125","2024","COM","2022","477","5","482","2024-12-30"
"54126","2024","COM","2022","214","3","217","2024-12-30"
"54127","2024","COM","2022","600","28","628","2024-12-30"
"54128","2024","COM","2022","702","8","710","2024-12-30"
"54129","2024","COM","2022","1579","25","1604","2024-12-30"
"54130","2024","COM","2022","175","2","177","2024-12-30"
"54131","2024","COM","2022","492","9","501","2024-12-30"
"54132","2024","COM","2022","57","1","58","2024-12-30"
"54133","2024","COM","2022","121","0","121","2024-12-30"
"54134","2024","COM","2022","244","2","246","2024-12-30"
"54135","2024","COM","2022","1430","25","1455","2024-12-30"
"54136","2024","COM","2022","2378","43","2421","2024-12-30"
"54137","2024","COM","2022","525","15","540","2024-12-30"
"54138","2024","COM","2022","2805","56","2861","2024-12-30"
"54139","2024","COM","2022","388","5","393","2024-12-30"
"54140","2024","COM","2022","87","0","87","2024-12-30"
"54141","2024","COM","2022","156","2","158","2024-12-30"
"54142","2024","COM","2022","147","3","150","2024-12-30"
"54143","2024","COM","2022","386","7","393","2024-12-30"
"54144","2024","COM","2022","348","6","354","2024-12-30"
"54145","2024","COM","2022","944","16","960","2024-12-30"
"54146","2024","COM","2022","301","1","302","2024-12-30"
"54147","2024","COM","2022","111","2","113","2024-12-30"
"54148","2024","COM","2022","632","5","637","2024-12-30"
"54149","2024","COM","2022","1559","25","1584","2024-12-30"
"54150","2024","COM","2022","3095","25","3120","2024-12-30"
"54151","2024","COM","2022","1042","27","1069","2024-12-30"
"54152","2024","COM","2022","3094","43","3137","2024-12-30"
"54153","2024","COM","2022","57","3","60","2024-12-30"
"54154","2024","COM","2022","461","15","476","2024-12-30"
"54155","2024","COM","2022","388","8","396","2024-12-30"
"54156","2024","COM","2022","465","16","481","2024-12-30"
"54157","2024","COM","2022","4603","39","4642","2024-12-30"
"54158","2024","COM","2022","147","2","149","2024-12-30"
"54159","2024","COM","2022","9528","160","9688","2024-12-30"
"54160","2024","COM","2022","408","8","416","2024-12-30"
"54161","2024","COM","2022","317","6","323","2024-12-30"
"54162","2024","COM","2022","1134","25","1159","2024-12-30"
"54163","2024","COM","2022","264","1","265","2024-12-30"
"54164","2024","COM","2022","79","4","83","2024-12-30"
"54165","2024","COM","2022","567","10","577","2024-12-30"
"54166","2024","COM","2022","27","2","29","2024-12-30"
"54167","2024","COM","2022","1991","34","2025","2024-12-30"
"54168","2024","COM","2022","311","2","313","2024-12-30"
"54169","2024","COM","2022","99","3","102","2024-12-30"
"54170","2024","COM","2022","70","1","71","2024-12-30"
"54171","2024","COM","2022","1120","18","1138","2024-12-30"
"54172","2024","COM","2022","294","6","300","2024-12-30"
"54173","2024","COM","2022","207","4","211","2024-12-30"
"54174","2024","COM","2022","4457","62","4519","2024-12-30"
"54175","2024","COM","2022","350","4","354","2024-12-30"
"54176","2024","COM","2022","1062","23","1085","2024-12-30"
"54177","2024","COM","2022","240","8","248","2024-12-30"
"54178","2024","COM","2022","196","6","202","2024-12-30"
"54179","2024","COM","2022","297","5","302","2024-12-30"
"54180","2024","COM","2022","68","1","69","2024-12-30"
"54181","2024","COM","2022","682","9","691","2024-12-30"
"54182","2024","COM","2022","328","4","332","2024-12-30"
"54183","2024","COM","2022","75","1","76","2024-12-30"
"54184","2024","COM","2022","8733","185","8918","2024-12-30"
"54185","2024","COM","2022","59","1","60","2024-12-30"
"54186","2024","COM","2022","1116","17","1133","2024-12-30"
"54187","2024","COM","2022","107","0","107","2024-12-30"
"54188","2024","COM","2022","1391","10","1401","2024-12-30"
"54189","2024","COM","2022","581","14","595","2024-12-30"
"54190","2024","COM","2022","106","3","109","2024-12-30"
"54191","2024","COM","2022","105","2","107","2024-12-30"
"54192","2024","COM","2022","344","5","349","2024-12-30"
"54193","2024","COM","2022","59","2","61","2024-12-30"
"54194","2024","COM","2022","524","11","535","2024-12-30"
"54195","2024","COM","2022","161","3","164","2024-12-30"
"54196","2024","COM","2022","1664","90","1754","2024-12-30"
"54197","2024","COM","2022","2187","26","2213","2024-12-30"
"54198","2024","COM","2022","300","4","304","2024-12-30"
"54199","2024","COM","2022","385","8","393","2024-12-30"
"54200","2024","COM","2022","163","1","164","2024-12-30"
"54201","2024","COM","2022","311","1","312","2024-12-30"
"54202","2024","COM","2022","368","10","378","2024-12-30"
"54203","2024","COM","2022","159","3","162","2024-12-30"
"54204","2024","COM","2022","89","2","91","2024-12-30"
"54205","2024","COM","2022","2622","13","2635","2024-12-30"
"54206","2024","COM","2022","363","8","371","2024-12-30"
"54207","2024","COM","2022","84","4","88","2024-12-30"
"54208","2024","COM","2022","295","6","301","2024-12-30"
"54209","2024","COM","2022","63","0","63","2024-12-30"
"54210","2024","COM","2022","223","2","225","2024-12-30"
"54211","2024","COM","2022","209","3","212","2024-12-30"
"54212","2024","COM","2022","413","14","427","2024-12-30"
"54213","2024","COM","2022","369","4","373","2024-12-30"
"54214","2024","COM","2022","713","9","722","2024-12-30"
"54215","2024","COM","2022","6480","68","6548","2024-12-30"
"54216","2024","COM","2022","121","3","124","2024-12-30"
"54217","2024","COM","2022","184","3","187","2024-12-30"
"54218","2024","COM","2022","49","1","50","2024-12-30"
"54219","2024","COM","2022","82","0","82","2024-12-30"
"54220","2024","COM","2022","76","0","76","2024-12-30"
"54221","2024","COM","2022","243","7","250","2024-12-30"
"54222","2024","COM","2022","1319","20","1339","2024-12-30"
"54223","2024","COM","2022","188","1","189","2024-12-30"
"54224","2024","COM","2022","130","0","130","2024-12-30"
"54225","2024","COM","2022","183","2","185","2024-12-30"
"54226","2024","COM","2022","175","3","178","2024-12-30"
"54227","2024","COM","2022","1370","18","1388","2024-12-30"
"54228","2024","COM","2022","71","4","75","2024-12-30"
"54229","2024","COM","2022","376","6","382","2024-12-30"
"54230","2024","COM","2022","56","0","56","2024-12-30"
"54231","2024","COM","2022","180","3","183","2024-12-30"
"54232","2024","COM","2022","2643","50","2693","2024-12-30"
"54233","2024","COM","2022","32","2","34","2024-12-30"
"54234","2024","COM","2022","2968","50","3018","2024-12-30"
"54235","2024","COM","2022","419","9","428","2024-12-30"
"54236","2024","COM","2022","362","6","368","2024-12-30"
"54237","2024","COM","2022","113","2","115","2024-12-30"
"54238","2024","COM","2022","271","1","272","2024-12-30"
"54239","2024","COM","2022","138","1","139","2024-12-30"
"54240","2024","COM","2022","52","0","52","2024-12-30"
"54241","2024","COM","2022","70","2","72","2024-12-30"
"54242","2024","COM","2022","281","2","283","2024-12-30"
"54243","2024","COM","2022","223","2","225","2024-12-30"
"54244","2024","COM","2022","110","3","113","2024-12-30"
"54245","2024","COM","2022","59","5","64","2024-12-30"
"54246","2024","COM","2022","65","1","66","2024-12-30"
"54247","2024","COM","2022","189","3","192","2024-12-30"
"54248","2024","COM","2022","97","3","100","2024-12-30"
"54249","2024","COM","2022","257","4","261","2024-12-30"
"54250","2024","COM","2022","732","5","737","2024-12-30"
"54251","2024","COM","2022","134","1","135","2024-12-30"
"54252","2024","COM","2022","514","6","520","2024-12-30"
"54253","2024","COM","2022","806","12","818","2024-12-30"
"54254","2024","COM","2022","3483","44","3527","2024-12-30"
"54255","2024","COM","2022","82","1","83","2024-12-30"
"54256","2024","COM","2022","318","6","324","2024-12-30"
"54257","2024","COM","2022","5396","81","5477","2024-12-30"
"54258","2024","COM","2022","149","2","151","2024-12-30"
"54259","2024","COM","2022","213","3","216","2024-12-30"
"54260","2024","COM","2022","903","14","917","2024-12-30"
"54261","2024","COM","2022","4176","52","4228","2024-12-30"
"54262","2024","COM","2022","206","0","206","2024-12-30"
"54263","2024","COM","2022","6250","43","6293","2024-12-30"
"54264","2024","COM","2022","350","0","350","2024-12-30"
"54265","2024","COM","2022","2069","40","2109","2024-12-30"
"54266","2024","COM","2022","399","7","406","2024-12-30"
"54268","2024","COM","2022","131","5","136","2024-12-30"
"54269","2024","COM","2022","316","7","323","2024-12-30"
"54270","2024","COM","2022","3921","68","3989","2024-12-30"
"54271","2024","COM","2022","113","2","115","2024-12-30"
"54272","2024","COM","2022","470","6","476","2024-12-30"
"54273","2024","COM","2022","8090","163","8253","2024-12-30"
"54274","2024","COM","2022","9362","214","9576","2024-12-30"
"54275","2024","COM","2022","200","2","202","2024-12-30"
"54276","2024","COM","2022","788","8","796","2024-12-30"
"54277","2024","COM","2022","369","1","370","2024-12-30"
"54278","2024","COM","2022","101","2","103","2024-12-30"
"54279","2024","COM","2022","1016","21","1037","2024-12-30"
"54280","2024","COM","2022","6509","52","6561","2024-12-30"
"54281","2024","COM","2022","889","11","900","2024-12-30"
"54282","2024","COM","2022","154","4","158","2024-12-30"
"54283","2024","COM","2022","280","6","286","2024-12-30"
"54284","2024","COM","2022","1108","20","1128","2024-12-30"
"54285","2024","COM","2022","42","1","43","2024-12-30"
"54286","2024","COM","2022","1564","30","1594","2024-12-30"
"54287","2024","COM","2022","260","1","261","2024-12-30"
"54288","2024","COM","2022","498","9","507","2024-12-30"
"54289","2024","COM","2022","353","10","363","2024-12-30"
"54290","2024","COM","2022","209","3","212","2024-12-30"
"54291","2024","COM","2022","301","5","306","2024-12-30"
"54292","2024","COM","2022","180","4","184","2024-12-30"
"54293","2024","COM","2022","85","1","86","2024-12-30"
"54294","2024","COM","2022","137","1","138","2024-12-30"
"54295","2024","COM","2022","979","127","1106","2024-12-30"
"54296","2024","COM","2022","431","3","434","2024-12-30"
"54297","2024","COM","2022","301","4","305","2024-12-30"
"54298","2024","COM","2022","155","0","155","2024-12-30"
"54299","2024","COM","2022","226","6","232","2024-12-30"
"54300","2024","COM","2022","6595","66","6661","2024-12-30"
"54301","2024","COM","2022","130","4","134","2024-12-30"
"54302","2024","COM","2022","734","16","750","2024-12-30"
"54303","2024","COM","2022","365","3","368","2024-12-30"
"54304","2024","COM","2022","15126","173","15299","2024-12-30"
"54305","2024","COM","2022","2367","47","2414","2024-12-30"
"54306","2024","COM","2022","339","6","345","2024-12-30"
"54307","2024","COM","2022","149","4","153","2024-12-30"
"54308","2024","COM","2022","149","1","150","2024-12-30"
"54309","2024","COM","2022","414","3","417","2024-12-30"
"54310","2024","COM","2022","2","0","2","2024-12-30"
"54311","2024","COM","2022","592","7","599","2024-12-30"
"54312","2024","COM","2022","503","5","508","2024-12-30"
"54313","2024","COM","2022","226","3","229","2024-12-30"
"54314","2024","COM","2022","3902","62","3964","2024-12-30"
"54315","2024","COM","2022","910","12","922","2024-12-30"
"54316","2024","COM","2022","312","3","315","2024-12-30"
"54317","2024","COM","2022","131","5","136","2024-12-30"
"54318","2024","COM","2022","5656","67","5723","2024-12-30"
"54320","2024","COM","2022","323","4","327","2024-12-30"
"54321","2024","COM","2022","2373","23","2396","2024-12-30"
"54322","2024","COM","2022","5141","57","5198","2024-12-30"
"54323","2024","COM","2022","15492","222","15714","2024-12-30"
"54324","2024","COM","2022","87","3","90","2024-12-30"
"54325","2024","COM","2022","78","8","86","2024-12-30"
"54326","2024","COM","2022","215","10","225","2024-12-30"
"54327","2024","COM","2022","624","15","639","2024-12-30"
"54328","2024","COM","2022","5899","79","5978","2024-12-30"
"54329","2024","COM","2022","17920","290","18210","2024-12-30"
"54330","2024","COM","2022","416","10","426","2024-12-30"
"54331","2024","COM","2022","284","1","285","2024-12-30"
"54332","2024","COM","2022","1495","18","1513","2024-12-30"
"54333","2024","COM","2022","244","14","258","2024-12-30"
"54334","2024","COM","2022","555","9","564","2024-12-30"
"54335","2024","COM","2022","405","4","409","2024-12-30"
"54336","2024","COM","2022","917","6","923","2024-12-30"
"54337","2024","COM","2022","125","4","129","2024-12-30"
"54338","2024","COM","2022","986","14","1000","2024-12-30"
"54339","2024","COM","2022","7818","284","8102","2024-12-30"
"54340","2024","COM","2022","335","7","342","2024-12-30"
"54343","2024","COM","2022","201","5","206","2024-12-30"
"54344","2024","COM","2022","209","3","212","2024-12-30"
"54345","2024","COM","2022","338","4","342","2024-12-30"
"54346","2024","COM","2022","254","4","258","2024-12-30"
"54348","2024","COM","2022","239","9","248","2024-12-30"
"54349","2024","COM","2022","171","1","172","2024-12-30"
"54350","2024","COM","2022","702","12","714","2024-12-30"
"54351","2024","COM","2022","1671","21","1692","2024-12-30"
"54352","2024","COM","2022","837","11","848","2024-12-30"
"54353","2024","COM","2022","885","14","899","2024-12-30"
"54354","2024","COM","2022","51","0","51","2024-12-30"
"54355","2024","COM","2022","91","1","92","2024-12-30"
"54356","2024","COM","2022","64","3","67","2024-12-30"
"54357","2024","COM","2022","10014","118","10132","2024-12-30"
"54358","2024","COM","2022","285","3","288","2024-12-30"
"54359","2024","COM","2022","243","5","248","2024-12-30"
"54360","2024","COM","2022","342","8","350","2024-12-30"
"54362","2024","COM","2022","1276","15","1291","2024-12-30"
"54363","2024","COM","2022","268","6","274","2024-12-30"
"54364","2024","COM","2022","1288","18","1306","2024-12-30"
"54365","2024","COM","2022","328","9","337","2024-12-30"
"54366","2024","COM","2022","1994","19","2013","2024-12-30"
"54367","2024","COM","2022","2303","65","2368","2024-12-30"
"54368","2024","COM","2022","173","3","176","2024-12-30"
"54369","2024","COM","2022","597","8","605","2024-12-30"
"54370","2024","COM","2022","226","4","230","2024-12-30"
"54371","2024","COM","2022","1097","21","1118","2024-12-30"
"54372","2024","COM","2022","532","2","534","2024-12-30"
"54373","2024","COM","2022","612","9","621","2024-12-30"
"54374","2024","COM","2022","533","9","542","2024-12-30"
"54375","2024","COM","2022","1089","17","1106","2024-12-30"
"54376","2024","COM","2022","401","7","408","2024-12-30"
"54377","2024","COM","2022","151","0","151","2024-12-30"
"54378","2024","COM","2022","479","11","490","2024-12-30"
"54379","2024","COM","2022","95","1","96","2024-12-30"
"54380","2024","COM","2022","415","10","425","2024-12-30"
"54381","2024","COM","2022","52","2","54","2024-12-30"
"54382","2024","COM","2022","9282","95","9377","2024-12-30"
"54383","2024","COM","2022","1132","13","1145","2024-12-30"
"54385","2024","COM","2022","1076","23","1099","2024-12-30"
"54386","2024","COM","2022","93","1","94","2024-12-30"
"54387","2024","COM","2022","167","0","167","2024-12-30"
"54388","2024","COM","2022","75","1","76","2024-12-30"
"54389","2024","COM","2022","104","0","104","2024-12-30"
"54390","2024","COM","2022","102","2","104","2024-12-30"
"54391","2024","COM","2022","1591","11","1602","2024-12-30"
"54392","2024","COM","2022","320","8","328","2024-12-30"
"54393","2024","COM","2022","522","7","529","2024-12-30"
"54394","2024","COM","2022","237","5","242","2024-12-30"
"54395","2024","COM","2022","104387","1405","105792","2024-12-30"
"54396","2024","COM","2022","212","13","225","2024-12-30"
"54397","2024","COM","2022","6572","48","6620","2024-12-30"
"54398","2024","COM","2022","92","6","98","2024-12-30"
"54399","2024","COM","2022","251","2","253","2024-12-30"
"54400","2024","COM","2022","1139","22","1161","2024-12-30"
"54401","2024","COM","2022","134","3","137","2024-12-30"
"54402","2024","COM","2022","418","10","428","2024-12-30"
"54403","2024","COM","2022","1161","34","1195","2024-12-30"
"54404","2024","COM","2022","233","5","238","2024-12-30"
"54405","2024","COM","2022","522","1","523","2024-12-30"
"54406","2024","COM","2022","279","6","285","2024-12-30"
"54407","2024","COM","2022","91","2","93","2024-12-30"
"54408","2024","COM","2022","223","6","229","2024-12-30"
"54409","2024","COM","2022","193","3","196","2024-12-30"
"54410","2024","COM","2022","509","7","516","2024-12-30"
"54411","2024","COM","2022","221","6","227","2024-12-30"
"54412","2024","COM","2022","39","0","39","2024-12-30"
"54413","2024","COM","2022","147","2","149","2024-12-30"
"54414","2024","COM","2022","649","10","659","2024-12-30"
"54415","2024","COM","2022","3953","62","4015","2024-12-30"
"54416","2024","COM","2022","175","4","179","2024-12-30"
"54417","2024","COM","2022","245","6","251","2024-12-30"
"54418","2024","COM","2022","179","2","181","2024-12-30"
"54419","2024","COM","2022","72","2","74","2024-12-30"
"54420","2024","COM","2022","94","2","96","2024-12-30"
"54421","2024","COM","2022","307","4","311","2024-12-30"
"54422","2024","COM","2022","66","1","67","2024-12-30"
"54423","2024","COM","2022","330","10","340","2024-12-30"
"54424","2024","COM","2022","41","2","43","2024-12-30"
"54425","2024","COM","2022","2443","20","2463","2024-12-30"
"54426","2024","COM","2022","474","7","481","2024-12-30"
"54427","2024","COM","2022","96","1","97","2024-12-30"
"54428","2024","COM","2022","827","10","837","2024-12-30"
"54429","2024","COM","2022","298","1","299","2024-12-30"
"54430","2024","COM","2022","4815","51","4866","2024-12-30"
"54431","2024","COM","2022","14383","242","14625","2024-12-30"
"54432","2024","COM","2022","1784","40","1824","2024-12-30"
"54433","2024","COM","2022","230","6","236","2024-12-30"
"54434","2024","COM","2022","251","2","253","2024-12-30"
"54435","2024","COM","2022","373","7","380","2024-12-30"
"54436","2024","COM","2022","159","4","163","2024-12-30"
"54437","2024","COM","2022","1151","21","1172","2024-12-30"
"54438","2024","COM","2022","55","0","55","2024-12-30"
"54439","2024","COM","2022","5123","64","5187","2024-12-30"
"54440","2024","COM","2022","112","0","112","2024-12-30"
"54441","2024","COM","2022","221","5","226","2024-12-30"
"54442","2024","COM","2022","96","1","97","2024-12-30"
"54443","2024","COM","2022","39","1","40","2024-12-30"
"54444","2024","COM","2022","232","3","235","2024-12-30"
"54445","2024","COM","2022","104","3","107","2024-12-30"
"54446","2024","COM","2022","63","2","65","2024-12-30"
"54447","2024","COM","2022","70","2","72","2024-12-30"
"54449","2024","COM","2022","1053","14","1067","2024-12-30"
"54450","2024","COM","2022","152","1","153","2024-12-30"
"54451","2024","COM","2022","3811","75","3886","2024-12-30"
"54452","2024","COM","2022","73","2","75","2024-12-30"
"54453","2024","COM","2022","154","1","155","2024-12-30"
"54455","2024","COM","2022","156","4","160","2024-12-30"
"54456","2024","COM","2022","642","8","650","2024-12-30"
"54457","2024","COM","2022","41","0","41","2024-12-30"
"54458","2024","COM","2022","109","3","112","2024-12-30"
"54459","2024","COM","2022","2362","25","2387","2024-12-30"
"54460","2024","COM","2022","152","3","155","2024-12-30"
"54461","2024","COM","2022","69","0","69","2024-12-30"
"54462","2024","COM","2022","2814","35","2849","2024-12-30"
"54463","2024","COM","2022","248","3","251","2024-12-30"
"54464","2024","COM","2022","102","0","102","2024-12-30"
"54465","2024","COM","2022","746","12","758","2024-12-30"
"54466","2024","COM","2022","396","6","402","2024-12-30"
"54467","2024","COM","2022","183","2","185","2024-12-30"
"54468","2024","COM","2022","106","2","108","2024-12-30"
"54469","2024","COM","2022","438","7","445","2024-12-30"
"54470","2024","COM","2022","65","0","65","2024-12-30"
"54471","2024","COM","2022","74","1","75","2024-12-30"
"54472","2024","COM","2022","850","9","859","2024-12-30"
"54473","2024","COM","2022","290","2","292","2024-12-30"
"54474","2024","COM","2022","189","3","192","2024-12-30"
"54475","2024","COM","2022","157","6","163","2024-12-30"
"54476","2024","COM","2022","409","10","419","2024-12-30"
"54477","2024","COM","2022","162","3","165","2024-12-30"
"54478","2024","COM","2022","150","1","151","2024-12-30"
"54479","2024","COM","2022","102","1","103","2024-12-30"
"54480","2024","COM","2022","54","1","55","2024-12-30"
"54481","2024","COM","2022","100","3","103","2024-12-30"
"54482","2024","COM","2022","10100","79","10179","2024-12-30"
"54483","2024","COM","2022","7363","65","7428","2024-12-30"
"54484","2024","COM","2022","179","7","186","2024-12-30"
"54485","2024","COM","2022","308","9","317","2024-12-30"
"54486","2024","COM","2022","325","5","330","2024-12-30"
"54487","2024","COM","2022","65","1","66","2024-12-30"
"54488","2024","COM","2022","40","0","40","2024-12-30"
"54489","2024","COM","2022","151","4","155","2024-12-30"
"54490","2024","COM","2022","1457","17","1474","2024-12-30"
"54491","2024","COM","2022","363","3","366","2024-12-30"
"54492","2024","COM","2022","148","8","156","2024-12-30"
"54493","2024","COM","2022","2261","35","2296","2024-12-30"
"54494","2024","COM","2022","101","0","101","2024-12-30"
"54495","2024","COM","2022","4306","60","4366","2024-12-30"
"54496","2024","COM","2022","371","5","376","2024-12-30"
"54497","2024","COM","2022","66","3","69","2024-12-30"
"54498","2024","COM","2022","5155","58","5213","2024-12-30"
"54499","2024","COM","2022","109","4","113","2024-12-30"
"54500","2024","COM","2022","187","5","192","2024-12-30"
"54501","2024","COM","2022","101","3","104","2024-12-30"
"54502","2024","COM","2022","250","3","253","2024-12-30"
"54504","2024","COM","2022","674","10","684","2024-12-30"
"54505","2024","COM","2022","724","7","731","2024-12-30"
"54507","2024","COM","2022","99","2","101","2024-12-30"
"54508","2024","COM","2022","239","6","245","2024-12-30"
"54509","2024","COM","2022","1002","10","1012","2024-12-30"
"54510","2024","COM","2022","327","4","331","2024-12-30"
"54511","2024","COM","2022","108","4","112","2024-12-30"
"54512","2024","COM","2022","106","2","108","2024-12-30"
"54513","2024","COM","2022","655","4","659","2024-12-30"
"54514","2024","COM","2022","638","14","652","2024-12-30"
"54515","2024","COM","2022","250","3","253","2024-12-30"
"54516","2024","COM","2022","18","0","18","2024-12-30"
"54517","2024","COM","2022","201","3","204","2024-12-30"
"54518","2024","COM","2022","1120","6","1126","2024-12-30"
"54519","2024","COM","2022","595","7","602","2024-12-30"
"54520","2024","COM","2022","383","8","391","2024-12-30"
"54521","2024","COM","2022","2006","20","2026","2024-12-30"
"54522","2024","COM","2022","122","2","124","2024-12-30"
"54523","2024","COM","2022","434","2","436","2024-12-30"
"54524","2024","COM","2022","97","2","99","2024-12-30"
"54525","2024","COM","2022","635","10","645","2024-12-30"
"54526","2024","COM","2022","9040","277","9317","2024-12-30"
"54527","2024","COM","2022","651","17","668","2024-12-30"
"54528","2024","COM","2022","15570","170","15740","2024-12-30"
"54529","2024","COM","2022","28","0","28","2024-12-30"
"54530","2024","COM","2022","91","3","94","2024-12-30"
"54531","2024","COM","2022","62","0","62","2024-12-30"
"54532","2024","COM","2022","158","1","159","2024-12-30"
"54533","2024","COM","2022","2682","32","2714","2024-12-30"
"54534","2024","COM","2022","521","21","542","2024-12-30"
"54535","2024","COM","2022","195","6","201","2024-12-30"
"54536","2024","COM","2022","2434","28","2462","2024-12-30"
"54537","2024","COM","2022","695","31","726","2024-12-30"
"54538","2024","COM","2022","367","3","370","2024-12-30"
"54539","2024","COM","2022","222","9","231","2024-12-30"
"54540","2024","COM","2022","557","4","561","2024-12-30"
"54541","2024","COM","2022","160","2","162","2024-12-30"
"54542","2024","COM","2022","2355","32","2387","2024-12-30"
"54543","2024","COM","2022","124","3","127","2024-12-30"
"54544","2024","COM","2022","142","0","142","2024-12-30"
"54545","2024","COM","2022","211","4","215","2024-12-30"
"54546","2024","COM","2022","932","8","940","2024-12-30"
"54547","2024","COM","2022","29697","298","29995","2024-12-30"
"54548","2024","COM","2022","511","9","520","2024-12-30"
"54549","2024","COM","2022","3555","39","3594","2024-12-30"
"54550","2024","COM","2022","315","7","322","2024-12-30"
"54551","2024","COM","2022","62","1","63","2024-12-30"
"54552","2024","COM","2022","70","1","71","2024-12-30"
"54553","2024","COM","2022","159","3","162","2024-12-30"
"54554","2024","COM","2022","82","0","82","2024-12-30"
"54555","2024","COM","2022","84","0","84","2024-12-30"
"54556","2024","COM","2022","111","4","115","2024-12-30"
"54557","2024","COM","2022","2333","82","2415","2024-12-30"
"54558","2024","COM","2022","284","3","287","2024-12-30"
"54559","2024","COM","2022","320","2","322","2024-12-30"
"54560","2024","COM","2022","53","0","53","2024-12-30"
"54561","2024","COM","2022","38","3","41","2024-12-30"
"54562","2024","COM","2022","124","2","126","2024-12-30"
"54563","2024","COM","2022","1354","19","1373","2024-12-30"
"54564","2024","COM","2022","140","1","141","2024-12-30"
"54565","2024","COM","2022","234","3","237","2024-12-30"
"54566","2024","COM","2022","147","1","148","2024-12-30"
"54567","2024","COM","2022","354","7","361","2024-12-30"
"54568","2024","COM","2022","246","11","257","2024-12-30"
"54569","2024","COM","2022","183","2","185","2024-12-30"
"54570","2024","COM","2022","343","0","343","2024-12-30"
"54571","2024","COM","2022","595","6","601","2024-12-30"
"54572","2024","COM","2022","705","4","709","2024-12-30"
"54573","2024","COM","2022","159","0","159","2024-12-30"
"54574","2024","COM","2022","568","20","588","2024-12-30"
"54575","2024","COM","2022","1562","31","1593","2024-12-30"
"54576","2024","COM","2022","116","1","117","2024-12-30"
"54577","2024","COM","2022","143","1","144","2024-12-30"
"54578","2024","COM","2022","14938","327","15265","2024-12-30"
"54579","2024","COM","2022","330","2","332","2024-12-30"
"54580","2024","COM","2022","10086","89","10175","2024-12-30"
"54581","2024","COM","2022","296","9","305","2024-12-30"
"54582","2024","COM","2022","188","2","190","2024-12-30"
"54583","2024","COM","2022","419","8","427","2024-12-30"
"54584","2024","COM","2022","1020","18","1038","2024-12-30"
"54585","2024","COM","2022","499","10","509","2024-12-30"
"54586","2024","COM","2022","740","11","751","2024-12-30"
"54587","2024","COM","2022","192","6","198","2024-12-30"
"54588","2024","COM","2022","387","4","391","2024-12-30"
"54589","2024","COM","2022","126","0","126","2024-12-30"
"54590","2024","COM","2022","658","8","666","2024-12-30"
"54591","2024","COM","2022","333","7","340","2024-12-30"
"54592","2024","COM","2022","266","3","269","2024-12-30"
"54593","2024","COM","2022","436","9","445","2024-12-30"
"54594","2024","COM","2022","178","2","180","2024-12-30"
"54595","2024","COM","2022","552","14","566","2024-12-30"
"54596","2024","COM","2022","962","9","971","2024-12-30"
"54597","2024","COM","2022","452","9","461","2024-12-30"
"54598","2024","COM","2022","267","6","273","2024-12-30"
"54599","2024","COM","2022","104","0","104","2024-12-30"
"54600","2024","COM","2022","113","2","115","2024-12-30"
"54601","2024","COM","2022","92","3","95","2024-12-30"
"54602","2024","COM","2022","146","2","148","2024-12-30"
"55001","2024","COM","2022","282","10","292","2024-12-30"
"55002","2024","COM","2022","100","2","102","2024-12-30"
"55004","2024","COM","2022","81","0","81","2024-12-30"
"55005","2024","COM","2022","35","1","36","2024-12-30"
"55007","2024","COM","2022","241","1","242","2024-12-30"
"55008","2024","COM","2022","150","6","156","2024-12-30"
"55009","2024","COM","2022","525","13","538","2024-12-30"
"55010","2024","COM","2022","2583","69","2652","2024-12-30"
"55011","2024","COM","2022","243","6","249","2024-12-30"
"55012","2024","COM","2022","425","8","433","2024-12-30"
"55013","2024","COM","2022","458","8","466","2024-12-30"
"55014","2024","COM","2022","367","11","378","2024-12-30"
"55015","2024","COM","2022","470","9","479","2024-12-30"
"55017","2024","COM","2022","112","3","115","2024-12-30"
"55018","2024","COM","2022","35","1","36","2024-12-30"
"55021","2024","COM","2022","80","4","84","2024-12-30"
"55022","2024","COM","2022","120","6","126","2024-12-30"
"55023","2024","COM","2022","121","1","122","2024-12-30"
"55024","2024","COM","2022","160","3","163","2024-12-30"
"55025","2024","COM","2022","268","3","271","2024-12-30"
"55026","2024","COM","2022","127","4","131","2024-12-30"
"55027","2024","COM","2022","161","2","163","2024-12-30"
"55028","2024","COM","2022","103","4","107","2024-12-30"
"55029","2024","COM","2022","14615","600","15215","2024-12-30"
"55031","2024","COM","2022","377","6","383","2024-12-30"
"55032","2024","COM","2022","41","0","41","2024-12-30"
"55033","2024","COM","2022","20","1","21","2024-12-30"
"55034","2024","COM","2022","109","1","110","2024-12-30"
"55035","2024","COM","2022","142","3","145","2024-12-30"
"55036","2024","COM","2022","90","3","93","2024-12-30"
"55037","2024","COM","2022","127","3","130","2024-12-30"
"55038","2024","COM","2022","39","2","41","2024-12-30"
"55039","2024","COM","2022","0","0","0","2024-12-30"
"55040","2024","COM","2022","256","3","259","2024-12-30"
"55041","2024","COM","2022","603","18","621","2024-12-30"
"55042","2024","COM","2022","486","15","501","2024-12-30"
"55043","2024","COM","2022","3023","45","3068","2024-12-30"
"55044","2024","COM","2022","38","0","38","2024-12-30"
"55045","2024","COM","2022","541","11","552","2024-12-30"
"55046","2024","COM","2022","136","4","140","2024-12-30"
"55047","2024","COM","2022","156","6","162","2024-12-30"
"55048","2024","COM","2022","47","0","47","2024-12-30"
"55049","2024","COM","2022","418","9","427","2024-12-30"
"55050","2024","COM","2022","0","0","0","2024-12-30"
"55051","2024","COM","2022","112","0","112","2024-12-30"
"55053","2024","COM","2022","358","6","364","2024-12-30"
"55054","2024","COM","2022","62","1","63","2024-12-30"
"55055","2024","COM","2022","13","1","14","2024-12-30"
"55057","2024","COM","2022","77","2","79","2024-12-30"
"55058","2024","COM","2022","319","10","329","2024-12-30"
"55059","2024","COM","2022","181","2","183","2024-12-30"
"55060","2024","COM","2022","367","11","378","2024-12-30"
"55061","2024","COM","2022","232","6","238","2024-12-30"
"55062","2024","COM","2022","100","1","101","2024-12-30"
"55063","2024","COM","2022","2428","39","2467","2024-12-30"
"55064","2024","COM","2022","118","0","118","2024-12-30"
"55065","2024","COM","2022","117","2","119","2024-12-30"
"55066","2024","COM","2022","130","2","132","2024-12-30"
"55067","2024","COM","2022","97","1","98","2024-12-30"
"55068","2024","COM","2022","100","0","100","2024-12-30"
"55069","2024","COM","2022","222","7","229","2024-12-30"
"55070","2024","COM","2022","117","6","123","2024-12-30"
"55071","2024","COM","2022","172","3","175","2024-12-30"
"55072","2024","COM","2022","104","1","105","2024-12-30"
"55073","2024","COM","2022","669","51","720","2024-12-30"
"55075","2024","COM","2022","164","3","167","2024-12-30"
"55076","2024","COM","2022","186","4","190","2024-12-30"
"55077","2024","COM","2022","261","4","265","2024-12-30"
"55078","2024","COM","2022","311","5","316","2024-12-30"
"55079","2024","COM","2022","713","21","734","2024-12-30"
"55080","2024","COM","2022","78","4","82","2024-12-30"
"55081","2024","COM","2022","62","0","62","2024-12-30"
"55082","2024","COM","2022","46","0","46","2024-12-30"
"55083","2024","COM","2022","161","4","165","2024-12-30"
"55084","2024","COM","2022","57","3","60","2024-12-30"
"55085","2024","COM","2022","285","10","295","2024-12-30"
"55087","2024","COM","2022","88","2","90","2024-12-30"
"55088","2024","COM","2022","157","4","161","2024-12-30"
"55089","2024","COM","2022","86","1","87","2024-12-30"
"55093","2024","COM","2022","266","7","273","2024-12-30"
"55094","2024","COM","2022","524","9","533","2024-12-30"
"55095","2024","COM","2022","113","3","116","2024-12-30"
"55096","2024","COM","2022","110","2","112","2024-12-30"
"55097","2024","COM","2022","304","3","307","2024-12-30"
"55099","2024","COM","2022","119","5","124","2024-12-30"
"55100","2024","COM","2022","86","2","88","2024-12-30"
"55101","2024","COM","2022","302","8","310","2024-12-30"
"55102","2024","COM","2022","521","19","540","2024-12-30"
"55103","2024","COM","2022","23","1","24","2024-12-30"
"55104","2024","COM","2022","87","1","88","2024-12-30"
"55105","2024","COM","2022","174","4","178","2024-12-30"
"55106","2024","COM","2022","176","5","181","2024-12-30"
"55107","2024","COM","2022","46","0","46","2024-12-30"
"55108","2024","COM","2022","120","4","124","2024-12-30"
"55109","2024","COM","2022","225","5","230","2024-12-30"
"55110","2024","COM","2022","216","6","222","2024-12-30"
"55111","2024","COM","2022","432","14","446","2024-12-30"
"55113","2024","COM","2022","155","4","159","2024-12-30"
"55114","2024","COM","2022","204","4","208","2024-12-30"
"55115","2024","COM","2022","45","0","45","2024-12-30"
"55116","2024","COM","2022","48","2","50","2024-12-30"
"55117","2024","COM","2022","1428","33","1461","2024-12-30"
"55118","2024","COM","2022","89","2","91","2024-12-30"
"55119","2024","COM","2022","189","1","190","2024-12-30"
"55120","2024","COM","2022","773","24","797","2024-12-30"
"55121","2024","COM","2022","108","4","112","2024-12-30"
"55122","2024","COM","2022","5332","228","5560","2024-12-30"
"55123","2024","COM","2022","702","23","725","2024-12-30"
"55124","2024","COM","2022","290","3","293","2024-12-30"
"55125","2024","COM","2022","773","18","791","2024-12-30"
"55127","2024","COM","2022","51","0","51","2024-12-30"
"55128","2024","COM","2022","42","1","43","2024-12-30"
"55129","2024","COM","2022","41","1","42","2024-12-30"
"55132","2024","COM","2022","1644","29","1673","2024-12-30"
"55133","2024","COM","2022","82","4","86","2024-12-30"
"55134","2024","COM","2022","153","1","154","2024-12-30"
"55137","2024","COM","2022","48","2","50","2024-12-30"
"55138","2024","COM","2022","124","5","129","2024-12-30"
"55139","2024","COM","2022","0","0","0","2024-12-30"
"55140","2024","COM","2022","22","0","22","2024-12-30"
"55141","2024","COM","2022","86","2","88","2024-12-30"
"55142","2024","COM","2022","121","6","127","2024-12-30"
"55143","2024","COM","2022","126","1","127","2024-12-30"
"55144","2024","COM","2022","369","11","380","2024-12-30"
"55145","2024","COM","2022","615","75","690","2024-12-30"
"55146","2024","COM","2022","192","9","201","2024-12-30"
"55148","2024","COM","2022","118","1","119","2024-12-30"
"55149","2024","COM","2022","126","0","126","2024-12-30"
"55150","2024","COM","2022","509","9","518","2024-12-30"
"55153","2024","COM","2022","193","2","195","2024-12-30"
"55154","2024","COM","2022","1452","46","1498","2024-12-30"
"55155","2024","COM","2022","374","10","384","2024-12-30"
"55156","2024","COM","2022","139","1","140","2024-12-30"
"55157","2024","COM","2022","51","0","51","2024-12-30"
"55158","2024","COM","2022","745","6","751","2024-12-30"
"55159","2024","COM","2022","369","4","373","2024-12-30"
"55160","2024","COM","2022","37","0","37","2024-12-30"
"55162","2024","COM","2022","28","0","28","2024-12-30"
"55163","2024","COM","2022","67","1","68","2024-12-30"
"55165","2024","COM","2022","422","8","430","2024-12-30"
"55166","2024","COM","2022","1262","28","1290","2024-12-30"
"55167","2024","COM","2022","590","18","608","2024-12-30"
"55168","2024","COM","2022","46","0","46","2024-12-30"
"55169","2024","COM","2022","534","14","548","2024-12-30"
"55170","2024","COM","2022","113","1","114","2024-12-30"
"55171","2024","COM","2022","262","3","265","2024-12-30"
"55172","2024","COM","2022","61","0","61","2024-12-30"
"55173","2024","COM","2022","38","2","40","2024-12-30"
"55174","2024","COM","2022","69","2","71","2024-12-30"
"55175","2024","COM","2022","174","4","178","2024-12-30"
"55177","2024","COM","2022","43","4","47","2024-12-30"
"55178","2024","COM","2022","193","4","197","2024-12-30"
"55179","2024","COM","2022","146","0","146","2024-12-30"
"55180","2024","COM","2022","135","11","146","2024-12-30"
"55181","2024","COM","2022","3449","66","3515","2024-12-30"
"55182","2024","COM","2022","201","4","205","2024-12-30"
"55183","2024","COM","2022","37","1","38","2024-12-30"
"55184","2024","COM","2022","1635","33","1668","2024-12-30"
"55185","2024","COM","2022","89","5","94","2024-12-30"
"55186","2024","COM","2022","2088","51","2139","2024-12-30"
"55188","2024","COM","2022","45","0","45","2024-12-30"
"55189","2024","COM","2022","0","0","0","2024-12-30"
"55191","2024","COM","2022","228","5","233","2024-12-30"
"55192","2024","COM","2022","36","1","37","2024-12-30"
"55193","2024","COM","2022","122","2","124","2024-12-30"
"55194","2024","COM","2022","61","0","61","2024-12-30"
"55195","2024","COM","2022","133","1","134","2024-12-30"
"55196","2024","COM","2022","127","1","128","2024-12-30"
"55197","2024","COM","2022","164","4","168","2024-12-30"
"55198","2024","COM","2022","668","11","679","2024-12-30"
"55199","2024","COM","2022","91","0","91","2024-12-30"
"55200","2024","COM","2022","212","3","215","2024-12-30"
"55201","2024","COM","2022","65","0","65","2024-12-30"
"55202","2024","COM","2022","139","3","142","2024-12-30"
"55204","2024","COM","2022","293","3","296","2024-12-30"
"55206","2024","COM","2022","123","5","128","2024-12-30"
"55207","2024","COM","2022","54","1","55","2024-12-30"
"55208","2024","COM","2022","52","2","54","2024-12-30"
"55210","2024","COM","2022","38","2","40","2024-12-30"
"55211","2024","COM","2022","61","0","61","2024-12-30"
"55212","2024","COM","2022","77","0","77","2024-12-30"
"55214","2024","COM","2022","287","7","294","2024-12-30"
"55215","2024","COM","2022","1041","14","1055","2024-12-30"
"55216","2024","COM","2022","70","1","71","2024-12-30"
"55217","2024","COM","2022","118","2","120","2024-12-30"
"55218","2024","COM","2022","44","0","44","2024-12-30"
"55219","2024","COM","2022","97","1","98","2024-12-30"
"55220","2024","COM","2022","93","2","95","2024-12-30"
"55221","2024","COM","2022","236","5","241","2024-12-30"
"55222","2024","COM","2022","34","2","36","2024-12-30"
"55224","2024","COM","2022","567","14","581","2024-12-30"
"55225","2024","COM","2022","138","1","139","2024-12-30"
"55226","2024","COM","2022","125","0","125","2024-12-30"
"55228","2024","COM","2022","546","5","551","2024-12-30"
"55229","2024","COM","2022","269","8","277","2024-12-30"
"55232","2024","COM","2022","112","0","112","2024-12-30"
"55236","2024","COM","2022","933","23","956","2024-12-30"
"55237","2024","COM","2022","232","1","233","2024-12-30"
"55239","2024","COM","2022","0","0","0","2024-12-30"
"55241","2024","COM","2022","83","1","84","2024-12-30"
"55242","2024","COM","2022","111","0","111","2024-12-30"
"55243","2024","COM","2022","181","4","185","2024-12-30"
"55244","2024","COM","2022","221","3","224","2024-12-30"
"55245","2024","COM","2022","169","2","171","2024-12-30"
"55246","2024","COM","2022","156","2","158","2024-12-30"
"55247","2024","COM","2022","46","4","50","2024-12-30"
"55248","2024","COM","2022","277","5","282","2024-12-30"
"55250","2024","COM","2022","178","1","179","2024-12-30"
"55251","2024","COM","2022","94","4","98","2024-12-30"
"55252","2024","COM","2022","151","2","153","2024-12-30"
"55253","2024","COM","2022","696","10","706","2024-12-30"
"55254","2024","COM","2022","121","2","123","2024-12-30"
"55255","2024","COM","2022","250","5","255","2024-12-30"
"55256","2024","COM","2022","144","2","146","2024-12-30"
"55257","2024","COM","2022","55","1","56","2024-12-30"
"55258","2024","COM","2022","627","14","641","2024-12-30"
"55260","2024","COM","2022","59","0","59","2024-12-30"
"55261","2024","COM","2022","134","3","137","2024-12-30"
"55262","2024","COM","2022","248","2","250","2024-12-30"
"55263","2024","COM","2022","164","1","165","2024-12-30"
"55264","2024","COM","2022","254","7","261","2024-12-30"
"55265","2024","COM","2022","140","1","141","2024-12-30"
"55266","2024","COM","2022","54","2","56","2024-12-30"
"55267","2024","COM","2022","280","7","287","2024-12-30"
"55268","2024","COM","2022","649","19","668","2024-12-30"
"55269","2024","COM","2022","76","1","77","2024-12-30"
"55270","2024","COM","2022","29","1","30","2024-12-30"
"55271","2024","COM","2022","354","6","360","2024-12-30"
"55272","2024","COM","2022","426","18","444","2024-12-30"
"55274","2024","COM","2022","276","1","277","2024-12-30"
"55275","2024","COM","2022","84","1","85","2024-12-30"
"55276","2024","COM","2022","223","2","225","2024-12-30"
"55278","2024","COM","2022","196","5","201","2024-12-30"
"55279","2024","COM","2022","446","6","452","2024-12-30"
"55280","2024","COM","2022","55","2","57","2024-12-30"
"55281","2024","COM","2022","87","1","88","2024-12-30"
"55282","2024","COM","2022","87","4","91","2024-12-30"
"55284","2024","COM","2022","71","2","73","2024-12-30"
"55285","2024","COM","2022","145","5","150","2024-12-30"
"55286","2024","COM","2022","236","1","237","2024-12-30"
"55288","2024","COM","2022","1380","25","1405","2024-12-30"
"55289","2024","COM","2022","56","0","56","2024-12-30"
"55290","2024","COM","2022","52","3","55","2024-12-30"
"55291","2024","COM","2022","3696","122","3818","2024-12-30"
"55292","2024","COM","2022","189","4","193","2024-12-30"
"55293","2024","COM","2022","178","3","181","2024-12-30"
"55295","2024","COM","2022","28","0","28","2024-12-30"
"55296","2024","COM","2022","465","7","472","2024-12-30"
"55297","2024","COM","2022","105","3","108","2024-12-30"
"55298","2024","COM","2022","278","5","283","2024-12-30"
"55299","2024","COM","2022","117","2","119","2024-12-30"
"55300","2024","COM","2022","219","8","227","2024-12-30"
"55301","2024","COM","2022","120","1","121","2024-12-30"
"55302","2024","COM","2022","1092","29","1121","2024-12-30"
"55303","2024","COM","2022","73","0","73","2024-12-30"
"55304","2024","COM","2022","163","5","168","2024-12-30"
"55306","2024","COM","2022","118","1","119","2024-12-30"
"55307","2024","COM","2022","0","0","0","2024-12-30"
"55310","2024","COM","2022","113","0","113","2024-12-30"
"55311","2024","COM","2022","24","1","25","2024-12-30"
"55312","2024","COM","2022","159","3","162","2024-12-30"
"55313","2024","COM","2022","69","2","71","2024-12-30"
"55315","2024","COM","2022","112","4","116","2024-12-30"
"55316","2024","COM","2022","401","9","410","2024-12-30"
"55317","2024","COM","2022","152","2","154","2024-12-30"
"55320","2024","COM","2022","68","0","68","2024-12-30"
"55321","2024","COM","2022","181","2","183","2024-12-30"
"55322","2024","COM","2022","58","1","59","2024-12-30"
"55323","2024","COM","2022","68","2","70","2024-12-30"
"55324","2024","COM","2022","514","12","526","2024-12-30"
"55325","2024","COM","2022","49","1","50","2024-12-30"
"55326","2024","COM","2022","107","3","110","2024-12-30"
"55327","2024","COM","2022","240","7","247","2024-12-30"
"55328","2024","COM","2022","281","4","285","2024-12-30"
"55329","2024","COM","2022","188","5","193","2024-12-30"
"55330","2024","COM","2022","89","0","89","2024-12-30"
"55331","2024","COM","2022","74","2","76","2024-12-30"
"55332","2024","COM","2022","229","2","231","2024-12-30"
"55333","2024","COM","2022","47","1","48","2024-12-30"
"55334","2024","COM","2022","175","2","177","2024-12-30"
"55335","2024","COM","2022","245","5","250","2024-12-30"
"55336","2024","COM","2022","146","1","147","2024-12-30"
"55338","2024","COM","2022","148","0","148","2024-12-30"
"55339","2024","COM","2022","74","1","75","2024-12-30"
"55340","2024","COM","2022","359","7","366","2024-12-30"
"55341","2024","COM","2022","112","4","116","2024-12-30"
"55343","2024","COM","2022","57","0","57","2024-12-30"
"55344","2024","COM","2022","21","0","21","2024-12-30"
"55345","2024","COM","2022","99","2","101","2024-12-30"
"55346","2024","COM","2022","276","5","281","2024-12-30"
"55347","2024","COM","2022","326","4","330","2024-12-30"
"55348","2024","COM","2022","366","7","373","2024-12-30"
"55349","2024","COM","2022","131","0","131","2024-12-30"
"55350","2024","COM","2022","77","0","77","2024-12-30"
"55351","2024","COM","2022","2018","79","2097","2024-12-30"
"55352","2024","COM","2022","137","11","148","2024-12-30"
"55353","2024","COM","2022","76","1","77","2024-12-30"
"55355","2024","COM","2022","154","2","156","2024-12-30"
"55356","2024","COM","2022","103","2","105","2024-12-30"
"55357","2024","COM","2022","107","3","110","2024-12-30"
"55358","2024","COM","2022","186","4","190","2024-12-30"
"55359","2024","COM","2022","207","3","210","2024-12-30"
"55360","2024","COM","2022","106","2","108","2024-12-30"
"55361","2024","COM","2022","138","0","138","2024-12-30"
"55362","2024","COM","2022","186","3","189","2024-12-30"
"55363","2024","COM","2022","87","1","88","2024-12-30"
"55364","2024","COM","2022","650","24","674","2024-12-30"
"55365","2024","COM","2022","138","4","142","2024-12-30"
"55366","2024","COM","2022","971","25","996","2024-12-30"
"55367","2024","COM","2022","132","4","136","2024-12-30"
"55368","2024","COM","2022","156","6","162","2024-12-30"
"55369","2024","COM","2022","809","16","825","2024-12-30"
"55370","2024","COM","2022","195","2","197","2024-12-30"
"55371","2024","COM","2022","74","2","76","2024-12-30"
"55372","2024","COM","2022","362","7","369","2024-12-30"
"55373","2024","COM","2022","82","5","87","2024-12-30"
"55374","2024","COM","2022","77","0","77","2024-12-30"
"55375","2024","COM","2022","63","1","64","2024-12-30"
"55376","2024","COM","2022","77","0","77","2024-12-30"
"55377","2024","COM","2022","91","4","95","2024-12-30"
"55378","2024","COM","2022","242","3","245","2024-12-30"
"55379","2024","COM","2022","54","2","56","2024-12-30"
"55380","2024","COM","2022","49","1","50","2024-12-30"
"55381","2024","COM","2022","147","0","147","2024-12-30"
"55382","2024","COM","2022","366","12","378","2024-12-30"
"55383","2024","COM","2022","227","4","231","2024-12-30"
"55384","2024","COM","2022","129","5","134","2024-12-30"
"55385","2024","COM","2022","502","10","512","2024-12-30"
"55386","2024","COM","2022","225","3","228","2024-12-30"
"55387","2024","COM","2022","245","4","249","2024-12-30"
"55388","2024","COM","2022","274","6","280","2024-12-30"
"55389","2024","COM","2022","249","6","255","2024-12-30"
"55391","2024","COM","2022","196","4","200","2024-12-30"
"55394","2024","COM","2022","8","0","8","2024-12-30"
"55395","2024","COM","2022","59","3","62","2024-12-30"
"55396","2024","COM","2022","221","4","225","2024-12-30"
"55397","2024","COM","2022","226","4","230","2024-12-30"
"55398","2024","COM","2022","1026","26","1052","2024-12-30"
"55399","2024","COM","2022","111","4","115","2024-12-30"
"55400","2024","COM","2022","42","1","43","2024-12-30"
"55401","2024","COM","2022","415","10","425","2024-12-30"
"55403","2024","COM","2022","60","1","61","2024-12-30"
"55404","2024","COM","2022","306","6","312","2024-12-30"
"55405","2024","COM","2022","250","6","256","2024-12-30"
"55406","2024","COM","2022","104","0","104","2024-12-30"
"55407","2024","COM","2022","132","1","133","2024-12-30"
"55408","2024","COM","2022","172","8","180","2024-12-30"
"55409","2024","COM","2022","61","2","63","2024-12-30"
"55410","2024","COM","2022","138","3","141","2024-12-30"
"55411","2024","COM","2022","86","0","86","2024-12-30"
"55412","2024","COM","2022","191","3","194","2024-12-30"
"55414","2024","COM","2022","180","2","182","2024-12-30"
"55415","2024","COM","2022","90","1","91","2024-12-30"
"55416","2024","COM","2022","205","6","211","2024-12-30"
"55419","2024","COM","2022","150","2","152","2024-12-30"
"55420","2024","COM","2022","68","0","68","2024-12-30"
"55421","2024","COM","2022","72","3","75","2024-12-30"
"55422","2024","COM","2022","50","1","51","2024-12-30"
"55423","2024","COM","2022","311","9","320","2024-12-30"
"55424","2024","COM","2022","45","1","46","2024-12-30"
"55425","2024","COM","2022","130","0","130","2024-12-30"
"55426","2024","COM","2022","372","7","379","2024-12-30"
"55427","2024","COM","2022","2600","35","2635","2024-12-30"
"55428","2024","COM","2022","130","1","131","2024-12-30"
"55429","2024","COM","2022","50","0","50","2024-12-30"
"55430","2024","COM","2022","71","1","72","2024-12-30"
"55431","2024","COM","2022","56","0","56","2024-12-30"
"55433","2024","COM","2022","370","5","375","2024-12-30"
"55434","2024","COM","2022","50","2","52","2024-12-30"
"55435","2024","COM","2022","758","21","779","2024-12-30"
"55436","2024","COM","2022","27","0","27","2024-12-30"
"55437","2024","COM","2022","123","4","127","2024-12-30"
"55438","2024","COM","2022","175","1","176","2024-12-30"
"55439","2024","COM","2022","105","4","109","2024-12-30"
"55442","2024","COM","2022","241","4","245","2024-12-30"
"55443","2024","COM","2022","589","6","595","2024-12-30"
"55444","2024","COM","2022","195","2","197","2024-12-30"
"55445","2024","COM","2022","193","8","201","2024-12-30"
"55446","2024","COM","2022","84","4","88","2024-12-30"
"55447","2024","COM","2022","367","8","375","2024-12-30"
"55448","2024","COM","2022","40","1","41","2024-12-30"
"55449","2024","COM","2022","282","4","286","2024-12-30"
"55450","2024","COM","2022","49","2","51","2024-12-30"
"55452","2024","COM","2022","60","0","60","2024-12-30"
"55453","2024","COM","2022","61","2","63","2024-12-30"
"55454","2024","COM","2022","177","9","186","2024-12-30"
"55456","2024","COM","2022","215","5","220","2024-12-30"
"55457","2024","COM","2022","181","6","187","2024-12-30"
"55458","2024","COM","2022","376","6","382","2024-12-30"
"55459","2024","COM","2022","232","7","239","2024-12-30"
"55460","2024","COM","2022","139","2","141","2024-12-30"
"55461","2024","COM","2022","443","14","457","2024-12-30"
"55462","2024","COM","2022","359","6","365","2024-12-30"
"55463","2024","COM","2022","3848","34","3882","2024-12-30"
"55464","2024","COM","2022","151","2","153","2024-12-30"
"55465","2024","COM","2022","99","1","100","2024-12-30"
"55466","2024","COM","2022","284","4","288","2024-12-30"
"55467","2024","COM","2022","693","13","706","2024-12-30"
"55468","2024","COM","2022","99","2","101","2024-12-30"
"55469","2024","COM","2022","89","0","89","2024-12-30"
"55470","2024","COM","2022","191","2","193","2024-12-30"
"55471","2024","COM","2022","82","2","84","2024-12-30"
"55472","2024","COM","2022","113","5","118","2024-12-30"
"55473","2024","COM","2022","113","2","115","2024-12-30"
"55474","2024","COM","2022","222","4","226","2024-12-30"
"55475","2024","COM","2022","70","1","71","2024-12-30"
"55476","2024","COM","2022","451","11","462","2024-12-30"
"55477","2024","COM","2022","400","15","415","2024-12-30"
"55479","2024","COM","2022","154","1","155","2024-12-30"
"55481","2024","COM","2022","299","5","304","2024-12-30"
"55482","2024","COM","2022","100","2","102","2024-12-30"
"55484","2024","COM","2022","47","1","48","2024-12-30"
"55485","2024","COM","2022","74","1","75","2024-12-30"
"55487","2024","COM","2022","85","1","86","2024-12-30"
"55488","2024","COM","2022","143","6","149","2024-12-30"
"55489","2024","COM","2022","279","5","284","2024-12-30"
"55490","2024","COM","2022","337","5","342","2024-12-30"
"55492","2024","COM","2022","959","12","971","2024-12-30"
"55493","2024","COM","2022","181","5","186","2024-12-30"
"55494","2024","COM","2022","401","20","421","2024-12-30"
"55495","2024","COM","2022","233","1","234","2024-12-30"
"55496","2024","COM","2022","1044","27","1071","2024-12-30"
"55497","2024","COM","2022","321","4","325","2024-12-30"
"55498","2024","COM","2022","426","5","431","2024-12-30"
"55500","2024","COM","2022","815","12","827","2024-12-30"
"55501","2024","COM","2022","375","10","385","2024-12-30"
"55502","2024","COM","2022","2428","110","2538","2024-12-30"
"55503","2024","COM","2022","123","2","125","2024-12-30"
"55504","2024","COM","2022","389","5","394","2024-12-30"
"55505","2024","COM","2022","3168","79","3247","2024-12-30"
"55506","2024","COM","2022","30","0","30","2024-12-30"
"55507","2024","COM","2022","206","5","211","2024-12-30"
"55508","2024","COM","2022","357","13","370","2024-12-30"
"55509","2024","COM","2022","276","4","280","2024-12-30"
"55510","2024","COM","2022","125","4","129","2024-12-30"
"55511","2024","COM","2022","115","3","118","2024-12-30"
"55512","2024","COM","2022","277","4","281","2024-12-30"
"55514","2024","COM","2022","571","14","585","2024-12-30"
"55515","2024","COM","2022","70","1","71","2024-12-30"
"55516","2024","COM","2022","550","6","556","2024-12-30"
"55517","2024","COM","2022","523","7","530","2024-12-30"
"55518","2024","COM","2022","146","2","148","2024-12-30"
"55519","2024","COM","2022","1319","17","1336","2024-12-30"
"55520","2024","COM","2022","470","5","475","2024-12-30"
"55521","2024","COM","2022","231","1","232","2024-12-30"
"55522","2024","COM","2022","106","3","109","2024-12-30"
"55523","2024","COM","2022","191","3","194","2024-12-30"
"55525","2024","COM","2022","77","1","78","2024-12-30"
"55526","2024","COM","2022","251","5","256","2024-12-30"
"55527","2024","COM","2022","629","12","641","2024-12-30"
"55528","2024","COM","2022","49","0","49","2024-12-30"
"55530","2024","COM","2022","95","1","96","2024-12-30"
"55531","2024","COM","2022","276","19","295","2024-12-30"
"55532","2024","COM","2022","314","5","319","2024-12-30"
"55533","2024","COM","2022","1916","23","1939","2024-12-30"
"55534","2024","COM","2022","49","1","50","2024-12-30"
"55535","2024","COM","2022","79","1","80","2024-12-30"
"55536","2024","COM","2022","23","2","25","2024-12-30"
"55537","2024","COM","2022","81","0","81","2024-12-30"
"55540","2024","COM","2022","59","3","62","2024-12-30"
"55541","2024","COM","2022","532","12","544","2024-12-30"
"55543","2024","COM","2022","880","19","899","2024-12-30"
"55544","2024","COM","2022","139","1","140","2024-12-30"
"55545","2024","COM","2022","16610","940","17550","2024-12-30"
"55546","2024","COM","2022","204","7","211","2024-12-30"
"55547","2024","COM","2022","109","5","114","2024-12-30"
"55549","2024","COM","2022","82","1","83","2024-12-30"
"55551","2024","COM","2022","1581","102","1683","2024-12-30"
"55552","2024","COM","2022","83","3","86","2024-12-30"
"55553","2024","COM","2022","1277","22","1299","2024-12-30"
"55554","2024","COM","2022","250","7","257","2024-12-30"
"55555","2024","COM","2022","33","1","34","2024-12-30"
"55556","2024","COM","2022","49","1","50","2024-12-30"
"55557","2024","COM","2022","130","0","130","2024-12-30"
"55559","2024","COM","2022","56","1","57","2024-12-30"
"55560","2024","COM","2022","127","4","131","2024-12-30"
"55561","2024","COM","2022","51","1","52","2024-12-30"
"55562","2024","COM","2022","127","0","127","2024-12-30"
"55563","2024","COM","2022","71","2","73","2024-12-30"
"55565","2024","COM","2022","74","3","77","2024-12-30"
"55566","2024","COM","2022","284","6","290","2024-12-30"
"55567","2024","COM","2022","139","4","143","2024-12-30"
"55568","2024","COM","2022","278","6","284","2024-12-30"
"55569","2024","COM","2022","163","5","168","2024-12-30"
"55570","2024","COM","2022","212","8","220","2024-12-30"
"55571","2024","COM","2022","254","2","256","2024-12-30"
"55572","2024","COM","2022","91","1","92","2024-12-30"
"55573","2024","COM","2022","1606","24","1630","2024-12-30"
"55574","2024","COM","2022","40","2","42","2024-12-30"
"55575","2024","COM","2022","78","0","78","2024-12-30"
"55577","2024","COM","2022","57","0","57","2024-12-30"
"55578","2024","COM","2022","182","2","184","2024-12-30"
"55579","2024","COM","2022","102","0","102","2024-12-30"
"55580","2024","COM","2022","48","1","49","2024-12-30"
"55581","2024","COM","2022","107","4","111","2024-12-30"
"55582","2024","COM","2022","92","3","95","2024-12-30"
"55583","2024","COM","2022","208","5","213","2024-12-30"
"55584","2024","COM","2022","130","4","134","2024-12-30"
"55586","2024","COM","2022","116","1","117","2024-12-30"
"56001","2024","COM","2022","3906","87","3993","2024-12-30"
"56002","2024","COM","2022","2091","55","2146","2024-12-30"
"56003","2024","COM","2022","5820","160","5980","2024-12-30"
"56004","2024","COM","2022","1794","27","1821","2024-12-30"
"56005","2024","COM","2022","2272","40","2312","2024-12-30"
"56006","2024","COM","2022","1542","30","1572","2024-12-30"
"56007","2024","COM","2022","14417","408","14825","2024-12-30"
"56008","2024","COM","2022","4864","121","4985","2024-12-30"
"56009","2024","COM","2022","1002","29","1031","2024-12-30"
"56010","2024","COM","2022","6246","184","6430","2024-12-30"
"56011","2024","COM","2022","1458","22","1480","2024-12-30"
"56012","2024","COM","2022","1939","46","1985","2024-12-30"
"56013","2024","COM","2022","3869","64","3933","2024-12-30"
"56014","2024","COM","2022","1558","130","1688","2024-12-30"
"56015","2024","COM","2022","2119","39","2158","2024-12-30"
"56017","2024","COM","2022","2750","62","2812","2024-12-30"
"56018","2024","COM","2022","1056","11","1067","2024-12-30"
"56019","2024","COM","2022","324","9","333","2024-12-30"
"56020","2024","COM","2022","862","21","883","2024-12-30"
"56021","2024","COM","2022","1480","27","1507","2024-12-30"
"56022","2024","COM","2022","1423","37","1460","2024-12-30"
"56023","2024","COM","2022","7057","298","7355","2024-12-30"
"56024","2024","COM","2022","2298","51","2349","2024-12-30"
"56025","2024","COM","2022","198","3","201","2024-12-30"
"56026","2024","COM","2022","2262","50","2312","2024-12-30"
"56027","2024","COM","2022","546","7","553","2024-12-30"
"56028","2024","COM","2022","1570","34","1604","2024-12-30"
"56029","2024","COM","2022","1267","22","1289","2024-12-30"
"56030","2024","COM","2022","1156","18","1174","2024-12-30"
"56031","2024","COM","2022","3180","63","3243","2024-12-30"
"56032","2024","COM","2022","1940","38","1978","2024-12-30"
"56033","2024","COM","2022","3137","64","3201","2024-12-30"
"56034","2024","COM","2022","4215","108","4323","2024-12-30"
"56035","2024","COM","2022","1132","32","1164","2024-12-30"
"56036","2024","COM","2022","7110","163","7273","2024-12-30"
"56039","2024","COM","2022","1002","26","1028","2024-12-30"
"56040","2024","COM","2022","3404","61","3465","2024-12-30"
"56041","2024","COM","2022","2849","79","2928","2024-12-30"
"56042","2024","COM","2022","2258","48","2306","2024-12-30"
"56043","2024","COM","2022","765","19","784","2024-12-30"
"56044","2024","COM","2022","805","29","834","2024-12-30"
"56045","2024","COM","2022","673","11","684","2024-12-30"
"56046","2024","COM","2022","3458","80","3538","2024-12-30"
"56047","2024","COM","2022","1493","45","1538","2024-12-30"
"56048","2024","COM","2022","742","12","754","2024-12-30"
"56050","2024","COM","2022","881","19","900","2024-12-30"
"56051","2024","COM","2022","661","10","671","2024-12-30"
"56052","2024","COM","2022","1930","30","1960","2024-12-30"
"56053","2024","COM","2022","6543","153","6696","2024-12-30"
"56054","2024","COM","2022","3987","93","4080","2024-12-30"
"56055","2024","COM","2022","2058","181","2239","2024-12-30"
"56056","2024","COM","2022","210","3","213","2024-12-30"
"56057","2024","COM","2022","2816","55","2871","2024-12-30"
"56058","2024","COM","2022","3445","68","3513","2024-12-30"
"56060","2024","COM","2022","960","18","978","2024-12-30"
"56061","2024","COM","2022","4011","101","4112","2024-12-30"
"56062","2024","COM","2022","685","18","703","2024-12-30"
"56063","2024","COM","2022","2569","90","2659","2024-12-30"
"56065","2024","COM","2022","724","19","743","2024-12-30"
"56066","2024","COM","2022","3892","163","4055","2024-12-30"
"56067","2024","COM","2022","5859","134","5993","2024-12-30"
"56068","2024","COM","2022","310","3","313","2024-12-30"
"56069","2024","COM","2022","2308","51","2359","2024-12-30"
"56070","2024","COM","2022","2308","40","2348","2024-12-30"
"56071","2024","COM","2022","804","12","816","2024-12-30"
"56072","2024","COM","2022","532","6","538","2024-12-30"
"56073","2024","COM","2022","1136","23","1159","2024-12-30"
"56074","2024","COM","2022","1895","38","1933","2024-12-30"
"56075","2024","COM","2022","6056","287","6343","2024-12-30"
"56076","2024","COM","2022","1379","24","1403","2024-12-30"
"56077","2024","COM","2022","975","23","998","2024-12-30"
"56078","2024","COM","2022","12236","307","12543","2024-12-30"
"56079","2024","COM","2022","1402","35","1437","2024-12-30"
"56080","2024","COM","2022","1352","109","1461","2024-12-30"
"56081","2024","COM","2022","2053","53","2106","2024-12-30"
"56082","2024","COM","2022","384","7","391","2024-12-30"
"56083","2024","COM","2022","15831","444","16275","2024-12-30"
"56084","2024","COM","2022","898","23","921","2024-12-30"
"56085","2024","COM","2022","103","2","105","2024-12-30"
"56086","2024","COM","2022","214","6","220","2024-12-30"
"56087","2024","COM","2022","632","17","649","2024-12-30"
"56088","2024","COM","2022","317","5","322","2024-12-30"
"56089","2024","COM","2022","2196","49","2245","2024-12-30"
"56090","2024","COM","2022","6631","129","6760","2024-12-30"
"56091","2024","COM","2022","2559","128","2687","2024-12-30"
"56092","2024","COM","2022","842","11","853","2024-12-30"
"56093","2024","COM","2022","713","23","736","2024-12-30"
"56094","2024","COM","2022","7085","210","7295","2024-12-30"
"56096","2024","COM","2022","2487","57","2544","2024-12-30"
"56097","2024","COM","2022","4049","81","4130","2024-12-30"
"56098","2024","COM","2022","23188","503","23691","2024-12-30"
"56099","2024","COM","2022","404","4","408","2024-12-30"
"56100","2024","COM","2022","1851","32","1883","2024-12-30"
"56101","2024","COM","2022","8046","164","8210","2024-12-30"
"56102","2024","COM","2022","2190","57","2247","2024-12-30"
"56103","2024","COM","2022","291","4","295","2024-12-30"
"56104","2024","COM","2022","809","9","818","2024-12-30"
"56105","2024","COM","2022","1133","25","1158","2024-12-30"
"56106","2024","COM","2022","891","18","909","2024-12-30"
"56107","2024","COM","2022","8368","203","8571","2024-12-30"
"56108","2024","COM","2022","1102","22","1124","2024-12-30"
"56109","2024","COM","2022","1237","29","1266","2024-12-30"
"56110","2024","COM","2022","855","12","867","2024-12-30"
"56111","2024","COM","2022","1306","22","1328","2024-12-30"
"56112","2024","COM","2022","807","16","823","2024-12-30"
"56113","2024","COM","2022","894","20","914","2024-12-30"
"56114","2024","COM","2022","973","29","1002","2024-12-30"
"56115","2024","COM","2022","1825","45","1870","2024-12-30"
"56116","2024","COM","2022","1567","41","1608","2024-12-30"
"56117","2024","COM","2022","4708","232","4940","2024-12-30"
"56118","2024","COM","2022","4094","104","4198","2024-12-30"
"56119","2024","COM","2022","3529","81","3610","2024-12-30"
"56120","2024","COM","2022","1980","43","2023","2024-12-30"
"56121","2024","COM","2022","58202","1451","59653","2024-12-30"
"56122","2024","COM","2022","1734","37","1771","2024-12-30"
"56123","2024","COM","2022","2292","41","2333","2024-12-30"
"56124","2024","COM","2022","2533","54","2587","2024-12-30"
"56125","2024","COM","2022","1849","62","1911","2024-12-30"
"56126","2024","COM","2022","2611","35","2646","2024-12-30"
"56127","2024","COM","2022","3169","63","3232","2024-12-30"
"56128","2024","COM","2022","1559","25","1584","2024-12-30"
"56129","2024","COM","2022","1478","32","1510","2024-12-30"
"56130","2024","COM","2022","3191","72","3263","2024-12-30"
"56131","2024","COM","2022","1475","31","1506","2024-12-30"
"56132","2024","COM","2022","2278","66","2344","2024-12-30"
"56133","2024","COM","2022","1192","34","1226","2024-12-30"
"56134","2024","COM","2022","988","14","1002","2024-12-30"
"56135","2024","COM","2022","1636","32","1668","2024-12-30"
"56136","2024","COM","2022","760","11","771","2024-12-30"
"56137","2024","COM","2022","3342","76","3418","2024-12-30"
"56139","2024","COM","2022","370","13","383","2024-12-30"
"56140","2024","COM","2022","3692","98","3790","2024-12-30"
"56141","2024","COM","2022","1713","36","1749","2024-12-30"
"56143","2024","COM","2022","5022","127","5149","2024-12-30"
"56144","2024","COM","2022","3384","82","3466","2024-12-30"
"56145","2024","COM","2022","1070","22","1092","2024-12-30"
"56146","2024","COM","2022","1476","38","1514","2024-12-30"
"56147","2024","COM","2022","4874","103","4977","2024-12-30"
"56148","2024","COM","2022","1650","36","1686","2024-12-30"
"56149","2024","COM","2022","2548","51","2599","2024-12-30"
"56151","2024","COM","2022","3605","99","3704","2024-12-30"
"56152","2024","COM","2022","2576","55","2631","2024-12-30"
"56153","2024","COM","2022","2856","50","2906","2024-12-30"
"56154","2024","COM","2022","1865","36","1901","2024-12-30"
"56155","2024","COM","2022","2057","27","2084","2024-12-30"
"56156","2024","COM","2022","358","7","365","2024-12-30"
"56157","2024","COM","2022","1970","54","2024","2024-12-30"
"56158","2024","COM","2022","6200","184","6384","2024-12-30"
"56159","2024","COM","2022","1850","47","1897","2024-12-30"
"56160","2024","COM","2022","1281","17","1298","2024-12-30"
"56161","2024","COM","2022","3109","91","3200","2024-12-30"
"56162","2024","COM","2022","18873","626","19499","2024-12-30"
"56163","2024","COM","2022","1259","22","1281","2024-12-30"
"56164","2024","COM","2022","6781","234","7015","2024-12-30"
"56165","2024","COM","2022","10021","534","10555","2024-12-30"
"56166","2024","COM","2022","5779","132","5911","2024-12-30"
"56167","2024","COM","2022","2599","88","2687","2024-12-30"
"56168","2024","COM","2022","2272","55","2327","2024-12-30"
"56169","2024","COM","2022","5343","123","5466","2024-12-30"
"56170","2024","COM","2022","1022","27","1049","2024-12-30"
"56171","2024","COM","2022","1515","28","1543","2024-12-30"
"56172","2024","COM","2022","2730","64","2794","2024-12-30"
"56173","2024","COM","2022","4535","74","4609","2024-12-30"
"56174","2024","COM","2022","2841","64","2905","2024-12-30"
"56175","2024","COM","2022","4199","93","4292","2024-12-30"
"56176","2024","COM","2022","6257","149","6406","2024-12-30"
"56177","2024","COM","2022","7644","144","7788","2024-12-30"
"56178","2024","COM","2022","14547","821","15368","2024-12-30"
"56179","2024","COM","2022","4015","89","4104","2024-12-30"
"56180","2024","COM","2022","749","17","766","2024-12-30"
"56181","2024","COM","2022","2689","104","2793","2024-12-30"
"56182","2024","COM","2022","1024","177","1201","2024-12-30"
"56184","2024","COM","2022","8081","287","8368","2024-12-30"
"56185","2024","COM","2022","8906","246","9152","2024-12-30"
"56186","2024","COM","2022","4782","79","4861","2024-12-30"
"56188","2024","COM","2022","1423","19","1442","2024-12-30"
"56189","2024","COM","2022","1067","18","1085","2024-12-30"
"56190","2024","COM","2022","1944","56","2000","2024-12-30"
"56191","2024","COM","2022","431","10","441","2024-12-30"
"56193","2024","COM","2022","5742","136","5878","2024-12-30"
"56194","2024","COM","2022","2841","76","2917","2024-12-30"
"56195","2024","COM","2022","720","16","736","2024-12-30"
"56196","2024","COM","2022","636","13","649","2024-12-30"
"56197","2024","COM","2022","2808","73","2881","2024-12-30"
"56198","2024","COM","2022","1541","36","1577","2024-12-30"
"56199","2024","COM","2022","715","17","732","2024-12-30"
"56200","2024","COM","2022","1396","31","1427","2024-12-30"
"56201","2024","COM","2022","611","7","618","2024-12-30"
"56202","2024","COM","2022","540","11","551","2024-12-30"
"56203","2024","COM","2022","632","13","645","2024-12-30"
"56204","2024","COM","2022","651","8","659","2024-12-30"
"56205","2024","COM","2022","885","17","902","2024-12-30"
"56206","2024","COM","2022","12173","281","12454","2024-12-30"
"56207","2024","COM","2022","1182","28","1210","2024-12-30"
"56208","2024","COM","2022","294","8","302","2024-12-30"
"56209","2024","COM","2022","178","6","184","2024-12-30"
"56210","2024","COM","2022","468","6","474","2024-12-30"
"56211","2024","COM","2022","806","16","822","2024-12-30"
"56212","2024","COM","2022","2636","50","2686","2024-12-30"
"56213","2024","COM","2022","1309","31","1340","2024-12-30"
"56214","2024","COM","2022","1784","35","1819","2024-12-30"
"56215","2024","COM","2022","1087","24","1111","2024-12-30"
"56216","2024","COM","2022","428","5","433","2024-12-30"
"56218","2024","COM","2022","745","24","769","2024-12-30"
"56219","2024","COM","2022","1446","23","1469","2024-12-30"
"56220","2024","COM","2022","1298","29","1327","2024-12-30"
"56221","2024","COM","2022","1733","82","1815","2024-12-30"
"56222","2024","COM","2022","2860","135","2995","2024-12-30"
"56223","2024","COM","2022","1430","57","1487","2024-12-30"
"56224","2024","COM","2022","394","9","403","2024-12-30"
"56225","2024","COM","2022","205","8","213","2024-12-30"
"56226","2024","COM","2022","543","23","566","2024-12-30"
"56227","2024","COM","2022","562","12","574","2024-12-30"
"56228","2024","COM","2022","1129","47","1176","2024-12-30"
"56229","2024","COM","2022","1305","18","1323","2024-12-30"
"56230","2024","COM","2022","455","9","464","2024-12-30"
"56231","2024","COM","2022","3952","100","4052","2024-12-30"
"56232","2024","COM","2022","1049","43","1092","2024-12-30"
"56233","2024","COM","2022","1580","45","1625","2024-12-30"
"56234","2024","COM","2022","2327","51","2378","2024-12-30"
"56236","2024","COM","2022","789","15","804","2024-12-30"
"56237","2024","COM","2022","1880","50","1930","2024-12-30"
"56238","2024","COM","2022","375","11","386","2024-12-30"
"56239","2024","COM","2022","1647","45","1692","2024-12-30"
"56240","2024","COM","2022","9068","178","9246","2024-12-30"
"56241","2024","COM","2022","1043","20","1063","2024-12-30"
"56242","2024","COM","2022","656","16","672","2024-12-30"
"56243","2024","COM","2022","9265","185","9450","2024-12-30"
"56244","2024","COM","2022","3386","54","3440","2024-12-30"
"56245","2024","COM","2022","488","11","499","2024-12-30"
"56246","2024","COM","2022","2128","48","2176","2024-12-30"
"56247","2024","COM","2022","3847","96","3943","2024-12-30"
"56248","2024","COM","2022","5110","120","5230","2024-12-30"
"56249","2024","COM","2022","2400","63","2463","2024-12-30"
"56250","2024","COM","2022","610","9","619","2024-12-30"
"56251","2024","COM","2022","8476","242","8718","2024-12-30"
"56252","2024","COM","2022","1259","9","1268","2024-12-30"
"56253","2024","COM","2022","679","8","687","2024-12-30"
"56254","2024","COM","2022","1369","20","1389","2024-12-30"
"56255","2024","COM","2022","2531","50","2581","2024-12-30"
"56256","2024","COM","2022","112","0","112","2024-12-30"
"56257","2024","COM","2022","667","10","677","2024-12-30"
"56258","2024","COM","2022","1837","35","1872","2024-12-30"
"56259","2024","COM","2022","1699","24","1723","2024-12-30"
"56260","2024","COM","2022","54955","1942","56897","2024-12-30"
"56261","2024","COM","2022","1484","32","1516","2024-12-30"
"56262","2024","COM","2022","2594","64","2658","2024-12-30"
"56263","2024","COM","2022","2837","135","2972","2024-12-30"
"56264","2024","COM","2022","418","6","424","2024-12-30"
"57001","2024","COM","2022","318","3","321","2024-12-30"
"57002","2024","COM","2022","66","1","67","2024-12-30"
"57003","2024","COM","2022","1427","30","1457","2024-12-30"
"57004","2024","COM","2022","79","1","80","2024-12-30"
"57006","2024","COM","2022","970","25","995","2024-12-30"
"57007","2024","COM","2022","134","4","138","2024-12-30"
"57008","2024","COM","2022","216","6","222","2024-12-30"
"57009","2024","COM","2022","102","1","103","2024-12-30"
"57010","2024","COM","2022","168","1","169","2024-12-30"
"57011","2024","COM","2022","610","20","630","2024-12-30"
"57012","2024","COM","2022","5928","68","5996","2024-12-30"
"57013","2024","COM","2022","2493","47","2540","2024-12-30"
"57014","2024","COM","2022","368","9","377","2024-12-30"
"57015","2024","COM","2022","531","13","544","2024-12-30"
"57016","2024","COM","2022","401","6","407","2024-12-30"
"57017","2024","COM","2022","2154","35","2189","2024-12-30"
"57018","2024","COM","2022","116","7","123","2024-12-30"
"57019","2024","COM","2022","10853","87","10940","2024-12-30"
"57020","2024","COM","2022","299","3","302","2024-12-30"
"57021","2024","COM","2022","1474","29","1503","2024-12-30"
"57022","2024","COM","2022","1357","22","1379","2024-12-30"
"57024","2024","COM","2022","195","2","197","2024-12-30"
"57025","2024","COM","2022","480","7","487","2024-12-30"
"57026","2024","COM","2022","1072","18","1090","2024-12-30"
"57027","2024","COM","2022","123","1","124","2024-12-30"
"57028","2024","COM","2022","1334","39","1373","2024-12-30"
"57029","2024","COM","2022","216","3","219","2024-12-30"
"57030","2024","COM","2022","532","7","539","2024-12-30"
"57031","2024","COM","2022","938","17","955","2024-12-30"
"57032","2024","COM","2022","4645","48","4693","2024-12-30"
"57033","2024","COM","2022","523","19","542","2024-12-30"
"57034","2024","COM","2022","37","0","37","2024-12-30"
"57035","2024","COM","2022","114","1","115","2024-12-30"
"57036","2024","COM","2022","99","0","99","2024-12-30"
"57037","2024","COM","2022","266","5","271","2024-12-30"
"57038","2024","COM","2022","7268","78","7346","2024-12-30"
"57039","2024","COM","2022","2127","37","2164","2024-12-30"
"57040","2024","COM","2022","308","2","310","2024-12-30"
"57041","2024","COM","2022","2401","33","2434","2024-12-30"
"57042","2024","COM","2022","578","9","587","2024-12-30"
"57043","2024","COM","2022","1614","23","1637","2024-12-30"
"57044","2024","COM","2022","101","0","101","2024-12-30"
"57045","2024","COM","2022","113","0","113","2024-12-30"
"57046","2024","COM","2022","742","11","753","2024-12-30"
"57047","2024","COM","2022","1024","16","1040","2024-12-30"
"57048","2024","COM","2022","75","3","78","2024-12-30"
"57049","2024","COM","2022","4637","69","4706","2024-12-30"
"57050","2024","COM","2022","101","2","103","2024-12-30"
"57051","2024","COM","2022","369","4","373","2024-12-30"
"57052","2024","COM","2022","571","9","580","2024-12-30"
"57053","2024","COM","2022","107","5","112","2024-12-30"
"57054","2024","COM","2022","176","1","177","2024-12-30"
"57055","2024","COM","2022","542","5","547","2024-12-30"
"57056","2024","COM","2022","189","5","194","2024-12-30"
"57057","2024","COM","2022","614","7","621","2024-12-30"
"57058","2024","COM","2022","6299","42","6341","2024-12-30"
"57059","2024","COM","2022","57","2","59","2024-12-30"
"57060","2024","COM","2022","518","5","523","2024-12-30"
"57061","2024","COM","2022","1133","28","1161","2024-12-30"
"57062","2024","COM","2022","457","15","472","2024-12-30"
"57063","2024","COM","2022","213","6","219","2024-12-30"
"57064","2024","COM","2022","295","7","302","2024-12-30"
"57065","2024","COM","2022","201","5","206","2024-12-30"
"57066","2024","COM","2022","508","4","512","2024-12-30"
"57067","2024","COM","2022","2900","77","2977","2024-12-30"
"57069","2024","COM","2022","462","9","471","2024-12-30"
"57070","2024","COM","2022","244","8","252","2024-12-30"
"57071","2024","COM","2022","397","10","407","2024-12-30"
"57072","2024","COM","2022","624","6","630","2024-12-30"
"57073","2024","COM","2022","860","16","876","2024-12-30"
"57074","2024","COM","2022","819","16","835","2024-12-30"
"57075","2024","COM","2022","297","3","300","2024-12-30"
"57076","2024","COM","2022","528","8","536","2024-12-30"
"57077","2024","COM","2022","94","1","95","2024-12-30"
"57079","2024","COM","2022","433","7","440","2024-12-30"
"57080","2024","COM","2022","85","0","85","2024-12-30"
"57081","2024","COM","2022","121","2","123","2024-12-30"
"57082","2024","COM","2022","339","7","346","2024-12-30"
"57083","2024","COM","2022","1173","17","1190","2024-12-30"
"57084","2024","COM","2022","300","6","306","2024-12-30"
"57085","2024","COM","2022","393","2","395","2024-12-30"
"57086","2024","COM","2022","231","5","236","2024-12-30"
"57087","2024","COM","2022","249","6","255","2024-12-30"
"57088","2024","COM","2022","312","2","314","2024-12-30"
"57089","2024","COM","2022","4899","101","5000","2024-12-30"
"57090","2024","COM","2022","105","2","107","2024-12-30"
"57091","2024","COM","2022","976","22","998","2024-12-30"
"57092","2024","COM","2022","600","8","608","2024-12-30"
"57093","2024","COM","2022","651","11","662","2024-12-30"
"57095","2024","COM","2022","566","8","574","2024-12-30"
"57096","2024","COM","2022","2431","45","2476","2024-12-30"
"57097","2024","COM","2022","5479","62","5541","2024-12-30"
"57098","2024","COM","2022","226","12","238","2024-12-30"
"57099","2024","COM","2022","246","5","251","2024-12-30"
"57100","2024","COM","2022","175","5","180","2024-12-30"
"57101","2024","COM","2022","1188","24","1212","2024-12-30"
"57102","2024","COM","2022","3254","54","3308","2024-12-30"
"57103","2024","COM","2022","115","2","117","2024-12-30"
"57104","2024","COM","2022","1159","27","1186","2024-12-30"
"57105","2024","COM","2022","152","2","154","2024-12-30"
"57106","2024","COM","2022","3824","57","3881","2024-12-30"
"57107","2024","COM","2022","100","0","100","2024-12-30"
"57108","2024","COM","2022","310","5","315","2024-12-30"
"57109","2024","COM","2022","853","13","866","2024-12-30"
"57110","2024","COM","2022","430","2","432","2024-12-30"
"57111","2024","COM","2022","504","3","507","2024-12-30"
"57112","2024","COM","2022","81","0","81","2024-12-30"
"57113","2024","COM","2022","971","19","990","2024-12-30"
"57114","2024","COM","2022","420","6","426","2024-12-30"
"57115","2024","COM","2022","99","4","103","2024-12-30"
"57116","2024","COM","2022","98","1","99","2024-12-30"
"57117","2024","COM","2022","567","15","582","2024-12-30"
"57118","2024","COM","2022","160","6","166","2024-12-30"
"57119","2024","COM","2022","1191","33","1224","2024-12-30"
"57120","2024","COM","2022","123","2","125","2024-12-30"
"57121","2024","COM","2022","226","5","231","2024-12-30"
"57122","2024","COM","2022","679","13","692","2024-12-30"
"57123","2024","COM","2022","3332","29","3361","2024-12-30"
"57124","2024","COM","2022","2593","58","2651","2024-12-30"
"57125","2024","COM","2022","404","5","409","2024-12-30"
"57126","2024","COM","2022","317","9","326","2024-12-30"
"57127","2024","COM","2022","149","1","150","2024-12-30"
"57128","2024","COM","2022","285","10","295","2024-12-30"
"57129","2024","COM","2022","793","15","808","2024-12-30"
"57130","2024","COM","2022","70","1","71","2024-12-30"
"57131","2024","COM","2022","297","12","309","2024-12-30"
"57132","2024","COM","2022","2294","238","2532","2024-12-30"
"57133","2024","COM","2022","106","0","106","2024-12-30"
"57134","2024","COM","2022","1869","193","2062","2024-12-30"
"57136","2024","COM","2022","592","17","609","2024-12-30"
"57137","2024","COM","2022","824","13","837","2024-12-30"
"57138","2024","COM","2022","80","0","80","2024-12-30"
"57139","2024","COM","2022","276","5","281","2024-12-30"
"57140","2024","COM","2022","557","10","567","2024-12-30"
"57141","2024","COM","2022","89","0","89","2024-12-30"
"57142","2024","COM","2022","413","7","420","2024-12-30"
"57143","2024","COM","2022","3591","25","3616","2024-12-30"
"57144","2024","COM","2022","3351","39","3390","2024-12-30"
"57145","2024","COM","2022","326","5","331","2024-12-30"
"57146","2024","COM","2022","817","24","841","2024-12-30"
"57147","2024","COM","2022","334","13","347","2024-12-30"
"57148","2024","COM","2022","564","12","576","2024-12-30"
"57149","2024","COM","2022","207","4","211","2024-12-30"
"57150","2024","COM","2022","722","8","730","2024-12-30"
"57151","2024","COM","2022","136","2","138","2024-12-30"
"57152","2024","COM","2022","524","7","531","2024-12-30"
"57153","2024","COM","2022","2155","38","2193","2024-12-30"
"57154","2024","COM","2022","601","18","619","2024-12-30"
"57155","2024","COM","2022","3005","327","3332","2024-12-30"
"57156","2024","COM","2022","1188","24","1212","2024-12-30"
"57158","2024","COM","2022","228","5","233","2024-12-30"
"57159","2024","COM","2022","3745","39","3784","2024-12-30"
"57160","2024","COM","2022","12389","174","12563","2024-12-30"
"57161","2024","COM","2022","101","1","102","2024-12-30"
"57162","2024","COM","2022","1040","18","1058","2024-12-30"
"57163","2024","COM","2022","2367","45","2412","2024-12-30"
"57165","2024","COM","2022","698","11","709","2024-12-30"
"57166","2024","COM","2022","98","1","99","2024-12-30"
"57167","2024","COM","2022","378","8","386","2024-12-30"
"57168","2024","COM","2022","671","16","687","2024-12-30"
"57169","2024","COM","2022","506","17","523","2024-12-30"
"57171","2024","COM","2022","1150","16","1166","2024-12-30"
"57172","2024","COM","2022","273","3","276","2024-12-30"
"57173","2024","COM","2022","99","3","102","2024-12-30"
"57174","2024","COM","2022","110","1","111","2024-12-30"
"57175","2024","COM","2022","244","4","248","2024-12-30"
"57176","2024","COM","2022","1670","37","1707","2024-12-30"
"57177","2024","COM","2022","2792","185","2977","2024-12-30"
"57178","2024","COM","2022","361","3","364","2024-12-30"
"57179","2024","COM","2022","1853","33","1886","2024-12-30"
"57180","2024","COM","2022","341","10","351","2024-12-30"
"57181","2024","COM","2022","97","2","99","2024-12-30"
"57182","2024","COM","2022","93","1","94","2024-12-30"
"57183","2024","COM","2022","190","1","191","2024-12-30"
"57186","2024","COM","2022","963","9","972","2024-12-30"
"57187","2024","COM","2022","363","7","370","2024-12-30"
"57188","2024","COM","2022","443","153","596","2024-12-30"
"57189","2024","COM","2022","223","2","225","2024-12-30"
"57190","2024","COM","2022","419","2","421","2024-12-30"
"57191","2024","COM","2022","672","19","691","2024-12-30"
"57192","2024","COM","2022","1210","25","1235","2024-12-30"
"57193","2024","COM","2022","2313","28","2341","2024-12-30"
"57194","2024","COM","2022","1202","34","1236","2024-12-30"
"57195","2024","COM","2022","566","10","576","2024-12-30"
"57196","2024","COM","2022","418","9","427","2024-12-30"
"57197","2024","COM","2022","506","9","515","2024-12-30"
"57198","2024","COM","2022","189","2","191","2024-12-30"
"57199","2024","COM","2022","697","14","711","2024-12-30"
"57200","2024","COM","2022","412","8","420","2024-12-30"
"57201","2024","COM","2022","714","11","725","2024-12-30"
"57202","2024","COM","2022","1135","16","1151","2024-12-30"
"57203","2024","COM","2022","227","4","231","2024-12-30"
"57204","2024","COM","2022","542","9","551","2024-12-30"
"57205","2024","COM","2022","2516","32","2548","2024-12-30"
"57206","2024","COM","2022","14759","158","14917","2024-12-30"
"57207","2024","COM","2022","5226","47","5273","2024-12-30"
"57208","2024","COM","2022","1325","14","1339","2024-12-30"
"57209","2024","COM","2022","5154","84","5238","2024-12-30"
"57210","2024","COM","2022","648","20","668","2024-12-30"
"57211","2024","COM","2022","1196","11","1207","2024-12-30"
"57212","2024","COM","2022","741","9","750","2024-12-30"
"57213","2024","COM","2022","774","11","785","2024-12-30"
"57214","2024","COM","2022","399","4","403","2024-12-30"
"57215","2024","COM","2022","371","3","374","2024-12-30"
"57216","2024","COM","2022","138","2","140","2024-12-30"
"57217","2024","COM","2022","876","19","895","2024-12-30"
"57218","2024","COM","2022","1284","24","1308","2024-12-30"
"57219","2024","COM","2022","588","7","595","2024-12-30"
"57220","2024","COM","2022","129","2","131","2024-12-30"
"57221","2024","COM","2022","11891","117","12008","2024-12-30"
"57222","2024","COM","2022","1392","27","1419","2024-12-30"
"57224","2024","COM","2022","3937","44","3981","2024-12-30"
"57225","2024","COM","2022","141","2","143","2024-12-30"
"57226","2024","COM","2022","3163","40","3203","2024-12-30"
"57227","2024","COM","2022","21111","261","21372","2024-12-30"
"57228","2024","COM","2022","186","4","190","2024-12-30"
"57229","2024","COM","2022","157","2","159","2024-12-30"
"57230","2024","COM","2022","192","2","194","2024-12-30"
"57231","2024","COM","2022","103","0","103","2024-12-30"
"57232","2024","COM","2022","759","15","774","2024-12-30"
"57233","2024","COM","2022","84","0","84","2024-12-30"
"57234","2024","COM","2022","602","10","612","2024-12-30"
"57235","2024","COM","2022","1010","21","1031","2024-12-30"
"57236","2024","COM","2022","88","0","88","2024-12-30"
"57237","2024","COM","2022","304","5","309","2024-12-30"
"57238","2024","COM","2022","197","6","203","2024-12-30"
"57239","2024","COM","2022","428","10","438","2024-12-30"
"57240","2024","COM","2022","13069","119","13188","2024-12-30"
"57241","2024","COM","2022","163","8","171","2024-12-30"
"57242","2024","COM","2022","3006","32","3038","2024-12-30"
"57244","2024","COM","2022","486","14","500","2024-12-30"
"57245","2024","COM","2022","591","15","606","2024-12-30"
"57246","2024","COM","2022","213","5","218","2024-12-30"
"57247","2024","COM","2022","80","2","82","2024-12-30"
"57248","2024","COM","2022","92","3","95","2024-12-30"
"57249","2024","COM","2022","259","3","262","2024-12-30"
"57250","2024","COM","2022","1464","24","1488","2024-12-30"
"57251","2024","COM","2022","352","0","352","2024-12-30"
"57252","2024","COM","2022","472","9","481","2024-12-30"
"57253","2024","COM","2022","504","8","512","2024-12-30"
"57254","2024","COM","2022","1133","13","1146","2024-12-30"
"57255","2024","COM","2022","571","11","582","2024-12-30"
"57256","2024","COM","2022","813","6","819","2024-12-30"
"57257","2024","COM","2022","100","1","101","2024-12-30"
"57258","2024","COM","2022","112","1","113","2024-12-30"
"57259","2024","COM","2022","311","10","321","2024-12-30"
"57260","2024","COM","2022","3322","52","3374","2024-12-30"
"57261","2024","COM","2022","1273","29","1302","2024-12-30"
"57262","2024","COM","2022","620","10","630","2024-12-30"
"57263","2024","COM","2022","661","11","672","2024-12-30"
"57264","2024","COM","2022","415","6","421","2024-12-30"
"57265","2024","COM","2022","60","3","63","2024-12-30"
"57266","2024","COM","2022","148","6","154","2024-12-30"
"57267","2024","COM","2022","798","12","810","2024-12-30"
"57268","2024","COM","2022","125","1","126","2024-12-30"
"57269","2024","COM","2022","7922","66","7988","2024-12-30"
"57270","2024","COM","2022","518","6","524","2024-12-30"
"57271","2024","COM","2022","681","17","698","2024-12-30"
"57272","2024","COM","2022","93","3","96","2024-12-30"
"57273","2024","COM","2022","367","9","376","2024-12-30"
"57274","2024","COM","2022","870","15","885","2024-12-30"
"57275","2024","COM","2022","924","18","942","2024-12-30"
"57276","2024","COM","2022","328","3","331","2024-12-30"
"57277","2024","COM","2022","143","4","147","2024-12-30"
"57278","2024","COM","2022","62","1","63","2024-12-30"
"57280","2024","COM","2022","356","19","375","2024-12-30"
"57281","2024","COM","2022","231","5","236","2024-12-30"
"57282","2024","COM","2022","369","4","373","2024-12-30"
"57283","2024","COM","2022","9300","109","9409","2024-12-30"
"57284","2024","COM","2022","104","1","105","2024-12-30"
"57286","2024","COM","2022","296","3","299","2024-12-30"
"57287","2024","COM","2022","2318","47","2365","2024-12-30"
"57288","2024","COM","2022","2889","37","2926","2024-12-30"
"57289","2024","COM","2022","2787","58","2845","2024-12-30"
"57290","2024","COM","2022","167","1","168","2024-12-30"
"57291","2024","COM","2022","261","3","264","2024-12-30"
"57292","2024","COM","2022","15","0","15","2024-12-30"
"57293","2024","COM","2022","251","9","260","2024-12-30"
"57294","2024","COM","2022","189","3","192","2024-12-30"
"57295","2024","COM","2022","109","1","110","2024-12-30"
"57296","2024","COM","2022","1083","17","1100","2024-12-30"
"57297","2024","COM","2022","186","5","191","2024-12-30"
"57298","2024","COM","2022","365","7","372","2024-12-30"
"57299","2024","COM","2022","939","17","956","2024-12-30"
"57300","2024","COM","2022","297","5","302","2024-12-30"
"57301","2024","COM","2022","292","4","296","2024-12-30"
"57302","2024","COM","2022","220","3","223","2024-12-30"
"57303","2024","COM","2022","589","9","598","2024-12-30"
"57304","2024","COM","2022","349","5","354","2024-12-30"
"57305","2024","COM","2022","451","5","456","2024-12-30"
"57306","2024","COM","2022","16013","205","16218","2024-12-30"
"57307","2024","COM","2022","257","5","262","2024-12-30"
"57308","2024","COM","2022","155","4","159","2024-12-30"
"57309","2024","COM","2022","485","5","490","2024-12-30"
"57310","2024","COM","2022","188","5","193","2024-12-30"
"57311","2024","COM","2022","517","10","527","2024-12-30"
"57312","2024","COM","2022","484","9","493","2024-12-30"
"57313","2024","COM","2022","143","3","146","2024-12-30"
"57314","2024","COM","2022","495","6","501","2024-12-30"
"57315","2024","COM","2022","705","22","727","2024-12-30"
"57316","2024","COM","2022","753","16","769","2024-12-30"
"57317","2024","COM","2022","104","1","105","2024-12-30"
"57318","2024","COM","2022","215","5","220","2024-12-30"
"57319","2024","COM","2022","519","7","526","2024-12-30"
"57320","2024","COM","2022","178","3","181","2024-12-30"
"57321","2024","COM","2022","552","21","573","2024-12-30"
"57322","2024","COM","2022","479","6","485","2024-12-30"
"57323","2024","COM","2022","7768","180","7948","2024-12-30"
"57324","2024","COM","2022","615","9","624","2024-12-30"
"57325","2024","COM","2022","840","15","855","2024-12-30"
"57326","2024","COM","2022","328","3","331","2024-12-30"
"57328","2024","COM","2022","91","1","92","2024-12-30"
"57329","2024","COM","2022","443","11","454","2024-12-30"
"57330","2024","COM","2022","1265","20","1285","2024-12-30"
"57331","2024","COM","2022","544","11","555","2024-12-30"
"57332","2024","COM","2022","6122","56","6178","2024-12-30"
"57333","2024","COM","2022","831","24","855","2024-12-30"
"57334","2024","COM","2022","309","4","313","2024-12-30"
"57335","2024","COM","2022","213","4","217","2024-12-30"
"57336","2024","COM","2022","5179","59","5238","2024-12-30"
"57337","2024","COM","2022","572","17","589","2024-12-30"
"57338","2024","COM","2022","505","5","510","2024-12-30"
"57339","2024","COM","2022","362","5","367","2024-12-30"
"57340","2024","COM","2022","1344","24","1368","2024-12-30"
"57341","2024","COM","2022","689","10","699","2024-12-30"
"57342","2024","COM","2022","90","0","90","2024-12-30"
"57343","2024","COM","2022","1785","38","1823","2024-12-30"
"57344","2024","COM","2022","702","12","714","2024-12-30"
"57345","2024","COM","2022","395","32","427","2024-12-30"
"57346","2024","COM","2022","601","9","610","2024-12-30"
"57347","2024","COM","2022","171","5","176","2024-12-30"
"57348","2024","COM","2022","790","14","804","2024-12-30"
"57349","2024","COM","2022","139","3","142","2024-12-30"
"57350","2024","COM","2022","1431","26","1457","2024-12-30"
"57351","2024","COM","2022","1383","20","1403","2024-12-30"
"57352","2024","COM","2022","458","17","475","2024-12-30"
"57353","2024","COM","2022","72","1","73","2024-12-30"
"57354","2024","COM","2022","138","0","138","2024-12-30"
"57355","2024","COM","2022","779","19","798","2024-12-30"
"57356","2024","COM","2022","1234","39","1273","2024-12-30"
"57357","2024","COM","2022","421","2","423","2024-12-30"
"57358","2024","COM","2022","1060","26","1086","2024-12-30"
"57359","2024","COM","2022","177","4","181","2024-12-30"
"57360","2024","COM","2022","1223","21","1244","2024-12-30"
"57361","2024","COM","2022","608","15","623","2024-12-30"
"57362","2024","COM","2022","192","5","197","2024-12-30"
"57364","2024","COM","2022","329","7","336","2024-12-30"
"57365","2024","COM","2022","479","11","490","2024-12-30"
"57366","2024","COM","2022","140","4","144","2024-12-30"
"57367","2024","COM","2022","213","3","216","2024-12-30"
"57368","2024","COM","2022","3206","45","3251","2024-12-30"
"57370","2024","COM","2022","2242","30","2272","2024-12-30"
"57371","2024","COM","2022","550","10","560","2024-12-30"
"57372","2024","COM","2022","1365","27","1392","2024-12-30"
"57373","2024","COM","2022","913","19","932","2024-12-30"
"57374","2024","COM","2022","207","2","209","2024-12-30"
"57375","2024","COM","2022","181","5","186","2024-12-30"
"57376","2024","COM","2022","475","15","490","2024-12-30"
"57377","2024","COM","2022","242","7","249","2024-12-30"
"57379","2024","COM","2022","268","2","270","2024-12-30"
"57380","2024","COM","2022","105","3","108","2024-12-30"
"57381","2024","COM","2022","285","6","291","2024-12-30"
"57382","2024","COM","2022","629","8","637","2024-12-30"
"57383","2024","COM","2022","159","6","165","2024-12-30"
"57384","2024","COM","2022","601","13","614","2024-12-30"
"57385","2024","COM","2022","1254","23","1277","2024-12-30"
"57386","2024","COM","2022","339","8","347","2024-12-30"
"57387","2024","COM","2022","285","4","289","2024-12-30"
"57388","2024","COM","2022","241","7","248","2024-12-30"
"57389","2024","COM","2022","460","12","472","2024-12-30"
"57390","2024","COM","2022","1427","42","1469","2024-12-30"
"57391","2024","COM","2022","59","2","61","2024-12-30"
"57392","2024","COM","2022","524","2","526","2024-12-30"
"57393","2024","COM","2022","189","1","190","2024-12-30"
"57394","2024","COM","2022","329","6","335","2024-12-30"
"57395","2024","COM","2022","204","4","208","2024-12-30"
"57396","2024","COM","2022","794","29","823","2024-12-30"
"57397","2024","COM","2022","107","3","110","2024-12-30"
"57398","2024","COM","2022","506","10","516","2024-12-30"
"57399","2024","COM","2022","90","7","97","2024-12-30"
"57401","2024","COM","2022","83","1","84","2024-12-30"
"57402","2024","COM","2022","117","1","118","2024-12-30"
"57403","2024","COM","2022","131","0","131","2024-12-30"
"57404","2024","COM","2022","222","7","229","2024-12-30"
"57405","2024","COM","2022","49","1","50","2024-12-30"
"57406","2024","COM","2022","143","5","148","2024-12-30"
"57407","2024","COM","2022","564","10","574","2024-12-30"
"57408","2024","COM","2022","810","16","826","2024-12-30"
"57409","2024","COM","2022","672","11","683","2024-12-30"
"57410","2024","COM","2022","145","3","148","2024-12-30"
"57411","2024","COM","2022","383","1","384","2024-12-30"
"57412","2024","COM","2022","4017","63","4080","2024-12-30"
"57413","2024","COM","2022","3592","63","3655","2024-12-30"
"57414","2024","COM","2022","1134","24","1158","2024-12-30"
"57415","2024","COM","2022","1726","58","1784","2024-12-30"
"57416","2024","COM","2022","678","9","687","2024-12-30"
"57417","2024","COM","2022","71","3","74","2024-12-30"
"57418","2024","COM","2022","301","5","306","2024-12-30"
"57419","2024","COM","2022","899","12","911","2024-12-30"
"57421","2024","COM","2022","152","3","155","2024-12-30"
"57422","2024","COM","2022","879","10","889","2024-12-30"
"57423","2024","COM","2022","67","1","68","2024-12-30"
"57424","2024","COM","2022","228","0","228","2024-12-30"
"57425","2024","COM","2022","588","10","598","2024-12-30"
"57426","2024","COM","2022","955","18","973","2024-12-30"
"57427","2024","COM","2022","558","7","565","2024-12-30"
"57428","2024","COM","2022","2827","47","2874","2024-12-30"
"57430","2024","COM","2022","322","6","328","2024-12-30"
"57431","2024","COM","2022","419","3","422","2024-12-30"
"57433","2024","COM","2022","11725","100","11825","2024-12-30"
"57434","2024","COM","2022","470","7","477","2024-12-30"
"57436","2024","COM","2022","131","6","137","2024-12-30"
"57437","2024","COM","2022","680","13","693","2024-12-30"
"57438","2024","COM","2022","353","5","358","2024-12-30"
"57439","2024","COM","2022","602","13","615","2024-12-30"
"57440","2024","COM","2022","142","3","145","2024-12-30"
"57441","2024","COM","2022","3074","76","3150","2024-12-30"
"57442","2024","COM","2022","251","3","254","2024-12-30"
"57443","2024","COM","2022","6517","56","6573","2024-12-30"
"57444","2024","COM","2022","371","6","377","2024-12-30"
"57445","2024","COM","2022","699","11","710","2024-12-30"
"57446","2024","COM","2022","53","0","53","2024-12-30"
"57447","2024","COM","2022","9937","199","10136","2024-12-30"
"57448","2024","COM","2022","234","6","240","2024-12-30"
"57449","2024","COM","2022","585","2","587","2024-12-30"
"57451","2024","COM","2022","167","5","172","2024-12-30"
"57452","2024","COM","2022","1058","15","1073","2024-12-30"
"57453","2024","COM","2022","296","10","306","2024-12-30"
"57454","2024","COM","2022","1201","24","1225","2024-12-30"
"57455","2024","COM","2022","140","3","143","2024-12-30"
"57456","2024","COM","2022","641","22","663","2024-12-30"
"57457","2024","COM","2022","140","1","141","2024-12-30"
"57459","2024","COM","2022","290","4","294","2024-12-30"
"57460","2024","COM","2022","1450","14","1464","2024-12-30"
"57461","2024","COM","2022","274","8","282","2024-12-30"
"57462","2024","COM","2022","425","10","435","2024-12-30"
"57463","2024","COM","2022","121695","1837","123532","2024-12-30"
"57464","2024","COM","2022","988","29","1017","2024-12-30"
"57465","2024","COM","2022","2276","53","2329","2024-12-30"
"57466","2024","COM","2022","693","6","699","2024-12-30"
"57467","2024","COM","2022","308","2","310","2024-12-30"
"57468","2024","COM","2022","642","17","659","2024-12-30"
"57469","2024","COM","2022","579","3","582","2024-12-30"
"57470","2024","COM","2022","9","1","10","2024-12-30"
"57471","2024","COM","2022","297","3","300","2024-12-30"
"57472","2024","COM","2022","146","0","146","2024-12-30"
"57473","2024","COM","2022","63","2","65","2024-12-30"
"57474","2024","COM","2022","5739","56","5795","2024-12-30"
"57475","2024","COM","2022","582","9","591","2024-12-30"
"57476","2024","COM","2022","401","10","411","2024-12-30"
"57477","2024","COM","2022","1583","39","1622","2024-12-30"
"57478","2024","COM","2022","87","0","87","2024-12-30"
"57479","2024","COM","2022","487","14","501","2024-12-30"
"57480","2024","COM","2022","21869","310","22179","2024-12-30"
"57481","2024","COM","2022","2717","21","2738","2024-12-30"
"57482","2024","COM","2022","1792","32","1824","2024-12-30"
"57483","2024","COM","2022","3347","64","3411","2024-12-30"
"57484","2024","COM","2022","2657","29","2686","2024-12-30"
"57485","2024","COM","2022","111","6","117","2024-12-30"
"57486","2024","COM","2022","118","1","119","2024-12-30"
"57487","2024","COM","2022","5161","71","5232","2024-12-30"
"57488","2024","COM","2022","567","10","577","2024-12-30"
"57489","2024","COM","2022","273","0","273","2024-12-30"
"57490","2024","COM","2022","329","3","332","2024-12-30"
"57491","2024","COM","2022","7320","60","7380","2024-12-30"
"57492","2024","COM","2022","443","9","452","2024-12-30"
"57493","2024","COM","2022","209","4","213","2024-12-30"
"57494","2024","COM","2022","235","1","236","2024-12-30"
"57495","2024","COM","2022","115","2","117","2024-12-30"
"57496","2024","COM","2022","332","6","338","2024-12-30"
"57497","2024","COM","2022","262","8","270","2024-12-30"
"57498","2024","COM","2022","2636","35","2671","2024-12-30"
"57499","2024","COM","2022","1349","28","1377","2024-12-30"
"57500","2024","COM","2022","37","0","37","2024-12-30"
"57501","2024","COM","2022","48","0","48","2024-12-30"
"57502","2024","COM","2022","333","13","346","2024-12-30"
"57504","2024","COM","2022","277","5","282","2024-12-30"
"57505","2024","COM","2022","1152","20","1172","2024-12-30"
"57506","2024","COM","2022","236","5","241","2024-12-30"
"57507","2024","COM","2022","276","2","278","2024-12-30"
"57508","2024","COM","2022","4375","56","4431","2024-12-30"
"57509","2024","COM","2022","514","12","526","2024-12-30"
"57510","2024","COM","2022","1103","16","1119","2024-12-30"
"57511","2024","COM","2022","1000","21","1021","2024-12-30"
"57512","2024","COM","2022","718","10","728","2024-12-30"
"57513","2024","COM","2022","155","1","156","2024-12-30"
"57514","2024","COM","2022","1185","24","1209","2024-12-30"
"57515","2024","COM","2022","1861","27","1888","2024-12-30"
"57516","2024","COM","2022","332","3","335","2024-12-30"
"57517","2024","COM","2022","270","4","274","2024-12-30"
"57518","2024","COM","2022","320","10","330","2024-12-30"
"57519","2024","COM","2022","157","4","161","2024-12-30"
"57520","2024","COM","2022","37","0","37","2024-12-30"
"57521","2024","COM","2022","2636","53","2689","2024-12-30"
"57524","2024","COM","2022","128","1","129","2024-12-30"
"57525","2024","COM","2022","56","1","57","2024-12-30"
"57526","2024","COM","2022","383","9","392","2024-12-30"
"57527","2024","COM","2022","418","8","426","2024-12-30"
"57528","2024","COM","2022","107","1","108","2024-12-30"
"57529","2024","COM","2022","3012","86","3098","2024-12-30"
"57530","2024","COM","2022","455","6","461","2024-12-30"
"57531","2024","COM","2022","730","19","749","2024-12-30"
"57532","2024","COM","2022","231","3","234","2024-12-30"
"57533","2024","COM","2022","870","17","887","2024-12-30"
"57534","2024","COM","2022","1803","123","1926","2024-12-30"
"57535","2024","COM","2022","1416","32","1448","2024-12-30"
"57536","2024","COM","2022","216","3","219","2024-12-30"
"57537","2024","COM","2022","6176","63","6239","2024-12-30"
"57538","2024","COM","2022","298","3","301","2024-12-30"
"57539","2024","COM","2022","40","2","42","2024-12-30"
"57540","2024","COM","2022","4657","239","4896","2024-12-30"
"57541","2024","COM","2022","615","13","628","2024-12-30"
"57542","2024","COM","2022","965","11","976","2024-12-30"
"57543","2024","COM","2022","1460","31","1491","2024-12-30"
"57544","2024","COM","2022","605","16","621","2024-12-30"
"57545","2024","COM","2022","2025","57","2082","2024-12-30"
"57546","2024","COM","2022","782","31","813","2024-12-30"
"57547","2024","COM","2022","728","10","738","2024-12-30"
"57548","2024","COM","2022","601","8","609","2024-12-30"
"57549","2024","COM","2022","751","13","764","2024-12-30"
"57550","2024","COM","2022","2435","49","2484","2024-12-30"
"57551","2024","COM","2022","198","7","205","2024-12-30"
"57552","2024","COM","2022","927","12","939","2024-12-30"
"57553","2024","COM","2022","613","13","626","2024-12-30"
"57554","2024","COM","2022","741","26","767","2024-12-30"
"57555","2024","COM","2022","110","1","111","2024-12-30"
"57556","2024","COM","2022","3058","45","3103","2024-12-30"
"57557","2024","COM","2022","1033","26","1059","2024-12-30"
"57558","2024","COM","2022","74","0","74","2024-12-30"
"57559","2024","COM","2022","168","0","168","2024-12-30"
"57560","2024","COM","2022","620","13","633","2024-12-30"
"57561","2024","COM","2022","720","19","739","2024-12-30"
"57562","2024","COM","2022","901","17","918","2024-12-30"
"57563","2024","COM","2022","292","3","295","2024-12-30"
"57564","2024","COM","2022","555","12","567","2024-12-30"
"57565","2024","COM","2022","1004","19","1023","2024-12-30"
"57566","2024","COM","2022","2307","49","2356","2024-12-30"
"57567","2024","COM","2022","144","1","145","2024-12-30"
"57568","2024","COM","2022","1308","23","1331","2024-12-30"
"57569","2024","COM","2022","337","6","343","2024-12-30"
"57570","2024","COM","2022","419","5","424","2024-12-30"
"57571","2024","COM","2022","1034","22","1056","2024-12-30"
"57572","2024","COM","2022","2050","96","2146","2024-12-30"
"57573","2024","COM","2022","129","0","129","2024-12-30"
"57574","2024","COM","2022","525","13","538","2024-12-30"
"57575","2024","COM","2022","1332","30","1362","2024-12-30"
"57576","2024","COM","2022","849","46","895","2024-12-30"
"57577","2024","COM","2022","380","5","385","2024-12-30"
"57578","2024","COM","2022","506","4","510","2024-12-30"
"57579","2024","COM","2022","124","1","125","2024-12-30"
"57580","2024","COM","2022","184","2","186","2024-12-30"
"57581","2024","COM","2022","348","7","355","2024-12-30"
"57582","2024","COM","2022","2145","41","2186","2024-12-30"
"57583","2024","COM","2022","115","5","120","2024-12-30"
"57584","2024","COM","2022","631","16","647","2024-12-30"
"57586","2024","COM","2022","205","7","212","2024-12-30"
"57587","2024","COM","2022","246","2","248","2024-12-30"
"57588","2024","COM","2022","1282","39","1321","2024-12-30"
"57589","2024","COM","2022","2290","48","2338","2024-12-30"
"57590","2024","COM","2022","259","6","265","2024-12-30"
"57591","2024","COM","2022","9534","81","9615","2024-12-30"
"57592","2024","COM","2022","334","7","341","2024-12-30"
"57593","2024","COM","2022","1048","8","1056","2024-12-30"
"57594","2024","COM","2022","96","3","99","2024-12-30"
"57595","2024","COM","2022","48","0","48","2024-12-30"
"57596","2024","COM","2022","730","5","735","2024-12-30"
"57597","2024","COM","2022","2403","24","2427","2024-12-30"
"57598","2024","COM","2022","1965","51","2016","2024-12-30"
"57599","2024","COM","2022","338","8","346","2024-12-30"
"57600","2024","COM","2022","1559","38","1597","2024-12-30"
"57601","2024","COM","2022","1330","19","1349","2024-12-30"
"57602","2024","COM","2022","2349","52","2401","2024-12-30"
"57603","2024","COM","2022","1257","21","1278","2024-12-30"
"57604","2024","COM","2022","651","5","656","2024-12-30"
"57605","2024","COM","2022","316","2","318","2024-12-30"
"57606","2024","COM","2022","14828","286","15114","2024-12-30"
"57607","2024","COM","2022","783","11","794","2024-12-30"
"57609","2024","COM","2022","176","3","179","2024-12-30"
"57610","2024","COM","2022","322","5","327","2024-12-30"
"57611","2024","COM","2022","192","6","198","2024-12-30"
"57612","2024","COM","2022","231","5","236","2024-12-30"
"57613","2024","COM","2022","319","5","324","2024-12-30"
"57614","2024","COM","2022","674","5","679","2024-12-30"
"57615","2024","COM","2022","963","20","983","2024-12-30"
"57616","2024","COM","2022","3562","64","3626","2024-12-30"
"57617","2024","COM","2022","281","7","288","2024-12-30"
"57618","2024","COM","2022","622","17","639","2024-12-30"
"57619","2024","COM","2022","463","9","472","2024-12-30"
"57620","2024","COM","2022","4512","32","4544","2024-12-30"
"57621","2024","COM","2022","106","1","107","2024-12-30"
"57622","2024","COM","2022","1873","23","1896","2024-12-30"
"57623","2024","COM","2022","693","49","742","2024-12-30"
"57624","2024","COM","2022","605","13","618","2024-12-30"
"57625","2024","COM","2022","171","0","171","2024-12-30"
"57626","2024","COM","2022","507","13","520","2024-12-30"
"57627","2024","COM","2022","422","3","425","2024-12-30"
"57628","2024","COM","2022","4386","85","4471","2024-12-30"
"57629","2024","COM","2022","791","6","797","2024-12-30"
"57630","2024","COM","2022","12274","258","12532","2024-12-30"
"57631","2024","COM","2022","20324","437","20761","2024-12-30"
"57633","2024","COM","2022","1206","27","1233","2024-12-30"
"57634","2024","COM","2022","1572","41","1613","2024-12-30"
"57635","2024","COM","2022","378","7","385","2024-12-30"
"57636","2024","COM","2022","335","9","344","2024-12-30"
"57637","2024","COM","2022","313","6","319","2024-12-30"
"57638","2024","COM","2022","2442","25","2467","2024-12-30"
"57639","2024","COM","2022","541","8","549","2024-12-30"
"57640","2024","COM","2022","472","7","479","2024-12-30"
"57641","2024","COM","2022","319","6","325","2024-12-30"
"57642","2024","COM","2022","2665","55","2720","2024-12-30"
"57643","2024","COM","2022","202","7","209","2024-12-30"
"57644","2024","COM","2022","1695","41","1736","2024-12-30"
"57645","2024","COM","2022","1023","9","1032","2024-12-30"
"57647","2024","COM","2022","4188","57","4245","2024-12-30"
"57648","2024","COM","2022","487","10","497","2024-12-30"
"57649","2024","COM","2022","467","10","477","2024-12-30"
"57650","2024","COM","2022","1769","25","1794","2024-12-30"
"57651","2024","COM","2022","644","6","650","2024-12-30"
"57652","2024","COM","2022","633","5","638","2024-12-30"
"57653","2024","COM","2022","34","1","35","2024-12-30"
"57654","2024","COM","2022","711","6","717","2024-12-30"
"57655","2024","COM","2022","1138","54","1192","2024-12-30"
"57656","2024","COM","2022","390","6","396","2024-12-30"
"57657","2024","COM","2022","25","0","25","2024-12-30"
"57658","2024","COM","2022","1024","25","1049","2024-12-30"
"57659","2024","COM","2022","3180","50","3230","2024-12-30"
"57660","2024","COM","2022","11048","99","11147","2024-12-30"
"57661","2024","COM","2022","168","1","169","2024-12-30"
"57662","2024","COM","2022","95","1","96","2024-12-30"
"57663","2024","COM","2022","8044","179","8223","2024-12-30"
"57664","2024","COM","2022","60","3","63","2024-12-30"
"57665","2024","COM","2022","1041","19","1060","2024-12-30"
"57666","2024","COM","2022","7609","104","7713","2024-12-30"
"57667","2024","COM","2022","765","8","773","2024-12-30"
"57668","2024","COM","2022","1260","33","1293","2024-12-30"
"57669","2024","COM","2022","2424","41","2465","2024-12-30"
"57670","2024","COM","2022","133","1","134","2024-12-30"
"57671","2024","COM","2022","140","1","141","2024-12-30"
"57672","2024","COM","2022","42778","714","43492","2024-12-30"
"57673","2024","COM","2022","51","2","53","2024-12-30"
"57674","2024","COM","2022","173","4","177","2024-12-30"
"57675","2024","COM","2022","117","1","118","2024-12-30"
"57676","2024","COM","2022","88","2","90","2024-12-30"
"57677","2024","COM","2022","979","21","1000","2024-12-30"
"57678","2024","COM","2022","2464","33","2497","2024-12-30"
"57679","2024","COM","2022","513","10","523","2024-12-30"
"57680","2024","COM","2022","1259","28","1287","2024-12-30"
"57681","2024","COM","2022","333","4","337","2024-12-30"
"57682","2024","COM","2022","11","0","11","2024-12-30"
"57683","2024","COM","2022","7001","41","7042","2024-12-30"
"57684","2024","COM","2022","497","10","507","2024-12-30"
"57685","2024","COM","2022","146","4","150","2024-12-30"
"57686","2024","COM","2022","245","2","247","2024-12-30"
"57687","2024","COM","2022","211","4","215","2024-12-30"
"57689","2024","COM","2022","352","7","359","2024-12-30"
"57690","2024","COM","2022","2951","65","3016","2024-12-30"
"57691","2024","COM","2022","82","4","86","2024-12-30"
"57692","2024","COM","2022","69","0","69","2024-12-30"
"57693","2024","COM","2022","818","14","832","2024-12-30"
"57694","2024","COM","2022","473","11","484","2024-12-30"
"57695","2024","COM","2022","501","10","511","2024-12-30"
"57696","2024","COM","2022","972","9","981","2024-12-30"
"57697","2024","COM","2022","320","9","329","2024-12-30"
"57698","2024","COM","2022","307","6","313","2024-12-30"
"57700","2024","COM","2022","486","7","493","2024-12-30"
"57701","2024","COM","2022","786","26","812","2024-12-30"
"57702","2024","COM","2022","169","4","173","2024-12-30"
"57703","2024","COM","2022","230","16","246","2024-12-30"
"57704","2024","COM","2022","651","10","661","2024-12-30"
"57705","2024","COM","2022","204","4","208","2024-12-30"
"57706","2024","COM","2022","537","12","549","2024-12-30"
"57707","2024","COM","2022","676","5","681","2024-12-30"
"57708","2024","COM","2022","2056","46","2102","2024-12-30"
"57709","2024","COM","2022","306","6","312","2024-12-30"
"57711","2024","COM","2022","384","9","393","2024-12-30"
"57712","2024","COM","2022","1325","22","1347","2024-12-30"
"57713","2024","COM","2022","249","6","255","2024-12-30"
"57714","2024","COM","2022","450","8","458","2024-12-30"
"57715","2024","COM","2022","386","11","397","2024-12-30"
"57716","2024","COM","2022","1541","19","1560","2024-12-30"
"57717","2024","COM","2022","173","3","176","2024-12-30"
"57718","2024","COM","2022","222","2","224","2024-12-30"
"57719","2024","COM","2022","81","2","83","2024-12-30"
"57720","2024","COM","2022","514","14","528","2024-12-30"
"57721","2024","COM","2022","347","11","358","2024-12-30"
"57723","2024","COM","2022","295","7","302","2024-12-30"
"57724","2024","COM","2022","2929","36","2965","2024-12-30"
"57725","2024","COM","2022","336","2","338","2024-12-30"
"57726","2024","COM","2022","389","4","393","2024-12-30"
"57727","2024","COM","2022","122","4","126","2024-12-30"
"57728","2024","COM","2022","252","5","257","2024-12-30"
"57730","2024","COM","2022","553","18","571","2024-12-30"
"57731","2024","COM","2022","2284","40","2324","2024-12-30"
"57732","2024","COM","2022","774","24","798","2024-12-30"
"57733","2024","COM","2022","2074","30","2104","2024-12-30"
"57734","2024","COM","2022","449","5","454","2024-12-30"
"57736","2024","COM","2022","629","12","641","2024-12-30"
"57737","2024","COM","2022","31","2","33","2024-12-30"
"57738","2024","COM","2022","350","8","358","2024-12-30"
"57739","2024","COM","2022","521","5","526","2024-12-30"
"57740","2024","COM","2022","804","11","815","2024-12-30"
"57741","2024","COM","2022","392","11","403","2024-12-30"
"57742","2024","COM","2022","1467","27","1494","2024-12-30"
"57743","2024","COM","2022","232","5","237","2024-12-30"
"57745","2024","COM","2022","908","22","930","2024-12-30"
"57746","2024","COM","2022","1519","33","1552","2024-12-30"
"57747","2024","COM","2022","260","3","263","2024-12-30"
"57748","2024","COM","2022","741","19","760","2024-12-30"
"57749","2024","COM","2022","159","5","164","2024-12-30"
"57750","2024","COM","2022","697","26","723","2024-12-30"
"57751","2024","COM","2022","14394","114","14508","2024-12-30"
"57752","2024","COM","2022","2822","48","2870","2024-12-30"
"57753","2024","COM","2022","62","1","63","2024-12-30"
"57754","2024","COM","2022","110","1","111","2024-12-30"
"57755","2024","COM","2022","99","0","99","2024-12-30"
"57756","2024","COM","2022","316","5","321","2024-12-30"
"57757","2024","COM","2022","17497","296","17793","2024-12-30"
"57759","2024","COM","2022","67","1","68","2024-12-30"
"57760","2024","COM","2022","856","20","876","2024-12-30"
"57761","2024","COM","2022","281","4","285","2024-12-30"
"57762","2024","COM","2022","711","6","717","2024-12-30"
"57763","2024","COM","2022","44","0","44","2024-12-30"
"57764","2024","COM","2022","1271","17","1288","2024-12-30"
"57765","2024","COM","2022","1029","20","1049","2024-12-30"
"57767","2024","COM","2022","1455","32","1487","2024-12-30"
"58001","2024","COM","2022","160","0","160","2024-12-30"
"58002","2024","COM","2022","922","10","932","2024-12-30"
"58003","2024","COM","2022","603","8","611","2024-12-30"
"58004","2024","COM","2022","368","6","374","2024-12-30"
"58005","2024","COM","2022","214","4","218","2024-12-30"
"58006","2024","COM","2022","241","3","244","2024-12-30"
"58007","2024","COM","2022","345","3","348","2024-12-30"
"58008","2024","COM","2022","168","3","171","2024-12-30"
"58009","2024","COM","2022","123","1","124","2024-12-30"
"58010","2024","COM","2022","641","7","648","2024-12-30"
"58011","2024","COM","2022","272","6","278","2024-12-30"
"58012","2024","COM","2022","550","13","563","2024-12-30"
"58013","2024","COM","2022","90","3","93","2024-12-30"
"58014","2024","COM","2022","69","0","69","2024-12-30"
"58015","2024","COM","2022","119","3","122","2024-12-30"
"58016","2024","COM","2022","140","6","146","2024-12-30"
"58017","2024","COM","2022","228","7","235","2024-12-30"
"58018","2024","COM","2022","40","0","40","2024-12-30"
"58019","2024","COM","2022","84","2","86","2024-12-30"
"58020","2024","COM","2022","247","4","251","2024-12-30"
"58021","2024","COM","2022","195","4","199","2024-12-30"
"58023","2024","COM","2022","165","1","166","2024-12-30"
"58024","2024","COM","2022","284","9","293","2024-12-30"
"58025","2024","COM","2022","161","6","167","2024-12-30"
"58026","2024","COM","2022","143","8","151","2024-12-30"
"58027","2024","COM","2022","119","5","124","2024-12-30"
"58028","2024","COM","2022","116","3","119","2024-12-30"
"58029","2024","COM","2022","86","0","86","2024-12-30"
"58030","2024","COM","2022","254","6","260","2024-12-30"
"58031","2024","COM","2022","316","3","319","2024-12-30"
"58032","2024","COM","2022","367","3","370","2024-12-30"
"58033","2024","COM","2022","311","8","319","2024-12-30"
"58034","2024","COM","2022","187","5","192","2024-12-30"
"58035","2024","COM","2022","297","3","300","2024-12-30"
"58036","2024","COM","2022","427","8","435","2024-12-30"
"58037","2024","COM","2022","594","35","629","2024-12-30"
"58038","2024","COM","2022","152","3","155","2024-12-30"
"58039","2024","COM","2022","249","2","251","2024-12-30"
"58040","2024","COM","2022","145","2","147","2024-12-30"
"58041","2024","COM","2022","166","5","171","2024-12-30"
"58042","2024","COM","2022","144","2","146","2024-12-30"
"58043","2024","COM","2022","53","0","53","2024-12-30"
"58044","2024","COM","2022","786","9","795","2024-12-30"
"58045","2024","COM","2022","155","2","157","2024-12-30"
"58046","2024","COM","2022","1683","22","1705","2024-12-30"
"58047","2024","COM","2022","594","12","606","2024-12-30"
"58048","2024","COM","2022","114","8","122","2024-12-30"
"58049","2024","COM","2022","83","2","85","2024-12-30"
"58050","2024","COM","2022","45","1","46","2024-12-30"
"58051","2024","COM","2022","1468","152","1620","2024-12-30"
"58052","2024","COM","2022","55","1","56","2024-12-30"
"58053","2024","COM","2022","326","9","335","2024-12-30"
"58054","2024","COM","2022","42","1","43","2024-12-30"
"58055","2024","COM","2022","744","13","757","2024-12-30"
"58056","2024","COM","2022","285","8","293","2024-12-30"
"58057","2024","COM","2022","1090","24","1114","2024-12-30"
"58058","2024","COM","2022","305","8","313","2024-12-30"
"58059","2024","COM","2022","4701","42","4743","2024-12-30"
"58060","2024","COM","2022","606","13","619","2024-12-30"
"58061","2024","COM","2022","128","0","128","2024-12-30"
"58062","2024","COM","2022","1857","364","2221","2024-12-30"
"58063","2024","COM","2022","555","8","563","2024-12-30"
"58064","2024","COM","2022","479","11","490","2024-12-30"
"58065","2024","COM","2022","835","16","851","2024-12-30"
"58066","2024","COM","2022","83","0","83","2024-12-30"
"58067","2024","COM","2022","1503","27","1530","2024-12-30"
"58068","2024","COM","2022","196","1","197","2024-12-30"
"58069","2024","COM","2022","164","4","168","2024-12-30"
"58070","2024","COM","2022","61","0","61","2024-12-30"
"58071","2024","COM","2022","136","7","143","2024-12-30"
"58072","2024","COM","2022","632","10","642","2024-12-30"
"58073","2024","COM","2022","114","3","117","2024-12-30"
"58074","2024","COM","2022","353","12","365","2024-12-30"
"58075","2024","COM","2022","218","3","221","2024-12-30"
"58076","2024","COM","2022","84","0","84","2024-12-30"
"58077","2024","COM","2022","376","8","384","2024-12-30"
"58078","2024","COM","2022","52","0","52","2024-12-30"
"58079","2024","COM","2022","3597","179","3776","2024-12-30"
"58080","2024","COM","2022","161","1","162","2024-12-30"
"58081","2024","COM","2022","269","5","274","2024-12-30"
"58082","2024","COM","2022","281","1","282","2024-12-30"
"58083","2024","COM","2022","1330","86","1416","2024-12-30"
"58084","2024","COM","2022","116","3","119","2024-12-30"
"58085","2024","COM","2022","725","10","735","2024-12-30"
"58086","2024","COM","2022","9786","225","10011","2024-12-30"
"58087","2024","COM","2022","657","14","671","2024-12-30"
"58088","2024","COM","2022","3678","71","3749","2024-12-30"
"58089","2024","COM","2022","220","45","265","2024-12-30"
"58090","2024","COM","2022","228","2","230","2024-12-30"
"58092","2024","COM","2022","399","9","408","2024-12-30"
"58093","2024","COM","2022","122","1","123","2024-12-30"
"58094","2024","COM","2022","456","1","457","2024-12-30"
"58095","2024","COM","2022","5025","171","5196","2024-12-30"
"58096","2024","COM","2022","472","16","488","2024-12-30"
"58097","2024","COM","2022","91","1","92","2024-12-30"
"58098","2024","COM","2022","106","4","110","2024-12-30"
"58099","2024","COM","2022","156","3","159","2024-12-30"
"58101","2024","COM","2022","183","5","188","2024-12-30"
"58102","2024","COM","2022","1542","18","1560","2024-12-30"
"58103","2024","COM","2022","457","7","464","2024-12-30"
"58104","2024","COM","2022","1458","29","1487","2024-12-30"
"58105","2024","COM","2022","303","5","308","2024-12-30"
"58106","2024","COM","2022","362","3","365","2024-12-30"
"58107","2024","COM","2022","148","3","151","2024-12-30"
"58108","2024","COM","2022","77","0","77","2024-12-30"
"58109","2024","COM","2022","738","5","743","2024-12-30"
"58110","2024","COM","2022","227","2","229","2024-12-30"
"58111","2024","COM","2022","105","0","105","2024-12-30"
"58112","2024","COM","2022","622","14","636","2024-12-30"
"58113","2024","COM","2022","92","1","93","2024-12-30"
"58114","2024","COM","2022","90","4","94","2024-12-30"
"58115","2024","COM","2022","228","5","233","2024-12-30"
"58116","2024","COM","2022","133","3","136","2024-12-30"
"58117","2024","COM","2022","4019","51","4070","2024-12-30"
"58118","2024","COM","2022","602","8","610","2024-12-30"
"58119","2024","COM","2022","80","1","81","2024-12-30"
"58120","2024","COM","2022","209","0","209","2024-12-30"
"58121","2024","COM","2022","3666","37","3703","2024-12-30"
"58122","2024","COM","2022","427","9","436","2024-12-30"
"58123","2024","COM","2022","120","9","129","2024-12-30"
"58124","2024","COM","2022","748","14","762","2024-12-30"
"58125","2024","COM","2022","90","2","92","2024-12-30"
"58126","2024","COM","2022","414","13","427","2024-12-30"
"58127","2024","COM","2022","188","3","191","2024-12-30"
"58128","2024","COM","2022","87","1","88","2024-12-30"
"58129","2024","COM","2022","161","4","165","2024-12-30"
"58130","2024","COM","2022","93","1","94","2024-12-30"
"58131","2024","COM","2022","2512","51","2563","2024-12-30"
"58132","2024","COM","2022","226","10","236","2024-12-30"
"58133","2024","COM","2022","73","0","73","2024-12-30"
"58134","2024","COM","2022","3175","33","3208","2024-12-30"
"58135","2024","COM","2022","102","0","102","2024-12-30"
"58136","2024","COM","2022","67","0","67","2024-12-30"
"58137","2024","COM","2022","68","1","69","2024-12-30"
"58138","2024","COM","2022","343","13","356","2024-12-30"
"58139","2024","COM","2022","122","1","123","2024-12-30"
"58140","2024","COM","2022","228","3","231","2024-12-30"
"58141","2024","COM","2022","69","1","70","2024-12-30"
"58142","2024","COM","2022","241","1","242","2024-12-30"
"58143","2024","COM","2022","145","1","146","2024-12-30"
"58144","2024","COM","2022","646","14","660","2024-12-30"
"58145","2024","COM","2022","1259","27","1286","2024-12-30"
"58146","2024","COM","2022","951","22","973","2024-12-30"
"58147","2024","COM","2022","274","4","278","2024-12-30"
"58148","2024","COM","2022","607","5","612","2024-12-30"
"58149","2024","COM","2022","1983","39","2022","2024-12-30"
"58150","2024","COM","2022","105","0","105","2024-12-30"
"58151","2024","COM","2022","3213","50","3263","2024-12-30"
"58152","2024","COM","2022","1417","22","1439","2024-12-30"
"58153","2024","COM","2022","68","1","69","2024-12-30"
"58154","2024","COM","2022","113","0","113","2024-12-30"
"58155","2024","COM","2022","525","12","537","2024-12-30"
"58156","2024","COM","2022","139","2","141","2024-12-30"
"58157","2024","COM","2022","276","14","290","2024-12-30"
"58158","2024","COM","2022","300","7","307","2024-12-30"
"58159","2024","COM","2022","191","4","195","2024-12-30"
"58160","2024","COM","2022","3650","144","3794","2024-12-30"
"58161","2024","COM","2022","146","1","147","2024-12-30"
"58162","2024","COM","2022","96","2","98","2024-12-30"
"58163","2024","COM","2022","182","3","185","2024-12-30"
"58164","2024","COM","2022","656","30","686","2024-12-30"
"58165","2024","COM","2022","178","6","184","2024-12-30"
"58166","2024","COM","2022","229","4","233","2024-12-30"
"58168","2024","COM","2022","439","5","444","2024-12-30"
"58169","2024","COM","2022","13","0","13","2024-12-30"
"58170","2024","COM","2022","126","2","128","2024-12-30"
"58171","2024","COM","2022","275","4","279","2024-12-30"
"58172","2024","COM","2022","116","3","119","2024-12-30"
"58173","2024","COM","2022","159","1","160","2024-12-30"
"58174","2024","COM","2022","124","2","126","2024-12-30"
"58175","2024","COM","2022","152","1","153","2024-12-30"
"58176","2024","COM","2022","632","17","649","2024-12-30"
"58177","2024","COM","2022","297","3","300","2024-12-30"
"58178","2024","COM","2022","154","0","154","2024-12-30"
"58179","2024","COM","2022","248","7","255","2024-12-30"
"58180","2024","COM","2022","497","10","507","2024-12-30"
"58181","2024","COM","2022","130","2","132","2024-12-30"
"58182","2024","COM","2022","1354","12","1366","2024-12-30"
"58183","2024","COM","2022","88","1","89","2024-12-30"
"58184","2024","COM","2022","108","2","110","2024-12-30"
"58185","2024","COM","2022","534","5","539","2024-12-30"
"58186","2024","COM","2022","57","1","58","2024-12-30"
"58187","2024","COM","2022","536","9","545","2024-12-30"
"58188","2024","COM","2022","111","2","113","2024-12-30"
"58189","2024","COM","2022","467","2","469","2024-12-30"
"58190","2024","COM","2022","93","1","94","2024-12-30"
"58191","2024","COM","2022","109","3","112","2024-12-30"
"58192","2024","COM","2022","211","3","214","2024-12-30"
"58193","2024","COM","2022","1428","28","1456","2024-12-30"
"58194","2024","COM","2022","33172","947","34119","2024-12-30"
"58195","2024","COM","2022","270","1","271","2024-12-30"
"58196","2024","COM","2022","346","6","352","2024-12-30"
"58197","2024","COM","2022","169","3","172","2024-12-30"
"58198","2024","COM","2022","304","5","309","2024-12-30"
"58199","2024","COM","2022","162","5","167","2024-12-30"
"58200","2024","COM","2022","148","2","150","2024-12-30"
"58201","2024","COM","2022","138","3","141","2024-12-30"
"58202","2024","COM","2022","27","0","27","2024-12-30"
"58203","2024","COM","2022","64","0","64","2024-12-30"
"58204","2024","COM","2022","528","8","536","2024-12-30"
"58205","2024","COM","2022","596","12","608","2024-12-30"
"58206","2024","COM","2022","33","0","33","2024-12-30"
"58207","2024","COM","2022","965","29","994","2024-12-30"
"58208","2024","COM","2022","293","13","306","2024-12-30"
"58209","2024","COM","2022","148","4","152","2024-12-30"
"58210","2024","COM","2022","308","4","312","2024-12-30"
"58211","2024","COM","2022","151","3","154","2024-12-30"
"58212","2024","COM","2022","329","5","334","2024-12-30"
"58213","2024","COM","2022","473","8","481","2024-12-30"
"58214","2024","COM","2022","2388","46","2434","2024-12-30"
"58215","2024","COM","2022","1623","23","1646","2024-12-30"
"58216","2024","COM","2022","142","3","145","2024-12-30"
"58217","2024","COM","2022","190","3","193","2024-12-30"
"58218","2024","COM","2022","1782","21","1803","2024-12-30"
"58219","2024","COM","2022","209","0","209","2024-12-30"
"58220","2024","COM","2022","611","18","629","2024-12-30"
"58221","2024","COM","2022","155","3","158","2024-12-30"
"58222","2024","COM","2022","153","0","153","2024-12-30"
"58223","2024","COM","2022","646","8","654","2024-12-30"
"58224","2024","COM","2022","85","1","86","2024-12-30"
"58225","2024","COM","2022","364","2","366","2024-12-30"
"58226","2024","COM","2022","139","1","140","2024-12-30"
"58227","2024","COM","2022","1211","21","1232","2024-12-30"
"58228","2024","COM","2022","609","3","612","2024-12-30"
"58229","2024","COM","2022","310","4","314","2024-12-30"
"58230","2024","COM","2022","68","0","68","2024-12-30"
"58231","2024","COM","2022","379","6","385","2024-12-30"
"58232","2024","COM","2022","1257","19","1276","2024-12-30"
"58233","2024","COM","2022","193","1","194","2024-12-30"
"58234","2024","COM","2022","149","1","150","2024-12-30"
"58235","2024","COM","2022","252","0","252","2024-12-30"
"58236","2024","COM","2022","139","1","140","2024-12-30"
"58237","2024","COM","2022","30","1","31","2024-12-30"
"58238","2024","COM","2022","2220","47","2267","2024-12-30"
"58239","2024","COM","2022","152","3","155","2024-12-30"
"58240","2024","COM","2022","80","2","82","2024-12-30"
"58241","2024","COM","2022","309","5","314","2024-12-30"
"58242","2024","COM","2022","117","0","117","2024-12-30"
"58243","2024","COM","2022","115","4","119","2024-12-30"
"58244","2024","COM","2022","219","7","226","2024-12-30"
"58245","2024","COM","2022","171","5","176","2024-12-30"
"58246","2024","COM","2022","687","12","699","2024-12-30"
"58247","2024","COM","2022","526","11","537","2024-12-30"
"58248","2024","COM","2022","216","5","221","2024-12-30"
"58249","2024","COM","2022","348","2","350","2024-12-30"
"58250","2024","COM","2022","1669","38","1707","2024-12-30"
"58251","2024","COM","2022","463","11","474","2024-12-30"
"58252","2024","COM","2022","142","4","146","2024-12-30"
"58253","2024","COM","2022","86","4","90","2024-12-30"
"58254","2024","COM","2022","556","10","566","2024-12-30"
"58255","2024","COM","2022","288","5","293","2024-12-30"
"58256","2024","COM","2022","377","12","389","2024-12-30"
"58257","2024","COM","2022","54","2","56","2024-12-30"
"58258","2024","COM","2022","482","9","491","2024-12-30"
"58259","2024","COM","2022","139","0","139","2024-12-30"
"58260","2024","COM","2022","1216","27","1243","2024-12-30"
"58261","2024","COM","2022","1047","21","1068","2024-12-30"
"58262","2024","COM","2022","202","6","208","2024-12-30"
"58263","2024","COM","2022","163","3","166","2024-12-30"
"58264","2024","COM","2022","1828","25","1853","2024-12-30"
"58265","2024","COM","2022","98","1","99","2024-12-30"
"58266","2024","COM","2022","191","0","191","2024-12-30"
"58267","2024","COM","2022","679","35","714","2024-12-30"
"58268","2024","COM","2022","186","5","191","2024-12-30"
"58269","2024","COM","2022","418","10","428","2024-12-30"
"58270","2024","COM","2022","369","7","376","2024-12-30"
"58271","2024","COM","2022","187","1","188","2024-12-30"
"58272","2024","COM","2022","113","3","116","2024-12-30"
"58273","2024","COM","2022","1413","32","1445","2024-12-30"
"58274","2024","COM","2022","108","4","112","2024-12-30"
"58275","2024","COM","2022","270","4","274","2024-12-30"
"58276","2024","COM","2022","223","3","226","2024-12-30"
"58277","2024","COM","2022","191","4","195","2024-12-30"
"58278","2024","COM","2022","1490","53","1543","2024-12-30"
"58279","2024","COM","2022","175","6","181","2024-12-30"
"58280","2024","COM","2022","590","16","606","2024-12-30"
"58281","2024","COM","2022","575","12","587","2024-12-30"
"58282","2024","COM","2022","336","10","346","2024-12-30"
"58283","2024","COM","2022","72","2","74","2024-12-30"
"58284","2024","COM","2022","40","1","41","2024-12-30"
"58285","2024","COM","2022","166","3","169","2024-12-30"
"58286","2024","COM","2022","546","12","558","2024-12-30"
"58287","2024","COM","2022","184","1","185","2024-12-30"
"58288","2024","COM","2022","115","1","116","2024-12-30"
"58289","2024","COM","2022","167","2","169","2024-12-30"
"58290","2024","COM","2022","43","1","44","2024-12-30"
"58291","2024","COM","2022","173","0","173","2024-12-30"
"58292","2024","COM","2022","161","0","161","2024-12-30"
"58293","2024","COM","2022","406","3","409","2024-12-30"
"58294","2024","COM","2022","124","1","125","2024-12-30"
"58295","2024","COM","2022","993","19","1012","2024-12-30"
"58296","2024","COM","2022","132","1","133","2024-12-30"
"58297","2024","COM","2022","243","2","245","2024-12-30"
"58298","2024","COM","2022","398","9","407","2024-12-30"
"58299","2024","COM","2022","218","3","221","2024-12-30"
"58300","2024","COM","2022","1735","28","1763","2024-12-30"
"58301","2024","COM","2022","293","4","297","2024-12-30"
"58302","2024","COM","2022","909","12","921","2024-12-30"
"58303","2024","COM","2022","9166","159","9325","2024-12-30"
"58304","2024","COM","2022","1066","195","1261","2024-12-30"
"58305","2024","COM","2022","135","6","141","2024-12-30"
"58306","2024","COM","2022","276","4","280","2024-12-30"
"58307","2024","COM","2022","175","4","179","2024-12-30"
"58308","2024","COM","2022","61","0","61","2024-12-30"
"58309","2024","COM","2022","411","9","420","2024-12-30"
"58310","2024","COM","2022","49","1","50","2024-12-30"
"58311","2024","COM","2022","237","2","239","2024-12-30"
"58312","2024","COM","2022","272","9","281","2024-12-30"
"58313","2024","COM","2022","101","2","103","2024-12-30"
"59001","2024","COM","2022","450","15","465","2024-12-30"
"59002","2024","COM","2022","4160","31","4191","2024-12-30"
"59003","2024","COM","2022","357","8","365","2024-12-30"
"59004","2024","COM","2022","1348","10","1358","2024-12-30"
"59005","2024","COM","2022","3549","58","3607","2024-12-30"
"59006","2024","COM","2022","232","4","236","2024-12-30"
"59007","2024","COM","2022","895","9","904","2024-12-30"
"59008","2024","COM","2022","10001","53","10054","2024-12-30"
"59009","2024","COM","2022","62342","594","62936","2024-12-30"
"59010","2024","COM","2022","256","1","257","2024-12-30"
"59011","2024","COM","2022","10887","95","10982","2024-12-30"
"59012","2024","COM","2022","3152","36","3188","2024-12-30"
"59013","2024","COM","2022","1643","25","1668","2024-12-30"
"59014","2024","COM","2022","13417","94","13511","2024-12-30"
"59015","2024","COM","2022","3148","26","3174","2024-12-30"
"59016","2024","COM","2022","2097","44","2141","2024-12-30"
"59017","2024","COM","2022","26107","371","26478","2024-12-30"
"59018","2024","COM","2022","1557","16","1573","2024-12-30"
"59019","2024","COM","2022","1073","11","1084","2024-12-30"
"59021","2024","COM","2022","1782","15","1797","2024-12-30"
"59022","2024","COM","2022","2241","29","2270","2024-12-30"
"59023","2024","COM","2022","535","7","542","2024-12-30"
"59024","2024","COM","2022","4626","38","4664","2024-12-30"
"59025","2024","COM","2022","1746","30","1776","2024-12-30"
"59026","2024","COM","2022","1167","17","1184","2024-12-30"
"59027","2024","COM","2022","1715","25","1740","2024-12-30"
"59028","2024","COM","2022","7171","32","7203","2024-12-30"
"59029","2024","COM","2022","1542","22","1564","2024-12-30"
"59031","2024","COM","2022","364","6","370","2024-12-30"
"59032","2024","COM","2022","7125","68","7193","2024-12-30"
"59033","2024","COM","2022","8674","250","8924","2024-12-30"
"59034","2024","COM","2022","2575","42","2617","2024-12-30"
"59035","2024","COM","2022","2254","44","2298","2024-12-30"
"59036","2024","COM","2022","4088","134","4222","2024-12-30"
"59037","2024","COM","2022","3584","40","3624","2024-12-30"
"59038","2024","COM","2022","1453","17","1470","2024-12-30"
"59039","2024","COM","2022","773","24","797","2024-12-30"
"59041","2024","COM","2022","2246","18","2264","2024-12-30"
"59042","2024","COM","2022","1890","31","1921","2024-12-30"
"59043","2024","COM","2022","14734","226","14960","2024-12-30"
"59044","2024","COM","2022","5361","49","5410","2024-12-30"
"59045","2024","COM","2022","161","5","166","2024-12-30"
"59046","2024","COM","2022","842","2","844","2024-12-30"
"59047","2024","COM","2022","343","9","352","2024-12-30"
"59048","2024","COM","2022","499","8","507","2024-12-30"
"59049","2024","COM","2022","443","7","450","2024-12-30"
"59050","2024","COM","2022","344","3","347","2024-12-30"
"59051","2024","COM","2022","6678","38","6716","2024-12-30"
"59052","2024","COM","2022","5124","49","5173","2024-12-30"
"59053","2024","COM","2022","3240","58","3298","2024-12-30"
"59054","2024","COM","2022","1046","13","1059","2024-12-30"
"59055","2024","COM","2022","549","9","558","2024-12-30"
"59056","2024","COM","2022","845","24","869","2024-12-30"
"59057","2024","COM","2022","572","4","576","2024-12-30"
"59058","2024","COM","2022","1008","14","1022","2024-12-30"
"59059","2024","COM","2022","457","7","464","2024-12-30"
"59060","2024","COM","2022","233","6","239","2024-12-30"
"59061","2024","COM","2022","277","2","279","2024-12-30"
"59062","2024","COM","2022","167","7","174","2024-12-30"
"59063","2024","COM","2022","1948","17","1965","2024-12-30"
"59064","2024","COM","2022","1315","12","1327","2024-12-30"
"59065","2024","COM","2022","810","18","828","2024-12-30"
"59066","2024","COM","2022","162","5","167","2024-12-30"
"59067","2024","COM","2022","3543","40","3583","2024-12-30"
"59068","2024","COM","2022","3169","38","3207","2024-12-30"
"59069","2024","COM","2022","778","13","791","2024-12-30"
"59070","2024","COM","2022","377","5","382","2024-12-30"
"59071","2024","COM","2022","2289","49","2338","2024-12-30"
"59072","2024","COM","2022","243","2","245","2024-12-30"
"59073","2024","COM","2022","618","10","628","2024-12-30"
"59074","2024","COM","2022","2138","27","2165","2024-12-30"
"59075","2024","COM","2022","697","5","702","2024-12-30"
"59076","2024","COM","2022","355","6","361","2024-12-30"
"59077","2024","COM","2022","254","6","260","2024-12-30"
"59078","2024","COM","2022","608","6","614","2024-12-30"
"59079","2024","COM","2022","6791","36","6827","2024-12-30"
"59080","2024","COM","2022","2852","42","2894","2024-12-30"
"59081","2024","COM","2022","537","13","550","2024-12-30"
"59082","2024","COM","2022","1744","26","1770","2024-12-30"
"59083","2024","COM","2022","242","11","253","2024-12-30"
"59084","2024","COM","2022","2046","30","2076","2024-12-30"
"59085","2024","COM","2022","309","6","315","2024-12-30"
"59086","2024","COM","2022","2212","30","2242","2024-12-30"
"59087","2024","COM","2022","738","12","750","2024-12-30"
"59088","2024","COM","2022","1784","24","1808","2024-12-30"
"59089","2024","COM","2022","1425","30","1455","2024-12-30"
"59090","2024","COM","2022","9666","183","9849","2024-12-30"
"59091","2024","COM","2022","564","16","580","2024-12-30"
"59092","2024","COM","2022","4054","28","4082","2024-12-30"
"59093","2024","COM","2022","294","6","300","2024-12-30"
"59094","2024","COM","2022","6958","46","7004","2024-12-30"
"59096","2024","COM","2022","1678","31","1709","2024-12-30"
"59097","2024","COM","2022","376","2","378","2024-12-30"
"59098","2024","COM","2022","4956","58","5014","2024-12-30"
"59099","2024","COM","2022","1770","27","1797","2024-12-30"
"59100","2024","COM","2022","344","12","356","2024-12-30"
"59101","2024","COM","2022","374","11","385","2024-12-30"
"59102","2024","COM","2022","450","4","454","2024-12-30"
"59103","2024","COM","2022","517","9","526","2024-12-30"
"59104","2024","COM","2022","3139","29","3168","2024-12-30"
"59105","2024","COM","2022","1564","33","1597","2024-12-30"
"59106","2024","COM","2022","766","14","780","2024-12-30"
"59107","2024","COM","2022","4284","65","4349","2024-12-30"
"59108","2024","COM","2022","695","6","701","2024-12-30"
"59109","2024","COM","2022","764","8","772","2024-12-30"
"59110","2024","COM","2022","1454","25","1479","2024-12-30"
"59111","2024","COM","2022","411","4","415","2024-12-30"
"59112","2024","COM","2022","11584","48","11632","2024-12-30"
"59113","2024","COM","2022","1345","16","1361","2024-12-30"
"59114","2024","COM","2022","1693","16","1709","2024-12-30"
"59115","2024","COM","2022","711","8","719","2024-12-30"
"59116","2024","COM","2022","400","9","409","2024-12-30"
"59117","2024","COM","2022","1084","11","1095","2024-12-30"
"59118","2024","COM","2022","2437","27","2464","2024-12-30"
"59119","2024","COM","2022","580","6","586","2024-12-30"
"59120","2024","COM","2022","1979","38","2017","2024-12-30"
"59121","2024","COM","2022","662","8","670","2024-12-30"
"59122","2024","COM","2022","31568","566","32134","2024-12-30"
"59123","2024","COM","2022","1725","17","1742","2024-12-30"
"59124","2024","COM","2022","2506","72","2578","2024-12-30"
"59125","2024","COM","2022","408","7","415","2024-12-30"
"59126","2024","COM","2022","1755","22","1777","2024-12-30"
"59127","2024","COM","2022","136","5","141","2024-12-30"
"59128","2024","COM","2022","2601","27","2628","2024-12-30"
"59129","2024","COM","2022","2259","45","2304","2024-12-30"
"59130","2024","COM","2022","1157","18","1175","2024-12-30"
"59131","2024","COM","2022","7865","77","7942","2024-12-30"
"59132","2024","COM","2022","987","12","999","2024-12-30"
"59133","2024","COM","2022","1097","14","1111","2024-12-30"
"59134","2024","COM","2022","1234","26","1260","2024-12-30"
"59135","2024","COM","2022","2212","86","2298","2024-12-30"
"59136","2024","COM","2022","6846","137","6983","2024-12-30"
"59137","2024","COM","2022","783","8","791","2024-12-30"
"59138","2024","COM","2022","687","9","696","2024-12-30"
"59139","2024","COM","2022","14032","141","14173","2024-12-30"
"59140","2024","COM","2022","464","9","473","2024-12-30"
"59141","2024","COM","2022","575","11","586","2024-12-30"
"59142","2024","COM","2022","667","10","677","2024-12-30"
"59143","2024","COM","2022","8782","71","8853","2024-12-30"
"59144","2024","COM","2022","886","15","901","2024-12-30"
"59145","2024","COM","2022","773","9","782","2024-12-30"
"59146","2024","COM","2022","3040","53","3093","2024-12-30"
"59147","2024","COM","2022","44","2","46","2024-12-30"
"59148","2024","COM","2022","361","1","362","2024-12-30"
"59149","2024","COM","2022","1087","12","1099","2024-12-30"
"59150","2024","COM","2022","553","7","560","2024-12-30"
"59151","2024","COM","2022","1551","23","1574","2024-12-30"
"59152","2024","COM","2022","12649","68","12717","2024-12-30"
"59153","2024","COM","2022","9297","52","9349","2024-12-30"
"59155","2024","COM","2022","20833","222","21055","2024-12-30"
"59156","2024","COM","2022","2868","32","2900","2024-12-30"
"59157","2024","COM","2022","2160","19","2179","2024-12-30"
"59158","2024","COM","2022","3341","38","3379","2024-12-30"
"59159","2024","COM","2022","770","7","777","2024-12-30"
"59160","2024","COM","2022","4541","34","4575","2024-12-30"
"59161","2024","COM","2022","717","30","747","2024-12-30"
"59162","2024","COM","2022","658","12","670","2024-12-30"
"59163","2024","COM","2022","20956","225","21181","2024-12-30"
"59164","2024","COM","2022","237","8","245","2024-12-30"
"59165","2024","COM","2022","6499","71","6570","2024-12-30"
"59166","2024","COM","2022","1351","35","1386","2024-12-30"
"59167","2024","COM","2022","187","3","190","2024-12-30"
"59168","2024","COM","2022","4717","62","4779","2024-12-30"
"59169","2024","COM","2022","205","5","210","2024-12-30"
"59170","2024","COM","2022","5343","29","5372","2024-12-30"
"59171","2024","COM","2022","42","1","43","2024-12-30"
"59172","2024","COM","2022","20622","128","20750","2024-12-30"
"59173","2024","COM","2022","1801","25","1826","2024-12-30"
"59174","2024","COM","2022","327","14","341","2024-12-30"
"59175","2024","COM","2022","296","11","307","2024-12-30"
"59176","2024","COM","2022","323","6","329","2024-12-30"
"59177","2024","COM","2022","837","8","845","2024-12-30"
"59178","2024","COM","2022","39833","871","40704","2024-12-30"
"59179","2024","COM","2022","10112","45","10157","2024-12-30"
"59180","2024","COM","2022","1445","23","1468","2024-12-30"
"59181","2024","COM","2022","537","7","544","2024-12-30"
"59182","2024","COM","2022","282","4","286","2024-12-30"
"59183","2024","COM","2022","87013","1239","88252","2024-12-30"
"59184","2024","COM","2022","658","10","668","2024-12-30"
"59185","2024","COM","2022","1883","14","1897","2024-12-30"
"59186","2024","COM","2022","92","2","94","2024-12-30"
"59187","2024","COM","2022","265","6","271","2024-12-30"
"59188","2024","COM","2022","143","2","145","2024-12-30"
"59189","2024","COM","2022","1215","27","1242","2024-12-30"
"59190","2024","COM","2022","1002","17","1019","2024-12-30"
"59191","2024","COM","2022","618","3","621","2024-12-30"
"59192","2024","COM","2022","813","46","859","2024-12-30"
"59193","2024","COM","2022","3026","23","3049","2024-12-30"
"59194","2024","COM","2022","1290","21","1311","2024-12-30"
"59195","2024","COM","2022","616","9","625","2024-12-30"
"59196","2024","COM","2022","1288","22","1310","2024-12-30"
"59197","2024","COM","2022","2417","30","2447","2024-12-30"
"59198","2024","COM","2022","229","0","229","2024-12-30"
"59199","2024","COM","2022","674","11","685","2024-12-30"
"59200","2024","COM","2022","469","12","481","2024-12-30"
"59201","2024","COM","2022","624","12","636","2024-12-30"
"59202","2024","COM","2022","5349","46","5395","2024-12-30"
"59203","2024","COM","2022","1576","8","1584","2024-12-30"
"59204","2024","COM","2022","478","8","486","2024-12-30"
"59205","2024","COM","2022","9060","45","9105","2024-12-30"
"59206","2024","COM","2022","3180","29","3209","2024-12-30"
"59207","2024","COM","2022","4174","24","4198","2024-12-30"
"59208","2024","COM","2022","303","9","312","2024-12-30"
"59209","2024","COM","2022","673","7","680","2024-12-30"
"59210","2024","COM","2022","2143","55","2198","2024-12-30"
"59211","2024","COM","2022","902","20","922","2024-12-30"
"59212","2024","COM","2022","6551","125","6676","2024-12-30"
"59213","2024","COM","2022","470","17","487","2024-12-30"
"59214","2024","COM","2022","1121","23","1144","2024-12-30"
"59215","2024","COM","2022","945","33","978","2024-12-30"
"59216","2024","COM","2022","360","6","366","2024-12-30"
"59217","2024","COM","2022","334","4","338","2024-12-30"
"59218","2024","COM","2022","1255","15","1270","2024-12-30"
"59219","2024","COM","2022","721","8","729","2024-12-30"
"59220","2024","COM","2022","18310","117","18427","2024-12-30"
"59221","2024","COM","2022","2459","68","2527","2024-12-30"
"59222","2024","COM","2022","2255","46","2301","2024-12-30"
"59223","2024","COM","2022","504","8","512","2024-12-30"
"59224","2024","COM","2022","1654","13","1667","2024-12-30"
"59225","2024","COM","2022","6727","64","6791","2024-12-30"
"59226","2024","COM","2022","1459","14","1473","2024-12-30"
"59227","2024","COM","2022","5533","46","5579","2024-12-30"
"59228","2024","COM","2022","1441","21","1462","2024-12-30"
"59229","2024","COM","2022","509","18","527","2024-12-30"
"59230","2024","COM","2022","5167","52","5219","2024-12-30"
"59231","2024","COM","2022","1043","5","1048","2024-12-30"
"59232","2024","COM","2022","433","8","441","2024-12-30"
"59233","2024","COM","2022","345","3","348","2024-12-30"
"59234","2024","COM","2022","5533","33","5566","2024-12-30"
"59236","2024","COM","2022","269","3","272","2024-12-30"
"59237","2024","COM","2022","946","15","961","2024-12-30"
"59238","2024","COM","2022","1667","18","1685","2024-12-30"
"59239","2024","COM","2022","5677","94","5771","2024-12-30"
"59240","2024","COM","2022","127","3","130","2024-12-30"
"59241","2024","COM","2022","508","15","523","2024-12-30"
"59242","2024","COM","2022","691","10","701","2024-12-30"
"59243","2024","COM","2022","1209","12","1221","2024-12-30"
"59244","2024","COM","2022","1759","30","1789","2024-12-30"
"59246","2024","COM","2022","558","7","565","2024-12-30"
"59247","2024","COM","2022","1660","26","1686","2024-12-30"
"59249","2024","COM","2022","11528","187","11715","2024-12-30"
"59250","2024","COM","2022","2167","106","2273","2024-12-30"
"59251","2024","COM","2022","384","4","388","2024-12-30"
"59252","2024","COM","2022","2617","23","2640","2024-12-30"
"59253","2024","COM","2022","7473","40","7513","2024-12-30"
"59254","2024","COM","2022","906","11","917","2024-12-30"
"59255","2024","COM","2022","573","5","578","2024-12-30"
"59256","2024","COM","2022","3221","33","3254","2024-12-30"
"59257","2024","COM","2022","1133","15","1148","2024-12-30"
"59258","2024","COM","2022","2811","656","3467","2024-12-30"
"59259","2024","COM","2022","501","13","514","2024-12-30"
"59260","2024","COM","2022","4126","61","4187","2024-12-30"
"59261","2024","COM","2022","1732","31","1763","2024-12-30"
"59262","2024","COM","2022","2037","29","2066","2024-12-30"
"59263","2024","COM","2022","1044","27","1071","2024-12-30"
"59264","2024","COM","2022","725","7","732","2024-12-30"
"59265","2024","COM","2022","2272","57","2329","2024-12-30"
"59266","2024","COM","2022","4099","47","4146","2024-12-30"
"59267","2024","COM","2022","283","8","291","2024-12-30"
"59268","2024","COM","2022","5553","55","5608","2024-12-30"
"59269","2024","COM","2022","1434","24","1458","2024-12-30"
"59270","2024","COM","2022","471","7","478","2024-12-30"
"59271","2024","COM","2022","20347","189","20536","2024-12-30"
"59272","2024","COM","2022","4901","49","4950","2024-12-30"
"59273","2024","COM","2022","11451","182","11633","2024-12-30"
"59274","2024","COM","2022","470","4","474","2024-12-30"
"59275","2024","COM","2022","1223","35","1258","2024-12-30"
"59276","2024","COM","2022","4645","27","4672","2024-12-30"
"59277","2024","COM","2022","354","3","357","2024-12-30"
"59278","2024","COM","2022","4739","40","4779","2024-12-30"
"59279","2024","COM","2022","20684","141","20825","2024-12-30"
"59280","2024","COM","2022","786","9","795","2024-12-30"
"59281","2024","COM","2022","1249","14","1263","2024-12-30"
"59282","2024","COM","2022","389","9","398","2024-12-30"
"59283","2024","COM","2022","613","10","623","2024-12-30"
"59284","2024","COM","2022","3853","37","3890","2024-12-30"
"59285","2024","COM","2022","2632","16","2648","2024-12-30"
"59286","2024","COM","2022","14922","103","15025","2024-12-30"
"59287","2024","COM","2022","192","3","195","2024-12-30"
"59288","2024","COM","2022","2307","25","2332","2024-12-30"
"59289","2024","COM","2022","1472","53","1525","2024-12-30"
"59290","2024","COM","2022","374","8","382","2024-12-30"
"59291","2024","COM","2022","14197","67","14264","2024-12-30"
"59292","2024","COM","2022","3224","13","3237","2024-12-30"
"59293","2024","COM","2022","1385","18","1403","2024-12-30"
"59294","2024","COM","2022","305","7","312","2024-12-30"
"59295","2024","COM","2022","21785","415","22200","2024-12-30"
"59296","2024","COM","2022","352","9","361","2024-12-30"
"59297","2024","COM","2022","1905","20","1925","2024-12-30"
"59299","2024","COM","2022","18579","145","18724","2024-12-30"
"59300","2024","COM","2022","552","8","560","2024-12-30"
"59301","2024","COM","2022","4471","34","4505","2024-12-30"
"59302","2024","COM","2022","4176","28","4204","2024-12-30"
"59303","2024","COM","2022","2288","29","2317","2024-12-30"
"59304","2024","COM","2022","426","8","434","2024-12-30"
"59305","2024","COM","2022","1627","34","1661","2024-12-30"
"59306","2024","COM","2022","299","3","302","2024-12-30"
"59307","2024","COM","2022","855","2","857","2024-12-30"
"59308","2024","COM","2022","915","18","933","2024-12-30"
"59309","2024","COM","2022","4010","81","4091","2024-12-30"
"59310","2024","COM","2022","879","12","891","2024-12-30"
"59311","2024","COM","2022","558","4","562","2024-12-30"
"59312","2024","COM","2022","722","16","738","2024-12-30"
"59313","2024","COM","2022","1448","16","1464","2024-12-30"
"59314","2024","COM","2022","3522","32","3554","2024-12-30"
"59315","2024","COM","2022","902","12","914","2024-12-30"
"59316","2024","COM","2022","3301","45","3346","2024-12-30"
"59317","2024","COM","2022","7907","113","8020","2024-12-30"
"59318","2024","COM","2022","982","19","1001","2024-12-30"
"59319","2024","COM","2022","3206","226","3432","2024-12-30"
"59320","2024","COM","2022","1688","16","1704","2024-12-30"
"59321","2024","COM","2022","627","4","631","2024-12-30"
"59322","2024","COM","2022","3335","29","3364","2024-12-30"
"59323","2024","COM","2022","1137","27","1164","2024-12-30"
"59324","2024","COM","2022","10273","92","10365","2024-12-30"
"59325","2024","COM","2022","860","14","874","2024-12-30"
"59326","2024","COM","2022","1172","16","1188","2024-12-30"
"59327","2024","COM","2022","6212","35","6247","2024-12-30"
"59328","2024","COM","2022","27105","453","27558","2024-12-30"
"59329","2024","COM","2022","4902","82","4984","2024-12-30"
"59330","2024","COM","2022","2482","43","2525","2024-12-30"
"59331","2024","COM","2022","3414","78","3492","2024-12-30"
"59332","2024","COM","2022","1791","8","1799","2024-12-30"
"59333","2024","COM","2022","239","7","246","2024-12-30"
"59334","2024","COM","2022","1593","21","1614","2024-12-30"
"59335","2024","COM","2022","3048","62","3110","2024-12-30"
"59336","2024","COM","2022","1355","15","1370","2024-12-30"
"59337","2024","COM","2022","705","19","724","2024-12-30"
"59338","2024","COM","2022","618","19","637","2024-12-30"
"59339","2024","COM","2022","9555","67","9622","2024-12-30"
"59340","2024","COM","2022","4101","95","4196","2024-12-30"
"59341","2024","COM","2022","448","6","454","2024-12-30"
"59342","2024","COM","2022","232","6","238","2024-12-30"
"59343","2024","COM","2022","9356","87","9443","2024-12-30"
"59344","2024","COM","2022","2483","12","2495","2024-12-30"
"59345","2024","COM","2022","2388","23","2411","2024-12-30"
"59346","2024","COM","2022","2966","24","2990","2024-12-30"
"59347","2024","COM","2022","529","11","540","2024-12-30"
"59348","2024","COM","2022","1464","15","1479","2024-12-30"
"59349","2024","COM","2022","1874","20","1894","2024-12-30"
"59350","2024","COM","2022","238695","1828","240523","2024-12-30"
"59351","2024","COM","2022","532","6","538","2024-12-30"
"59352","2024","COM","2022","8177","91","8268","2024-12-30"
"59353","2024","COM","2022","297","5","302","2024-12-30"
"59354","2024","COM","2022","717","12","729","2024-12-30"
"59356","2024","COM","2022","2170","46","2216","2024-12-30"
"59357","2024","COM","2022","2061","28","2089","2024-12-30"
"59358","2024","COM","2022","1217","12","1229","2024-12-30"
"59359","2024","COM","2022","5995","69","6064","2024-12-30"
"59360","2024","COM","2022","22948","274","23222","2024-12-30"
"59361","2024","COM","2022","3756","22","3778","2024-12-30"
"59363","2024","COM","2022","903","17","920","2024-12-30"
"59364","2024","COM","2022","902","12","914","2024-12-30"
"59365","2024","COM","2022","6334","35","6369","2024-12-30"
"59366","2024","COM","2022","782","15","797","2024-12-30"
"59367","2024","COM","2022","13987","132","14119","2024-12-30"
"59368","2024","COM","2022","22161","198","22359","2024-12-30"
"59369","2024","COM","2022","3970","50","4020","2024-12-30"
"59370","2024","COM","2022","698","11","709","2024-12-30"
"59371","2024","COM","2022","628","16","644","2024-12-30"
"59372","2024","COM","2022","487","10","497","2024-12-30"
"59374","2024","COM","2022","468","4","472","2024-12-30"
"59375","2024","COM","2022","4506","59","4565","2024-12-30"
"59377","2024","COM","2022","1865","31","1896","2024-12-30"
"59378","2024","COM","2022","39943","730","40673","2024-12-30"
"59379","2024","COM","2022","751","5","756","2024-12-30"
"59381","2024","COM","2022","806","20","826","2024-12-30"
"59382","2024","COM","2022","1403","13","1416","2024-12-30"
"59383","2024","COM","2022","11980","108","12088","2024-12-30"
"59384","2024","COM","2022","1445","21","1466","2024-12-30"
"59385","2024","COM","2022","2649","21","2670","2024-12-30"
"59386","2024","COM","2022","11709","78","11787","2024-12-30"
"59387","2024","COM","2022","1953","12","1965","2024-12-30"
"59388","2024","COM","2022","1971","23","1994","2024-12-30"
"59389","2024","COM","2022","2731","37","2768","2024-12-30"
"59390","2024","COM","2022","4028","27","4055","2024-12-30"
"59391","2024","COM","2022","900","2","902","2024-12-30"
"59392","2024","COM","2022","28879","270","29149","2024-12-30"
"59393","2024","COM","2022","955","13","968","2024-12-30"
"59394","2024","COM","2022","405","2","407","2024-12-30"
"59395","2024","COM","2022","279","5","284","2024-12-30"
"59396","2024","COM","2022","697","11","708","2024-12-30"
"59397","2024","COM","2022","609","12","621","2024-12-30"
"59398","2024","COM","2022","3476","141","3617","2024-12-30"
"59399","2024","COM","2022","1078","21","1099","2024-12-30"
"59400","2024","COM","2022","9729","98","9827","2024-12-30"
"59401","2024","COM","2022","2230","31","2261","2024-12-30"
"59402","2024","COM","2022","843","20","863","2024-12-30"
"59403","2024","COM","2022","708","7","715","2024-12-30"
"59405","2024","COM","2022","493","3","496","2024-12-30"
"59406","2024","COM","2022","423","5","428","2024-12-30"
"59407","2024","COM","2022","583","10","593","2024-12-30"
"59408","2024","COM","2022","1683","25","1708","2024-12-30"
"59409","2024","COM","2022","2488","18","2506","2024-12-30"
"59410","2024","COM","2022","21368","135","21503","2024-12-30"
"59411","2024","COM","2022","2077","38","2115","2024-12-30"
"59412","2024","COM","2022","275","3","278","2024-12-30"
"59413","2024","COM","2022","552","7","559","2024-12-30"
"59414","2024","COM","2022","4588","60","4648","2024-12-30"
"59415","2024","COM","2022","227","2","229","2024-12-30"
"59416","2024","COM","2022","2538","55","2593","2024-12-30"
"59418","2024","COM","2022","1581","7","1588","2024-12-30"
"59419","2024","COM","2022","1466","22","1488","2024-12-30"
"59420","2024","COM","2022","61","2","63","2024-12-30"
"59421","2024","COM","2022","13239","181","13420","2024-12-30"
"59422","2024","COM","2022","623","12","635","2024-12-30"
"59423","2024","COM","2022","1422","21","1443","2024-12-30"
"59424","2024","COM","2022","1296","10","1306","2024-12-30"
"59425","2024","COM","2022","303","8","311","2024-12-30"
"59426","2024","COM","2022","10125","82","10207","2024-12-30"
"59427","2024","COM","2022","606","13","619","2024-12-30"
"59428","2024","COM","2022","3909","36","3945","2024-12-30"
"59429","2024","COM","2022","2759","14","2773","2024-12-30"
"59430","2024","COM","2022","1091","11","1102","2024-12-30"
"59431","2024","COM","2022","7685","81","7766","2024-12-30"
"59432","2024","COM","2022","511","7","518","2024-12-30"
"59433","2024","COM","2022","906","12","918","2024-12-30"
"59434","2024","COM","2022","1393","18","1411","2024-12-30"
"59435","2024","COM","2022","2618","45","2663","2024-12-30"
"59436","2024","COM","2022","812","13","825","2024-12-30"
"59437","2024","COM","2022","839","15","854","2024-12-30"
"59438","2024","COM","2022","815","18","833","2024-12-30"
"59439","2024","COM","2022","282","6","288","2024-12-30"
"59440","2024","COM","2022","661","11","672","2024-12-30"
"59441","2024","COM","2022","655","14","669","2024-12-30"
"59442","2024","COM","2022","273","6","279","2024-12-30"
"59443","2024","COM","2022","363","1","364","2024-12-30"
"59444","2024","COM","2022","936","9","945","2024-12-30"
"59445","2024","COM","2022","1185","16","1201","2024-12-30"
"59446","2024","COM","2022","695","8","703","2024-12-30"
"59447","2024","COM","2022","8567","68","8635","2024-12-30"
"59448","2024","COM","2022","468","5","473","2024-12-30"
"59449","2024","COM","2022","8390","137","8527","2024-12-30"
"59450","2024","COM","2022","639","5","644","2024-12-30"
"59451","2024","COM","2022","560","10","570","2024-12-30"
"59452","2024","COM","2022","6014","27","6041","2024-12-30"
"59453","2024","COM","2022","690","15","705","2024-12-30"
"59454","2024","COM","2022","533","5","538","2024-12-30"
"59455","2024","COM","2022","1022","13","1035","2024-12-30"
"59456","2024","COM","2022","6160","258","6418","2024-12-30"
"59457","2024","COM","2022","8487","65","8552","2024-12-30"
"59458","2024","COM","2022","1001","22","1023","2024-12-30"
"59459","2024","COM","2022","5058","40","5098","2024-12-30"
"59461","2024","COM","2022","286","6","292","2024-12-30"
"59462","2024","COM","2022","4863","50","4913","2024-12-30"
"59463","2024","COM","2022","992","17","1009","2024-12-30"
"59464","2024","COM","2022","2156","13","2169","2024-12-30"
"59465","2024","COM","2022","779","2","781","2024-12-30"
"59466","2024","COM","2022","3054","91","3145","2024-12-30"
"59467","2024","COM","2022","2387","25","2412","2024-12-30"
"59468","2024","COM","2022","440","5","445","2024-12-30"
"59469","2024","COM","2022","404","9","413","2024-12-30"
"59470","2024","COM","2022","2029","31","2060","2024-12-30"
"59471","2024","COM","2022","2083","21","2104","2024-12-30"
"59472","2024","COM","2022","839","8","847","2024-12-30"
"59473","2024","COM","2022","302","5","307","2024-12-30"
"59474","2024","COM","2022","1046","20","1066","2024-12-30"
"59475","2024","COM","2022","2202","20","2222","2024-12-30"
"59476","2024","COM","2022","3167","54","3221","2024-12-30"
"59477","2024","COM","2022","4456","42","4498","2024-12-30"
"59478","2024","COM","2022","1122","26","1148","2024-12-30"
"59479","2024","COM","2022","3141","29","3170","2024-12-30"
"59480","2024","COM","2022","863","10","873","2024-12-30"
"59481","2024","COM","2022","4859","119","4978","2024-12-30"
"59482","2024","COM","2022","6863","61","6924","2024-12-30"
"59483","2024","COM","2022","138","1","139","2024-12-30"
"59484","2024","COM","2022","6078","41","6119","2024-12-30"
"59485","2024","COM","2022","1800","19","1819","2024-12-30"
"59486","2024","COM","2022","2644","40","2684","2024-12-30"
"59487","2024","COM","2022","1404","20","1424","2024-12-30"
"59488","2024","COM","2022","2104","39","2143","2024-12-30"
"59489","2024","COM","2022","4012","54","4066","2024-12-30"
"59490","2024","COM","2022","194","1","195","2024-12-30"
"59491","2024","COM","2022","12140","61","12201","2024-12-30"
"59492","2024","COM","2022","588","7","595","2024-12-30"
"59493","2024","COM","2022","224","2","226","2024-12-30"
"59494","2024","COM","2022","152","1","153","2024-12-30"
"59495","2024","COM","2022","2379","14","2393","2024-12-30"
"59496","2024","COM","2022","227","2","229","2024-12-30"
"59497","2024","COM","2022","2130","29","2159","2024-12-30"
"59498","2024","COM","2022","341","10","351","2024-12-30"
"59499","2024","COM","2022","1984","31","2015","2024-12-30"
"59500","2024","COM","2022","378","5","383","2024-12-30"
"59501","2024","COM","2022","1226","25","1251","2024-12-30"
"59502","2024","COM","2022","1432","19","1451","2024-12-30"
"59503","2024","COM","2022","208","2","210","2024-12-30"
"59504","2024","COM","2022","3767","19","3786","2024-12-30"
"59505","2024","COM","2022","745","7","752","2024-12-30"
"59506","2024","COM","2022","480","7","487","2024-12-30"
"59507","2024","COM","2022","19436","150","19586","2024-12-30"
"59508","2024","COM","2022","13873","111","13984","2024-12-30"
"59509","2024","COM","2022","5966","50","6016","2024-12-30"
"59511","2024","COM","2022","1997","35","2032","2024-12-30"
"59512","2024","COM","2022","99507","419","99926","2024-12-30"
"59513","2024","COM","2022","456","4","460","2024-12-30"
"59514","2024","COM","2022","4016","55","4071","2024-12-30"
"59515","2024","COM","2022","658","5","663","2024-12-30"
"59516","2024","COM","2022","915","22","937","2024-12-30"
"59517","2024","COM","2022","740","13","753","2024-12-30"
"59518","2024","COM","2022","452","6","458","2024-12-30"
"59519","2024","COM","2022","1738","34","1772","2024-12-30"
"59520","2024","COM","2022","1422","23","1445","2024-12-30"
"59521","2024","COM","2022","416","8","424","2024-12-30"
"59522","2024","COM","2022","1936","29","1965","2024-12-30"
"59523","2024","COM","2022","2844","38","2882","2024-12-30"
"59524","2024","COM","2022","5663","50","5713","2024-12-30"
"59525","2024","COM","2022","2766","26","2792","2024-12-30"
"59526","2024","COM","2022","16042","203","16245","2024-12-30"
"59527","2024","COM","2022","12909","133","13042","2024-12-30"
"59528","2024","COM","2022","1563","16","1579","2024-12-30"
"59529","2024","COM","2022","338","5","343","2024-12-30"
"59530","2024","COM","2022","331","1","332","2024-12-30"
"59531","2024","COM","2022","341","4","345","2024-12-30"
"59532","2024","COM","2022","289","3","292","2024-12-30"
"59533","2024","COM","2022","1557","21","1578","2024-12-30"
"59534","2024","COM","2022","767","21","788","2024-12-30"
"59535","2024","COM","2022","1609","46","1655","2024-12-30"
"59536","2024","COM","2022","835","25","860","2024-12-30"
"59537","2024","COM","2022","492","11","503","2024-12-30"
"59538","2024","COM","2022","420","11","431","2024-12-30"
"59539","2024","COM","2022","983","16","999","2024-12-30"
"59541","2024","COM","2022","985","7","992","2024-12-30"
"59542","2024","COM","2022","473","7","480","2024-12-30"
"59543","2024","COM","2022","1057","11","1068","2024-12-30"
"59544","2024","COM","2022","11121","141","11262","2024-12-30"
"59545","2024","COM","2022","1197","25","1222","2024-12-30"
"59546","2024","COM","2022","1151","33","1184","2024-12-30"
"59547","2024","COM","2022","855","7","862","2024-12-30"
"59548","2024","COM","2022","672","9","681","2024-12-30"
"59549","2024","COM","2022","328","3","331","2024-12-30"
"59550","2024","COM","2022","3116","31","3147","2024-12-30"
"59551","2024","COM","2022","1722","41","1763","2024-12-30"
"59552","2024","COM","2022","197","6","203","2024-12-30"
"59553","2024","COM","2022","5656","60","5716","2024-12-30"
"59554","2024","COM","2022","613","15","628","2024-12-30"
"59555","2024","COM","2022","1411","14","1425","2024-12-30"
"59556","2024","COM","2022","258","3","261","2024-12-30"
"59557","2024","COM","2022","2526","31","2557","2024-12-30"
"59558","2024","COM","2022","1685","18","1703","2024-12-30"
"59559","2024","COM","2022","1972","42","2014","2024-12-30"
"59560","2024","COM","2022","13011","97","13108","2024-12-30"
"59562","2024","COM","2022","527","8","535","2024-12-30"
"59563","2024","COM","2022","229","6","235","2024-12-30"
"59564","2024","COM","2022","3140","15","3155","2024-12-30"
"59565","2024","COM","2022","645","9","654","2024-12-30"
"59566","2024","COM","2022","4722","37","4759","2024-12-30"
"59567","2024","COM","2022","417","5","422","2024-12-30"
"59568","2024","COM","2022","489","8","497","2024-12-30"
"59569","2024","COM","2022","15916","84","16000","2024-12-30"
"59570","2024","COM","2022","873","18","891","2024-12-30"
"59571","2024","COM","2022","4193","115","4308","2024-12-30"
"59572","2024","COM","2022","1790","20","1810","2024-12-30"
"59573","2024","COM","2022","143","3","146","2024-12-30"
"59574","2024","COM","2022","11902","79","11981","2024-12-30"
"59575","2024","COM","2022","398","7","405","2024-12-30"
"59576","2024","COM","2022","1725","38","1763","2024-12-30"
"59577","2024","COM","2022","715","5","720","2024-12-30"
"59578","2024","COM","2022","1626","43","1669","2024-12-30"
"59579","2024","COM","2022","1385","15","1400","2024-12-30"
"59580","2024","COM","2022","4308","68","4376","2024-12-30"
"59581","2024","COM","2022","3474","55","3529","2024-12-30"
"59582","2024","COM","2022","944","10","954","2024-12-30"
"59583","2024","COM","2022","476","4","480","2024-12-30"
"59584","2024","COM","2022","960","14","974","2024-12-30"
"59585","2024","COM","2022","3630","38","3668","2024-12-30"
"59586","2024","COM","2022","6979","104","7083","2024-12-30"
"59587","2024","COM","2022","518","12","530","2024-12-30"
"59588","2024","COM","2022","8272","221","8493","2024-12-30"
"59589","2024","COM","2022","2963","20","2983","2024-12-30"
"59590","2024","COM","2022","918","15","933","2024-12-30"
"59591","2024","COM","2022","820","6","826","2024-12-30"
"59592","2024","COM","2022","4102","48","4150","2024-12-30"
"59593","2024","COM","2022","777","10","787","2024-12-30"
"59594","2024","COM","2022","1102","12","1114","2024-12-30"
"59595","2024","COM","2022","542","13","555","2024-12-30"
"59596","2024","COM","2022","538","20","558","2024-12-30"
"59597","2024","COM","2022","695","8","703","2024-12-30"
"59598","2024","COM","2022","3964","35","3999","2024-12-30"
"59599","2024","COM","2022","99160","598","99758","2024-12-30"
"59600","2024","COM","2022","950","15","965","2024-12-30"
"59601","2024","COM","2022","2642","59","2701","2024-12-30"
"59602","2024","COM","2022","1390","42","1432","2024-12-30"
"59603","2024","COM","2022","6062","88","6150","2024-12-30"
"59604","2024","COM","2022","808","10","818","2024-12-30"
"59605","2024","COM","2022","1524","30","1554","2024-12-30"
"59606","2024","COM","2022","42979","489","43468","2024-12-30"
"59607","2024","COM","2022","479","5","484","2024-12-30"
"59608","2024","COM","2022","1123","22","1145","2024-12-30"
"59609","2024","COM","2022","1615","20","1635","2024-12-30"
"59610","2024","COM","2022","1103","11","1114","2024-12-30"
"59611","2024","COM","2022","2678","39","2717","2024-12-30"
"59612","2024","COM","2022","524","12","536","2024-12-30"
"59613","2024","COM","2022","1472","16","1488","2024-12-30"
"59614","2024","COM","2022","1364","17","1381","2024-12-30"
"59615","2024","COM","2022","2641","44","2685","2024-12-30"
"59616","2024","COM","2022","10455","58","10513","2024-12-30"
"59617","2024","COM","2022","637","7","644","2024-12-30"
"59618","2024","COM","2022","923","7","930","2024-12-30"
"59619","2024","COM","2022","1062","15","1077","2024-12-30"
"59620","2024","COM","2022","670","7","677","2024-12-30"
"59622","2024","COM","2022","1148","15","1163","2024-12-30"
"59623","2024","COM","2022","682","6","688","2024-12-30"
"59624","2024","COM","2022","2137","17","2154","2024-12-30"
"59625","2024","COM","2022","389","5","394","2024-12-30"
"59626","2024","COM","2022","1230","21","1251","2024-12-30"
"59627","2024","COM","2022","1008","9","1017","2024-12-30"
"59628","2024","COM","2022","567","11","578","2024-12-30"
"59629","2024","COM","2022","1311","23","1334","2024-12-30"
"59630","2024","COM","2022","2596","48","2644","2024-12-30"
"59631","2024","COM","2022","2091","20","2111","2024-12-30"
"59632","2024","COM","2022","5618","36","5654","2024-12-30"
"59633","2024","COM","2022","274","7","281","2024-12-30"
"59634","2024","COM","2022","798","19","817","2024-12-30"
"59635","2024","COM","2022","368","6","374","2024-12-30"
"59636","2024","COM","2022","10984","118","11102","2024-12-30"
"59637","2024","COM","2022","1310","17","1327","2024-12-30"
"59638","2024","COM","2022","1332","13","1345","2024-12-30"
"59639","2024","COM","2022","1113","22","1135","2024-12-30"
"59640","2024","COM","2022","774","11","785","2024-12-30"
"59641","2024","COM","2022","2035","38","2073","2024-12-30"
"59642","2024","COM","2022","599","14","613","2024-12-30"
"59643","2024","COM","2022","233","5","238","2024-12-30"
"59645","2024","COM","2022","596","9","605","2024-12-30"
"59646","2024","COM","2022","20674","234","20908","2024-12-30"
"59647","2024","COM","2022","2567","24","2591","2024-12-30"
"59648","2024","COM","2022","15756","195","15951","2024-12-30"
"59649","2024","COM","2022","240","5","245","2024-12-30"
"59650","2024","COM","2022","40881","192","41073","2024-12-30"
"59651","2024","COM","2022","1606","10","1616","2024-12-30"
"59652","2024","COM","2022","432","4","436","2024-12-30"
"59653","2024","COM","2022","7777","58","7835","2024-12-30"
"59654","2024","COM","2022","7312","61","7373","2024-12-30"
"59655","2024","COM","2022","229","4","233","2024-12-30"
"59656","2024","COM","2022","5446","52","5498","2024-12-30"
"59657","2024","COM","2022","640","10","650","2024-12-30"
"59658","2024","COM","2022","562","7","569","2024-12-30"
"59659","2024","COM","2022","2813","19","2832","2024-12-30"
"59660","2024","COM","2022","2969","30","2999","2024-12-30"
"59661","2024","COM","2022","128","3","131","2024-12-30"
"59662","2024","COM","2022","1280","31","1311","2024-12-30"
"59663","2024","COM","2022","5645","93","5738","2024-12-30"
"59664","2024","COM","2022","332","8","340","2024-12-30"
"59665","2024","COM","2022","301","6","307","2024-12-30"
"59666","2024","COM","2022","1549","27","1576","2024-12-30"
"59667","2024","COM","2022","245","5","250","2024-12-30"
"59668","2024","COM","2022","1608","55","1663","2024-12-30"
"59669","2024","COM","2022","542","9","551","2024-12-30"
"59670","2024","COM","2022","1401","12","1413","2024-12-30"
"60001","2024","COM","2022","581","12","593","2024-12-30"
"60002","2024","COM","2022","861","26","887","2024-12-30"
"60003","2024","COM","2022","510","13","523","2024-12-30"
"60004","2024","COM","2022","406","8","414","2024-12-30"
"60005","2024","COM","2022","844","8","852","2024-12-30"
"60006","2024","COM","2022","1147","20","1167","2024-12-30"
"60007","2024","COM","2022","3060","98","3158","2024-12-30"
"60008","2024","COM","2022","389","155","544","2024-12-30"
"60009","2024","COM","2022","1737","37","1774","2024-12-30"
"60010","2024","COM","2022","1786","29","1815","2024-12-30"
"60011","2024","COM","2022","421","1","422","2024-12-30"
"60012","2024","COM","2022","3429","41","3470","2024-12-30"
"60013","2024","COM","2022","1335","26","1361","2024-12-30"
"60014","2024","COM","2022","159","5","164","2024-12-30"
"60015","2024","COM","2022","1129","17","1146","2024-12-30"
"60016","2024","COM","2022","271","8","279","2024-12-30"
"60017","2024","COM","2022","1140","18","1158","2024-12-30"
"60019","2024","COM","2022","410","14","424","2024-12-30"
"60020","2024","COM","2022","271","3","274","2024-12-30"
"60021","2024","COM","2022","505","5","510","2024-12-30"
"60022","2024","COM","2022","638","15","653","2024-12-30"
"60023","2024","COM","2022","531","15","546","2024-12-30"
"60024","2024","COM","2022","817","12","829","2024-12-30"
"60025","2024","COM","2022","1855","47","1902","2024-12-30"
"60026","2024","COM","2022","561","9","570","2024-12-30"
"60027","2024","COM","2022","521","9","530","2024-12-30"
"60028","2024","COM","2022","564","25","589","2024-12-30"
"60029","2024","COM","2022","2895","38","2933","2024-12-30"
"60030","2024","COM","2022","553","8","561","2024-12-30"
"60031","2024","COM","2022","259","6","265","2024-12-30"
"60032","2024","COM","2022","725","11","736","2024-12-30"
"60033","2024","COM","2022","866","38","904","2024-12-30"
"60034","2024","COM","2022","1154","21","1175","2024-12-30"
"60035","2024","COM","2022","237","4","241","2024-12-30"
"60036","2024","COM","2022","401","8","409","2024-12-30"
"60037","2024","COM","2022","514","8","522","2024-12-30"
"60039","2024","COM","2022","479","6","485","2024-12-30"
"60040","2024","COM","2022","644","15","659","2024-12-30"
"60041","2024","COM","2022","2328","60","2388","2024-12-30"
"60042","2024","COM","2022","1477","31","1508","2024-12-30"
"60043","2024","COM","2022","605","11","616","2024-12-30"
"60044","2024","COM","2022","1639","27","1666","2024-12-30"
"60045","2024","COM","2022","532","10","542","2024-12-30"
"60046","2024","COM","2022","330","13","343","2024-12-30"
"60047","2024","COM","2022","740","21","761","2024-12-30"
"60048","2024","COM","2022","284","5","289","2024-12-30"
"60049","2024","COM","2022","103","2","105","2024-12-30"
"60050","2024","COM","2022","370","7","377","2024-12-30"
"60051","2024","COM","2022","170","1","171","2024-12-30"
"60052","2024","COM","2022","102","1","103","2024-12-30"
"60053","2024","COM","2022","571","36","607","2024-12-30"
"60054","2024","COM","2022","337","7","344","2024-12-30"
"60055","2024","COM","2022","340","9","349","2024-12-30"
"60056","2024","COM","2022","64","1","65","2024-12-30"
"60057","2024","COM","2022","55906","1392","57298","2024-12-30"
"60058","2024","COM","2022","224","2","226","2024-12-30"
"60059","2024","COM","2022","194","4","198","2024-12-30"
"60060","2024","COM","2022","725","12","737","2024-12-30"
"60061","2024","COM","2022","70","4","74","2024-12-30"
"60062","2024","COM","2022","316","6","322","2024-12-30"
"60063","2024","COM","2022","819","19","838","2024-12-30"
"60064","2024","COM","2022","937","15","952","2024-12-30"
"60065","2024","COM","2022","1574","33","1607","2024-12-30"
"60066","2024","COM","2022","206","4","210","2024-12-30"
"60067","2024","COM","2022","992","24","1016","2024-12-30"
"60068","2024","COM","2022","3133","45","3178","2024-12-30"
"60069","2024","COM","2022","1118","41","1159","2024-12-30"
"60070","2024","COM","2022","489","11","500","2024-12-30"
"60071","2024","COM","2022","172","5","177","2024-12-30"
"60072","2024","COM","2022","309","12","321","2024-12-30"
"60073","2024","COM","2022","576","14","590","2024-12-30"
"60074","2024","COM","2022","1187","32","1219","2024-12-30"
"60075","2024","COM","2022","143","1","144","2024-12-30"
"60076","2024","COM","2022","505","8","513","2024-12-30"
"60077","2024","COM","2022","358","9","367","2024-12-30"
"60078","2024","COM","2022","122","2","124","2024-12-30"
"60079","2024","COM","2022","955","18","973","2024-12-30"
"60081","2024","COM","2022","472","9","481","2024-12-30"
"60082","2024","COM","2022","780","15","795","2024-12-30"
"60083","2024","COM","2022","976","20","996","2024-12-30"
"60084","2024","COM","2022","194","1","195","2024-12-30"
"60085","2024","COM","2022","193","1","194","2024-12-30"
"60086","2024","COM","2022","2135","47","2182","2024-12-30"
"60087","2024","COM","2022","356","15","371","2024-12-30"
"60088","2024","COM","2022","4796","69","4865","2024-12-30"
"60089","2024","COM","2022","385","5","390","2024-12-30"
"60090","2024","COM","2022","431","2","433","2024-12-30"
"60091","2024","COM","2022","425","6","431","2024-12-30"
"60092","2024","COM","2022","201","5","206","2024-12-30"
"60093","2024","COM","2022","466","8","474","2024-12-30"
"60094","2024","COM","2022","306","3","309","2024-12-30"
"60095","2024","COM","2022","343","2","345","2024-12-30"
"60097","2024","COM","2022","215","4","219","2024-12-30"
"60098","2024","COM","2022","170","4","174","2024-12-30"
"60099","2024","COM","2022","175","3","178","2024-12-30"
"60100","2024","COM","2022","114","6","120","2024-12-30"
"60101","2024","COM","2022","638","9","647","2024-12-30"
"60102","2024","COM","2022","2120","38","2158","2024-12-30"
"60103","2024","COM","2022","4032","54","4086","2024-12-30"
"60104","2024","COM","2022","4189","92","4281","2024-12-30"
"60105","2024","COM","2022","433","8","441","2024-12-30"
"60106","2024","COM","2022","2526","44","2570","2024-12-30"
"60107","2024","COM","2022","3150","145","3295","2024-12-30"
"60108","2024","COM","2022","297","6","303","2024-12-30"
"60109","2024","COM","2022","247","2","249","2024-12-30"
"60110","2024","COM","2022","238","4","242","2024-12-30"
"60111","2024","COM","2022","143","2","145","2024-12-30"
"60112","2024","COM","2022","344","4","348","2024-12-30"
"60113","2024","COM","2022","207","2","209","2024-12-30"
"60114","2024","COM","2022","148","1","149","2024-12-30"
"60115","2024","COM","2022","851","10","861","2024-12-30"
"60116","2024","COM","2022","2876","37","2913","2024-12-30"
"60117","2024","COM","2022","308","12","320","2024-12-30"
"60118","2024","COM","2022","512","9","521","2024-12-30"
"60119","2024","COM","2022","1875","32","1907","2024-12-30"
"60120","2024","COM","2022","1179","37","1216","2024-12-30"
"60121","2024","COM","2022","160","2","162","2024-12-30"
"60122","2024","COM","2022","485","9","494","2024-12-30"
"60123","2024","COM","2022","476","8","484","2024-12-30"
"60124","2024","COM","2022","319","6","325","2024-12-30"
"60125","2024","COM","2022","743","20","763","2024-12-30"
"60126","2024","COM","2022","517","12","529","2024-12-30"
"60127","2024","COM","2022","411","3","414","2024-12-30"
"60128","2024","COM","2022","224","0","224","2024-12-30"
"60129","2024","COM","2022","1402","29","1431","2024-12-30"
"60130","2024","COM","2022","1080","27","1107","2024-12-30"
"60131","2024","COM","2022","101","2","103","2024-12-30"
"60132","2024","COM","2022","179","2","181","2024-12-30"
"60133","2024","COM","2022","540","9","549","2024-12-30"
"60134","2024","COM","2022","2669","30","2699","2024-12-30"
"60135","2024","COM","2022","1675","38","1713","2024-12-30"
"60136","2024","COM","2022","479","12","491","2024-12-30"
"60137","2024","COM","2022","294","3","297","2024-12-30"
"60138","2024","COM","2022","1037","29","1066","2024-12-30"
"60139","2024","COM","2022","9909","127","10036","2024-12-30"
"60140","2024","COM","2022","303","7","310","2024-12-30"
"60141","2024","COM","2022","10740","236","10976","2024-12-30"
"60142","2024","COM","2022","3109","94","3203","2024-12-30"
"60143","2024","COM","2022","3359","44","3403","2024-12-30"
"60144","2024","COM","2022","162","5","167","2024-12-30"
"60145","2024","COM","2022","475","13","488","2024-12-30"
"60146","2024","COM","2022","457","10","467","2024-12-30"
"60147","2024","COM","2022","782","33","815","2024-12-30"
"60148","2024","COM","2022","405","10","415","2024-12-30"
"60149","2024","COM","2022","2017","68","2085","2024-12-30"
"60150","2024","COM","2022","1109","25","1134","2024-12-30"
"60151","2024","COM","2022","3386","89","3475","2024-12-30"
"60152","2024","COM","2022","245","1","246","2024-12-30"
"60153","2024","COM","2022","99","0","99","2024-12-30"
"60154","2024","COM","2022","1638","58","1696","2024-12-30"
"60155","2024","COM","2022","3997","54","4051","2024-12-30"
"60156","2024","COM","2022","2220","53","2273","2024-12-30"
"60157","2024","COM","2022","10704","200","10904","2024-12-30"
"60158","2024","COM","2022","245","4","249","2024-12-30"
"60159","2024","COM","2022","40808","1017","41825","2024-12-30"
"60160","2024","COM","2022","753","13","766","2024-12-30"
"60161","2024","COM","2022","71","1","72","2024-12-30"
"60162","2024","COM","2022","332","12","344","2024-12-30"
"60163","2024","COM","2022","393","5","398","2024-12-30"
"60164","2024","COM","2022","857","15","872","2024-12-30"
"60165","2024","COM","2022","555","16","571","2024-12-30"
"60166","2024","COM","2022","1054","18","1072","2024-12-30"
"60167","2024","COM","2022","592","10","602","2024-12-30"
"60168","2024","COM","2022","212","2","214","2024-12-30"
"60169","2024","COM","2022","811","22","833","2024-12-30"
"60170","2024","COM","2022","578","36","614","2024-12-30"
"60171","2024","COM","2022","174","1","175","2024-12-30"
"60172","2024","COM","2022","3868","148","4016","2024-12-30"
"60173","2024","COM","2022","804","12","816","2024-12-30"
"60174","2024","COM","2022","220","4","224","2024-12-30"
"60175","2024","COM","2022","36494","246","36740","2024-12-30"
"60176","2024","COM","2022","14243","249","14492","2024-12-30"
"60177","2024","COM","2022","437","9","446","2024-12-30"
"60178","2024","COM","2022","3458","124","3582","2024-12-30"
"60179","2024","COM","2022","157","1","158","2024-12-30"
"60180","2024","COM","2022","488","13","501","2024-12-30"
"60181","2024","COM","2022","921","18","939","2024-12-30"
"60182","2024","COM","2022","178","4","182","2024-12-30"
"60183","2024","COM","2022","234","9","243","2024-12-30"
"60184","2024","COM","2022","205","12","217","2024-12-30"
"60185","2024","COM","2022","1100","26","1126","2024-12-30"
"60186","2024","COM","2022","266","6","272","2024-12-30"
"60187","2024","COM","2022","966","14","980","2024-12-30"
"60188","2024","COM","2022","2101","87","2188","2024-12-30"
"60189","2024","COM","2022","955","21","976","2024-12-30"
"60190","2024","COM","2022","315","6","321","2024-12-30"
"60191","2024","COM","2022","621","10","631","2024-12-30"
"60192","2024","COM","2022","216","6","222","2024-12-30"
"60193","2024","COM","2022","200","2","202","2024-12-30"
"60194","2024","COM","2022","242","3","245","2024-12-30"
"60195","2024","COM","2022","533","10","543","2024-12-30"
"60196","2024","COM","2022","1086","17","1103","2024-12-30"
"60197","2024","COM","2022","973","6","979","2024-12-30"
"60198","2024","COM","2022","376","10","386","2024-12-30"
"60199","2024","COM","2022","254","8","262","2024-12-30"
"60200","2024","COM","2022","317","2","319","2024-12-30"
"60201","2024","COM","2022","245","2","247","2024-12-30"
"60203","2024","COM","2022","417","9","426","2024-12-30"
"60204","2024","COM","2022","299","5","304","2024-12-30"
"60205","2024","COM","2022","49","1","50","2024-12-30"
"60206","2024","COM","2022","918","21","939","2024-12-30"
"60207","2024","COM","2022","285","7","292","2024-12-30"
"60208","2024","COM","2022","116","6","122","2024-12-30"
"60209","2024","COM","2022","544","10","554","2024-12-30"
"60210","2024","COM","2022","282","5","287","2024-12-30"
"60211","2024","COM","2022","599","3","602","2024-12-30"
"60212","2024","COM","2022","1626","26","1652","2024-12-30"
"60213","2024","COM","2022","927","21","948","2024-12-30"
"60214","2024","COM","2022","176","7","183","2024-12-30"
"60215","2024","COM","2022","592","12","604","2024-12-30"
"60216","2024","COM","2022","185","3","188","2024-12-30"
"60217","2024","COM","2022","223","5","228","2024-12-30"
"60218","2024","COM","2022","1654","11","1665","2024-12-30"
"60219","2024","COM","2022","176","1","177","2024-12-30"
"60220","2024","COM","2022","504","16","520","2024-12-30"
"60221","2024","COM","2022","735","4","739","2024-12-30"
"60222","2024","COM","2022","520","16","536","2024-12-30"
"60223","2024","COM","2022","3660","88","3748","2024-12-30"
"60224","2024","COM","2022","177","6","183","2024-12-30"
"60225","2024","COM","2022","839","26","865","2024-12-30"
"60226","2024","COM","2022","415","6","421","2024-12-30"
"60227","2024","COM","2022","217","5","222","2024-12-30"
"60228","2024","COM","2022","470","11","481","2024-12-30"
"60229","2024","COM","2022","233","4","237","2024-12-30"
"60230","2024","COM","2022","529","14","543","2024-12-30"
"60231","2024","COM","2022","451","5","456","2024-12-30"
"60232","2024","COM","2022","446","6","452","2024-12-30"
"60233","2024","COM","2022","1396","14","1410","2024-12-30"
"60234","2024","COM","2022","2546","46","2592","2024-12-30"
"60235","2024","COM","2022","677","16","693","2024-12-30"
"60236","2024","COM","2022","225","3","228","2024-12-30"
"60237","2024","COM","2022","87","1","88","2024-12-30"
"60238","2024","COM","2022","1927","83","2010","2024-12-30"
"60239","2024","COM","2022","586","12","598","2024-12-30"
"60240","2024","COM","2022","235","8","243","2024-12-30"
"60241","2024","COM","2022","326","16","342","2024-12-30"
"60242","2024","COM","2022","503","8","511","2024-12-30"
"60243","2024","COM","2022","176","6","182","2024-12-30"
"60244","2024","COM","2022","144","1","145","2024-12-30"
"60245","2024","COM","2022","2101","26","2127","2024-12-30"
"60247","2024","COM","2022","144","2","146","2024-12-30"
"60248","2024","COM","2022","217","8","225","2024-12-30"
"60249","2024","COM","2022","193","4","197","2024-12-30"
"60250","2024","COM","2022","405","11","416","2024-12-30"
"60251","2024","COM","2022","297","7","304","2024-12-30"
"60252","2024","COM","2022","521","10","531","2024-12-30"
"60253","2024","COM","2022","499","8","507","2024-12-30"
"60254","2024","COM","2022","544","16","560","2024-12-30"
"60255","2024","COM","2022","326","3","329","2024-12-30"
"60256","2024","COM","2022","1332","22","1354","2024-12-30"
"60257","2024","COM","2022","440","1","441","2024-12-30"
"60258","2024","COM","2022","157","0","157","2024-12-30"
"60259","2024","COM","2022","874","20","894","2024-12-30"
"60260","2024","COM","2022","681","21","702","2024-12-30"
"60261","2024","COM","2022","547","16","563","2024-12-30"
"60262","2024","COM","2022","231","8","239","2024-12-30"
"60263","2024","COM","2022","264","1","265","2024-12-30"
"60264","2024","COM","2022","522","6","528","2024-12-30"
"60265","2024","COM","2022","966","16","982","2024-12-30"
"60267","2024","COM","2022","158","6","164","2024-12-30"
"60268","2024","COM","2022","356","3","359","2024-12-30"
"60269","2024","COM","2022","346","9","355","2024-12-30"
"60270","2024","COM","2022","330","85","415","2024-12-30"
"60271","2024","COM","2022","86","2","88","2024-12-30"
"60272","2024","COM","2022","629","19","648","2024-12-30"
"60273","2024","COM","2022","524","15","539","2024-12-30"
"60274","2024","COM","2022","364","9","373","2024-12-30"
"60275","2024","COM","2022","217","0","217","2024-12-30"
"60276","2024","COM","2022","200","2","202","2024-12-30"
"60277","2024","COM","2022","1582","40","1622","2024-12-30"
"60278","2024","COM","2022","407","5","412","2024-12-30"
"60279","2024","COM","2022","217","4","221","2024-12-30"
"60280","2024","COM","2022","104","0","104","2024-12-30"
"60281","2024","COM","2022","535","14","549","2024-12-30"
"60282","2024","COM","2022","8934","389","9323","2024-12-30"
"60283","2024","COM","2022","15","1","16","2024-12-30"
"60284","2024","COM","2022","1826","60","1886","2024-12-30"
"60285","2024","COM","2022","300","15","315","2024-12-30"
"60286","2024","COM","2022","2761","73","2834","2024-12-30"
"60287","2024","COM","2022","367","6","373","2024-12-30"
"60288","2024","COM","2022","479","9","488","2024-12-30"
"60289","2024","COM","2022","264","6","270","2024-12-30"
"60290","2024","COM","2022","386","8","394","2024-12-30"
"60291","2024","COM","2022","1763","33","1796","2024-12-30"
"60292","2024","COM","2022","233","8","241","2024-12-30"
"60293","2024","COM","2022","379","6","385","2024-12-30"
"60294","2024","COM","2022","87","1","88","2024-12-30"
"60295","2024","COM","2022","439","6","445","2024-12-30"
"60296","2024","COM","2022","130","4","134","2024-12-30"
"60297","2024","COM","2022","185","3","188","2024-12-30"
"60298","2024","COM","2022","654","13","667","2024-12-30"
"60299","2024","COM","2022","551","9","560","2024-12-30"
"60301","2024","COM","2022","132","3","135","2024-12-30"
"60302","2024","COM","2022","767","24","791","2024-12-30"
"60303","2024","COM","2022","191","3","194","2024-12-30"
"60304","2024","COM","2022","262","6","268","2024-12-30"
"60305","2024","COM","2022","347","6","353","2024-12-30"
"60306","2024","COM","2022","149","3","152","2024-12-30"
"60307","2024","COM","2022","649","11","660","2024-12-30"
"60308","2024","COM","2022","467","5","472","2024-12-30"
"60309","2024","COM","2022","909","20","929","2024-12-30"
"60310","2024","COM","2022","588","12","600","2024-12-30"
"60311","2024","COM","2022","238","2","240","2024-12-30"
"60312","2024","COM","2022","108","2","110","2024-12-30"
"60313","2024","COM","2022","2510","39","2549","2024-12-30"
"60314","2024","COM","2022","321","9","330","2024-12-30"
"60315","2024","COM","2022","484","12","496","2024-12-30"
"60316","2024","COM","2022","228","7","235","2024-12-30"
"60317","2024","COM","2022","715","6","721","2024-12-30"
"60318","2024","COM","2022","676","12","688","2024-12-30"
"60319","2024","COM","2022","605","5","610","2024-12-30"
"60320","2024","COM","2022","255","6","261","2024-12-30"
"60321","2024","COM","2022","876","7","883","2024-12-30"
"60322","2024","COM","2022","309","9","318","2024-12-30"
"60323","2024","COM","2022","635","11","646","2024-12-30"
"60324","2024","COM","2022","858","11","869","2024-12-30"
"60325","2024","COM","2022","2240","63","2303","2024-12-30"
"60326","2024","COM","2022","600","24","624","2024-12-30"
"60327","2024","COM","2022","1067","17","1084","2024-12-30"
"60328","2024","COM","2022","297","9","306","2024-12-30"
"60329","2024","COM","2022","200","6","206","2024-12-30"
"60330","2024","COM","2022","1330","21","1351","2024-12-30"
"60331","2024","COM","2022","457","6","463","2024-12-30"
"60332","2024","COM","2022","699","7","706","2024-12-30"
"60333","2024","COM","2022","1534","29","1563","2024-12-30"
"60334","2024","COM","2022","830","16","846","2024-12-30"
"60335","2024","COM","2022","159","2","161","2024-12-30"
"60336","2024","COM","2022","184","7","191","2024-12-30"
"60337","2024","COM","2022","807","32","839","2024-12-30"
"60338","2024","COM","2022","5175","178","5353","2024-12-30"
"60339","2024","COM","2022","350","6","356","2024-12-30"
"60340","2024","COM","2022","524","17","541","2024-12-30"
"60341","2024","COM","2022","2046","42","2088","2024-12-30"
"60342","2024","COM","2022","4846","53","4899","2024-12-30"
"60343","2024","COM","2022","598","22","620","2024-12-30"
"60344","2024","COM","2022","521","9","530","2024-12-30"
"60345","2024","COM","2022","194","2","196","2024-12-30"
"60346","2024","COM","2022","9097","250","9347","2024-12-30"
"60347","2024","COM","2022","281","3","284","2024-12-30"
"60348","2024","COM","2022","511","10","521","2024-12-30"
"60350","2024","COM","2022","1436","24","1460","2024-12-30"
"60351","2024","COM","2022","117","0","117","2024-12-30"
"60352","2024","COM","2022","174","2","176","2024-12-30"
"60353","2024","COM","2022","185","1","186","2024-12-30"
"60354","2024","COM","2022","28","1","29","2024-12-30"
"60355","2024","COM","2022","1133","30","1163","2024-12-30"
"60356","2024","COM","2022","637","7","644","2024-12-30"
"60357","2024","COM","2022","553","7","560","2024-12-30"
"60358","2024","COM","2022","1014","23","1037","2024-12-30"
"60359","2024","COM","2022","202","3","205","2024-12-30"
"60360","2024","COM","2022","6884","75","6959","2024-12-30"
"60361","2024","COM","2022","577","11","588","2024-12-30"
"60362","2024","COM","2022","179","7","186","2024-12-30"
"60363","2024","COM","2022","222","7","229","2024-12-30"
"60364","2024","COM","2022","708","11","719","2024-12-30"
"60365","2024","COM","2022","424","5","429","2024-12-30"
"60366","2024","COM","2022","370","5","375","2024-12-30"
"60367","2024","COM","2022","331","8","339","2024-12-30"
"60368","2024","COM","2022","2595","47","2642","2024-12-30"
"60369","2024","COM","2022","1952","45","1997","2024-12-30"
"60370","2024","COM","2022","1282","18","1300","2024-12-30"
"60371","2024","COM","2022","151","7","158","2024-12-30"
"60372","2024","COM","2022","670","12","682","2024-12-30"
"60373","2024","COM","2022","808","20","828","2024-12-30"
"60374","2024","COM","2022","2493","37","2530","2024-12-30"
"60375","2024","COM","2022","385","10","395","2024-12-30"
"60376","2024","COM","2022","178","2","180","2024-12-30"
"60377","2024","COM","2022","287","8","295","2024-12-30"
"60378","2024","COM","2022","377","8","385","2024-12-30"
"60379","2024","COM","2022","606","16","622","2024-12-30"
"60380","2024","COM","2022","1589","38","1627","2024-12-30"
"60381","2024","COM","2022","254","3","257","2024-12-30"
"60382","2024","COM","2022","8700","178","8878","2024-12-30"
"60383","2024","COM","2022","533","13","546","2024-12-30"
"60385","2024","COM","2022","646","12","658","2024-12-30"
"60386","2024","COM","2022","481","12","493","2024-12-30"
"60387","2024","COM","2022","1426","14","1440","2024-12-30"
"60388","2024","COM","2022","137","7","144","2024-12-30"
"60389","2024","COM","2022","232","7","239","2024-12-30"
"60390","2024","COM","2022","341","7","348","2024-12-30"
"60391","2024","COM","2022","214","3","217","2024-12-30"
"60392","2024","COM","2022","791","17","808","2024-12-30"
"60393","2024","COM","2022","601","14","615","2024-12-30"
"60394","2024","COM","2022","103","3","106","2024-12-30"
"60395","2024","COM","2022","14091","170","14261","2024-12-30"
"60396","2024","COM","2022","612","10","622","2024-12-30"
"60397","2024","COM","2022","69","3","72","2024-12-30"
"60398","2024","COM","2022","2392","28","2420","2024-12-30"
"60399","2024","COM","2022","249","3","252","2024-12-30"
"60400","2024","COM","2022","266","6","272","2024-12-30"
"60401","2024","COM","2022","776","20","796","2024-12-30"
"60402","2024","COM","2022","2310","59","2369","2024-12-30"
"60403","2024","COM","2022","1878","36","1914","2024-12-30"
"60404","2024","COM","2022","1495","40","1535","2024-12-30"
"60405","2024","COM","2022","1126","17","1143","2024-12-30"
"60406","2024","COM","2022","948","22","970","2024-12-30"
"60407","2024","COM","2022","218","2","220","2024-12-30"
"60408","2024","COM","2022","776","17","793","2024-12-30"
"60409","2024","COM","2022","2161","41","2202","2024-12-30"
"60410","2024","COM","2022","248","8","256","2024-12-30"
"60411","2024","COM","2022","769","24","793","2024-12-30"
"60412","2024","COM","2022","676","14","690","2024-12-30"
"60413","2024","COM","2022","431","9","440","2024-12-30"
"60414","2024","COM","2022","13944","136","14080","2024-12-30"
"60415","2024","COM","2022","151","4","155","2024-12-30"
"60416","2024","COM","2022","168","2","170","2024-12-30"
"60418","2024","COM","2022","396","14","410","2024-12-30"
"60420","2024","COM","2022","525","10","535","2024-12-30"
"60421","2024","COM","2022","405","11","416","2024-12-30"
"60422","2024","COM","2022","206","9","215","2024-12-30"
"60423","2024","COM","2022","1159","23","1182","2024-12-30"
"60424","2024","COM","2022","288","8","296","2024-12-30"
"60425","2024","COM","2022","495","13","508","2024-12-30"
"60426","2024","COM","2022","244","6","250","2024-12-30"
"60427","2024","COM","2022","187","1","188","2024-12-30"
"60428","2024","COM","2022","648","27","675","2024-12-30"
"60429","2024","COM","2022","408","11","419","2024-12-30"
"60430","2024","COM","2022","1055","22","1077","2024-12-30"
"60431","2024","COM","2022","513","9","522","2024-12-30"
"60432","2024","COM","2022","859","17","876","2024-12-30"
"60433","2024","COM","2022","975","12","987","2024-12-30"
"60434","2024","COM","2022","220","6","226","2024-12-30"
"60435","2024","COM","2022","504","8","512","2024-12-30"
"60436","2024","COM","2022","80","2","82","2024-12-30"
"60437","2024","COM","2022","75","2","77","2024-12-30"
"60438","2024","COM","2022","189","5","194","2024-12-30"
"60439","2024","COM","2022","5339","58","5397","2024-12-30"
"60440","2024","COM","2022","584","17","601","2024-12-30"
"60441","2024","COM","2022","666","18","684","2024-12-30"
"60442","2024","COM","2022","135","6","141","2024-12-30"
"60443","2024","COM","2022","587","4","591","2024-12-30"
"60444","2024","COM","2022","140","2","142","2024-12-30"
"60445","2024","COM","2022","297","3","300","2024-12-30"
"60446","2024","COM","2022","4274","66","4340","2024-12-30"
"60447","2024","COM","2022","646","14","660","2024-12-30"
"60448","2024","COM","2022","389","7","396","2024-12-30"
"60449","2024","COM","2022","278","6","284","2024-12-30"
"60450","2024","COM","2022","4132","44","4176","2024-12-30"
"60451","2024","COM","2022","1591","30","1621","2024-12-30"
"60452","2024","COM","2022","475","7","482","2024-12-30"
"60454","2024","COM","2022","954","17","971","2024-12-30"
"60456","2024","COM","2022","906","28","934","2024-12-30"
"60457","2024","COM","2022","162","5","167","2024-12-30"
"60458","2024","COM","2022","304","15","319","2024-12-30"
"60459","2024","COM","2022","203","4","207","2024-12-30"
"60460","2024","COM","2022","208","5","213","2024-12-30"
"60461","2024","COM","2022","211","9","220","2024-12-30"
"60462","2024","COM","2022","2857","43","2900","2024-12-30"
"60463","2024","COM","2022","21859","334","22193","2024-12-30"
"60464","2024","COM","2022","1156","16","1172","2024-12-30"
"60465","2024","COM","2022","187","3","190","2024-12-30"
"60466","2024","COM","2022","254","3","257","2024-12-30"
"60468","2024","COM","2022","295","4","299","2024-12-30"
"60469","2024","COM","2022","374","5","379","2024-12-30"
"60470","2024","COM","2022","892","17","909","2024-12-30"
"60471","2024","COM","2022","12810","199","13009","2024-12-30"
"60472","2024","COM","2022","112","3","115","2024-12-30"
"60473","2024","COM","2022","328","4","332","2024-12-30"
"60474","2024","COM","2022","287","4","291","2024-12-30"
"60476","2024","COM","2022","203","4","207","2024-12-30"
"60477","2024","COM","2022","1375","19","1394","2024-12-30"
"60478","2024","COM","2022","371","9","380","2024-12-30"
"60479","2024","COM","2022","795","12","807","2024-12-30"
"60480","2024","COM","2022","541","8","549","2024-12-30"
"60481","2024","COM","2022","587","16","603","2024-12-30"
"60482","2024","COM","2022","3519","92","3611","2024-12-30"
"60483","2024","COM","2022","519","14","533","2024-12-30"
"60484","2024","COM","2022","294","4","298","2024-12-30"
"60485","2024","COM","2022","244","4","248","2024-12-30"
"60486","2024","COM","2022","572","12","584","2024-12-30"
"60487","2024","COM","2022","318","15","333","2024-12-30"
"60488","2024","COM","2022","271","5","276","2024-12-30"
"60489","2024","COM","2022","1217","20","1237","2024-12-30"
"60490","2024","COM","2022","365","8","373","2024-12-30"
"60491","2024","COM","2022","1888","152","2040","2024-12-30"
"60492","2024","COM","2022","851","18","869","2024-12-30"
"60493","2024","COM","2022","518","10","528","2024-12-30"
"60494","2024","COM","2022","1791","38","1829","2024-12-30"
"60495","2024","COM","2022","417","5","422","2024-12-30"
"60496","2024","COM","2022","163","3","166","2024-12-30"
"60497","2024","COM","2022","211","3","214","2024-12-30"
"60498","2024","COM","2022","539","3","542","2024-12-30"
"60499","2024","COM","2022","240","2","242","2024-12-30"
"60500","2024","COM","2022","3822","54","3876","2024-12-30"
"60501","2024","COM","2022","1307","22","1329","2024-12-30"
"60502","2024","COM","2022","107","5","112","2024-12-30"
"60503","2024","COM","2022","112","3","115","2024-12-30"
"60504","2024","COM","2022","1151","16","1167","2024-12-30"
"60505","2024","COM","2022","896","22","918","2024-12-30"
"60506","2024","COM","2022","671","12","683","2024-12-30"
"60507","2024","COM","2022","438","7","445","2024-12-30"
"60508","2024","COM","2022","3279","74","3353","2024-12-30"
"60509","2024","COM","2022","12343","132","12475","2024-12-30"
"60510","2024","COM","2022","675","16","691","2024-12-30"
"60511","2024","COM","2022","412","10","422","2024-12-30"
"60512","2024","COM","2022","153","6","159","2024-12-30"
"60513","2024","COM","2022","3331","73","3404","2024-12-30"
"60514","2024","COM","2022","249","1","250","2024-12-30"
"60515","2024","COM","2022","370","13","383","2024-12-30"
"60516","2024","COM","2022","397","8","405","2024-12-30"
"60517","2024","COM","2022","859","15","874","2024-12-30"
"60518","2024","COM","2022","205","4","209","2024-12-30"
"60519","2024","COM","2022","172","3","175","2024-12-30"
"60520","2024","COM","2022","220","5","225","2024-12-30"
"60521","2024","COM","2022","403","17","420","2024-12-30"
"60522","2024","COM","2022","317","2","319","2024-12-30"
"60523","2024","COM","2022","892","15","907","2024-12-30"
"60524","2024","COM","2022","2538","34","2572","2024-12-30"
"60525","2024","COM","2022","121","6","127","2024-12-30"
"60526","2024","COM","2022","1047","17","1064","2024-12-30"
"60527","2024","COM","2022","142","0","142","2024-12-30"
"60528","2024","COM","2022","116","4","120","2024-12-30"
"60529","2024","COM","2022","75","2","77","2024-12-30"
"60530","2024","COM","2022","209","9","218","2024-12-30"
"60531","2024","COM","2022","1957","60","2017","2024-12-30"
"60533","2024","COM","2022","1742","30","1772","2024-12-30"
"60534","2024","COM","2022","649","19","668","2024-12-30"
"60535","2024","COM","2022","329","2","331","2024-12-30"
"60536","2024","COM","2022","134","8","142","2024-12-30"
"60537","2024","COM","2022","3809","175","3984","2024-12-30"
"60538","2024","COM","2022","293","5","298","2024-12-30"
"60539","2024","COM","2022","1553","29","1582","2024-12-30"
"60540","2024","COM","2022","627","15","642","2024-12-30"
"60541","2024","COM","2022","352","11","363","2024-12-30"
"60542","2024","COM","2022","999","14","1013","2024-12-30"
"60543","2024","COM","2022","118","1","119","2024-12-30"
"60544","2024","COM","2022","188","3","191","2024-12-30"
"60545","2024","COM","2022","542","5","547","2024-12-30"
"60546","2024","COM","2022","143","4","147","2024-12-30"
"60547","2024","COM","2022","622","17","639","2024-12-30"
"60548","2024","COM","2022","605","4","609","2024-12-30"
"60549","2024","COM","2022","233","7","240","2024-12-30"
"60550","2024","COM","2022","229","0","229","2024-12-30"
"60551","2024","COM","2022","283","7","290","2024-12-30"
"60552","2024","COM","2022","250","9","259","2024-12-30"
"60553","2024","COM","2022","282","7","289","2024-12-30"
"60554","2024","COM","2022","472","11","483","2024-12-30"
"60555","2024","COM","2022","70","1","71","2024-12-30"
"60556","2024","COM","2022","211","3","214","2024-12-30"
"60557","2024","COM","2022","329","6","335","2024-12-30"
"60558","2024","COM","2022","451","20","471","2024-12-30"
"60559","2024","COM","2022","860","9","869","2024-12-30"
"60560","2024","COM","2022","751","33","784","2024-12-30"
"60561","2024","COM","2022","237","4","241","2024-12-30"
"60562","2024","COM","2022","1578","25","1603","2024-12-30"
"60563","2024","COM","2022","633","7","640","2024-12-30"
"60564","2024","COM","2022","286","3","289","2024-12-30"
"60565","2024","COM","2022","512","5","517","2024-12-30"
"60566","2024","COM","2022","202","3","205","2024-12-30"
"60567","2024","COM","2022","1193","27","1220","2024-12-30"
"60568","2024","COM","2022","348","8","356","2024-12-30"
"60569","2024","COM","2022","175","8","183","2024-12-30"
"60570","2024","COM","2022","1629","25","1654","2024-12-30"
"60571","2024","COM","2022","80","2","82","2024-12-30"
"60572","2024","COM","2022","292","4","296","2024-12-30"
"60573","2024","COM","2022","335","5","340","2024-12-30"
"60574","2024","COM","2022","618","14","632","2024-12-30"
"60575","2024","COM","2022","3478","51","3529","2024-12-30"
"60576","2024","COM","2022","454","14","468","2024-12-30"
"60577","2024","COM","2022","1680","32","1712","2024-12-30"
"60578","2024","COM","2022","1062","20","1082","2024-12-30"
"60579","2024","COM","2022","341","6","347","2024-12-30"
"60581","2024","COM","2022","5940","64","6004","2024-12-30"
"60582","2024","COM","2022","743","19","762","2024-12-30"
"60583","2024","COM","2022","376","9","385","2024-12-30"
"60584","2024","COM","2022","4576","112","4688","2024-12-30"
"60585","2024","COM","2022","270","2","272","2024-12-30"
"60586","2024","COM","2022","1080","18","1098","2024-12-30"
"60587","2024","COM","2022","1431","30","1461","2024-12-30"
"60588","2024","COM","2022","388","3","391","2024-12-30"
"60589","2024","COM","2022","3153","90","3243","2024-12-30"
"60590","2024","COM","2022","1205","29","1234","2024-12-30"
"60591","2024","COM","2022","1612","25","1637","2024-12-30"
"60592","2024","COM","2022","679","18","697","2024-12-30"
"60593","2024","COM","2022","147","2","149","2024-12-30"
"60594","2024","COM","2022","282","5","287","2024-12-30"
"60595","2024","COM","2022","435","5","440","2024-12-30"
"60596","2024","COM","2022","231","7","238","2024-12-30"
"60597","2024","COM","2022","1752","32","1784","2024-12-30"
"60598","2024","COM","2022","1066","78","1144","2024-12-30"
"60599","2024","COM","2022","285","5","290","2024-12-30"
"60600","2024","COM","2022","647","14","661","2024-12-30"
"60601","2024","COM","2022","1009","21","1030","2024-12-30"
"60602","2024","COM","2022","54","6","60","2024-12-30"
"60603","2024","COM","2022","900","23","923","2024-12-30"
"60604","2024","COM","2022","270","1","271","2024-12-30"
"60605","2024","COM","2022","350","8","358","2024-12-30"
"60608","2024","COM","2022","105","1","106","2024-12-30"
"60609","2024","COM","2022","926","25","951","2024-12-30"
"60610","2024","COM","2022","754","11","765","2024-12-30"
"60611","2024","COM","2022","583","12","595","2024-12-30"
"60612","2024","COM","2022","15238","565","15803","2024-12-30"
"60613","2024","COM","2022","351","6","357","2024-12-30"
"60614","2024","COM","2022","187","6","193","2024-12-30"
"60615","2024","COM","2022","133","1","134","2024-12-30"
"60616","2024","COM","2022","2798","27","2825","2024-12-30"
"60617","2024","COM","2022","273","5","278","2024-12-30"
"60618","2024","COM","2022","272","5","277","2024-12-30"
"60619","2024","COM","2022","1206","23","1229","2024-12-30"
"60620","2024","COM","2022","452","9","461","2024-12-30"
"60621","2024","COM","2022","130","0","130","2024-12-30"
"60622","2024","COM","2022","480","5","485","2024-12-30"
"60623","2024","COM","2022","939","81","1020","2024-12-30"
"60624","2024","COM","2022","166","3","169","2024-12-30"
"60625","2024","COM","2022","537","15","552","2024-12-30"
"60626","2024","COM","2022","648","17","665","2024-12-30"
"60627","2024","COM","2022","253","3","256","2024-12-30"
"60628","2024","COM","2022","1175","18","1193","2024-12-30"
"60629","2024","COM","2022","195","3","198","2024-12-30"
"60630","2024","COM","2022","214","3","217","2024-12-30"
"60631","2024","COM","2022","1086","27","1113","2024-12-30"
"60632","2024","COM","2022","749","16","765","2024-12-30"
"60633","2024","COM","2022","381","0","381","2024-12-30"
"60634","2024","COM","2022","439","9","448","2024-12-30"
"60635","2024","COM","2022","1061","8","1069","2024-12-30"
"60636","2024","COM","2022","4460","69","4529","2024-12-30"
"60637","2024","COM","2022","466","11","477","2024-12-30"
"60638","2024","COM","2022","670","12","682","2024-12-30"
"60639","2024","COM","2022","1294","27","1321","2024-12-30"
"60640","2024","COM","2022","171","1","172","2024-12-30"
"60641","2024","COM","2022","1701","49","1750","2024-12-30"
"60642","2024","COM","2022","1041","30","1071","2024-12-30"
"60643","2024","COM","2022","1378","14","1392","2024-12-30"
"60644","2024","COM","2022","1878","31","1909","2024-12-30"
"60645","2024","COM","2022","306","6","312","2024-12-30"
"60646","2024","COM","2022","1364","35","1399","2024-12-30"
"60647","2024","COM","2022","2024","50","2074","2024-12-30"
"60648","2024","COM","2022","316","3","319","2024-12-30"
"60650","2024","COM","2022","521","10","531","2024-12-30"
"60651","2024","COM","2022","1920","32","1952","2024-12-30"
"60652","2024","COM","2022","921","14","935","2024-12-30"
"60653","2024","COM","2022","298","6","304","2024-12-30"
"60654","2024","COM","2022","257","7","264","2024-12-30"
"60655","2024","COM","2022","365","8","373","2024-12-30"
"60656","2024","COM","2022","268","2","270","2024-12-30"
"60657","2024","COM","2022","245","4","249","2024-12-30"
"60658","2024","COM","2022","700","9","709","2024-12-30"
"60659","2024","COM","2022","163","3","166","2024-12-30"
"60660","2024","COM","2022","409","11","420","2024-12-30"
"60661","2024","COM","2022","1000","37","1037","2024-12-30"
"60662","2024","COM","2022","500","10","510","2024-12-30"
"60663","2024","COM","2022","238","3","241","2024-12-30"
"60664","2024","COM","2022","444","11","455","2024-12-30"
"60665","2024","COM","2022","2776","58","2834","2024-12-30"
"60666","2024","COM","2022","1155","28","1183","2024-12-30"
"60667","2024","COM","2022","3858","63","3921","2024-12-30"
"60668","2024","COM","2022","720","17","737","2024-12-30"
"60669","2024","COM","2022","487","12","499","2024-12-30"
"60670","2024","COM","2022","4795","117","4912","2024-12-30"
"60671","2024","COM","2022","348","19","367","2024-12-30"
"60672","2024","COM","2022","280","7","287","2024-12-30"
"60673","2024","COM","2022","216","4","220","2024-12-30"
"60674","2024","COM","2022","600","31","631","2024-12-30"
"60675","2024","COM","2022","420","5","425","2024-12-30"
"60676","2024","COM","2022","746","16","762","2024-12-30"
"60677","2024","COM","2022","248","10","258","2024-12-30"
"60678","2024","COM","2022","1188","26","1214","2024-12-30"
"60679","2024","COM","2022","141","6","147","2024-12-30"
"60680","2024","COM","2022","718","18","736","2024-12-30"
"60681","2024","COM","2022","470","11","481","2024-12-30"
"60682","2024","COM","2022","724","18","742","2024-12-30"
"60683","2024","COM","2022","388","7","395","2024-12-30"
"60684","2024","COM","2022","6500","90","6590","2024-12-30"
"60685","2024","COM","2022","981","15","996","2024-12-30"
"60686","2024","COM","2022","2301","57","2358","2024-12-30"
"60687","2024","COM","2022","371","5","376","2024-12-30"
"60688","2024","COM","2022","140","3","143","2024-12-30"
"60689","2024","COM","2022","1419","48","1467","2024-12-30"
"60691","2024","COM","2022","121","0","121","2024-12-30"
"60692","2024","COM","2022","151","1","152","2024-12-30"
"60693","2024","COM","2022","385","3","388","2024-12-30"
"60694","2024","COM","2022","547","12","559","2024-12-30"
"60695","2024","COM","2022","1399","51","1450","2024-12-30"
"60697","2024","COM","2022","33","1","34","2024-12-30"
"60698","2024","COM","2022","279","10","289","2024-12-30"
"60699","2024","COM","2022","162","5","167","2024-12-30"
"60700","2024","COM","2022","1220","22","1242","2024-12-30"
"60701","2024","COM","2022","1347","9","1356","2024-12-30"
"60702","2024","COM","2022","238","2","240","2024-12-30"
"60703","2024","COM","2022","911","13","924","2024-12-30"
"61001","2024","COM","2022","25667","711","26378","2024-12-30"
"61002","2024","COM","2022","642","10","652","2024-12-30"
"61005","2024","COM","2022","277","10","287","2024-12-30"
"61006","2024","COM","2022","13494","355","13849","2024-12-30"
"61007","2024","COM","2022","4208","88","4296","2024-12-30"
"61008","2024","COM","2022","1249","48","1297","2024-12-30"
"61010","2024","COM","2022","130","0","130","2024-12-30"
"61011","2024","COM","2022","396","14","410","2024-12-30"
"61012","2024","COM","2022","197","2","199","2024-12-30"
"61013","2024","COM","2022","142","0","142","2024-12-30"
"61014","2024","COM","2022","247","5","252","2024-12-30"
"61015","2024","COM","2022","276","9","285","2024-12-30"
"61017","2024","COM","2022","76","1","77","2024-12-30"
"61018","2024","COM","2022","69","2","71","2024-12-30"
"61020","2024","COM","2022","217","4","221","2024-12-30"
"61021","2024","COM","2022","94","4","98","2024-12-30"
"61023","2024","COM","2022","608","22","630","2024-12-30"
"61024","2024","COM","2022","630","14","644","2024-12-30"
"61026","2024","COM","2022","185","4","189","2024-12-30"
"61028","2024","COM","2022","455","11","466","2024-12-30"
"61029","2024","COM","2022","833","21","854","2024-12-30"
"61030","2024","COM","2022","272","6","278","2024-12-30"
"61032","2024","COM","2022","327","8","335","2024-12-30"
"61034","2024","COM","2022","203","6","209","2024-12-30"
"61035","2024","COM","2022","265","5","270","2024-12-30"
"61036","2024","COM","2022","208","4","212","2024-12-30"
"61037","2024","COM","2022","135","3","138","2024-12-30"
"61038","2024","COM","2022","1457","15","1472","2024-12-30"
"61039","2024","COM","2022","129","0","129","2024-12-30"
"61040","2024","COM","2022","1031","27","1058","2024-12-30"
"61041","2024","COM","2022","196","4","200","2024-12-30"
"61043","2024","COM","2022","1094","20","1114","2024-12-30"
"61044","2024","COM","2022","427","7","434","2024-12-30"
"61046","2024","COM","2022","141","0","141","2024-12-30"
"61048","2024","COM","2022","125","2","127","2024-12-30"
"61049","2024","COM","2022","109","1","110","2024-12-30"
"61050","2024","COM","2022","580","19","599","2024-12-30"
"61051","2024","COM","2022","348","8","356","2024-12-30"
"61052","2024","COM","2022","189","5","194","2024-12-30"
"61053","2024","COM","2022","232","3","235","2024-12-30"
"61054","2024","COM","2022","259","6","265","2024-12-30"
"61055","2024","COM","2022","567","8","575","2024-12-30"
"61056","2024","COM","2022","167","3","170","2024-12-30"
"61060","2024","COM","2022","136","5","141","2024-12-30"
"61061","2024","COM","2022","1462","19","1481","2024-12-30"
"61062","2024","COM","2022","89","1","90","2024-12-30"
"61063","2024","COM","2022","1511","34","1545","2024-12-30"
"61064","2024","COM","2022","92","1","93","2024-12-30"
"61066","2024","COM","2022","101","6","107","2024-12-30"
"61067","2024","COM","2022","166","1","167","2024-12-30"
"61068","2024","COM","2022","200","2","202","2024-12-30"
"61069","2024","COM","2022","162","7","169","2024-12-30"
"61070","2024","COM","2022","845","23","868","2024-12-30"
"61071","2024","COM","2022","169","7","176","2024-12-30"
"61072","2024","COM","2022","218","0","218","2024-12-30"
"61074","2024","COM","2022","626","8","634","2024-12-30"
"61075","2024","COM","2022","1164","20","1184","2024-12-30"
"61076","2024","COM","2022","145","5","150","2024-12-30"
"61077","2024","COM","2022","853","15","868","2024-12-30"
"61078","2024","COM","2022","706","50","756","2024-12-30"
"61079","2024","COM","2022","1765","22","1787","2024-12-30"
"61080","2024","COM","2022","82","0","82","2024-12-30"
"61081","2024","COM","2022","892","17","909","2024-12-30"
"61082","2024","COM","2022","84","5","89","2024-12-30"
"61084","2024","COM","2022","177","2","179","2024-12-30"
"61085","2024","COM","2022","29","0","29","2024-12-30"
"61086","2024","COM","2022","98","0","98","2024-12-30"
"61087","2024","COM","2022","160","4","164","2024-12-30"
"61088","2024","COM","2022","42","1","43","2024-12-30"
"61089","2024","COM","2022","102","0","102","2024-12-30"
"61091","2024","COM","2022","961","31","992","2024-12-30"
"61092","2024","COM","2022","681","16","697","2024-12-30"
"61093","2024","COM","2022","1248","27","1275","2024-12-30"
"61094","2024","COM","2022","587","13","600","2024-12-30"
"61095","2024","COM","2022","532","8","540","2024-12-30"
"61096","2024","COM","2022","2867","76","2943","2024-12-30"
"61097","2024","COM","2022","510","16","526","2024-12-30"
"61098","2024","COM","2022","488","35","523","2024-12-30"
"61099","2024","COM","2022","245","4","249","2024-12-30"
"61100","2024","COM","2022","289","17","306","2024-12-30"
"61101","2024","COM","2022","185","3","188","2024-12-30"
"61102","2024","COM","2022","402","9","411","2024-12-30"
"61103","2024","COM","2022","167","2","169","2024-12-30"
"61104","2024","COM","2022","53","1","54","2024-12-30"
"61105","2024","COM","2022","173","7","180","2024-12-30"
"61107","2024","COM","2022","410","10","420","2024-12-30"
"61108","2024","COM","2022","181","4","185","2024-12-30"
"61111","2024","COM","2022","334","6","340","2024-12-30"
"61113","2024","COM","2022","61","1","62","2024-12-30"
"61114","2024","COM","2022","149","6","155","2024-12-30"
"61116","2024","COM","2022","1983","37","2020","2024-12-30"
"61117","2024","COM","2022","2492","47","2539","2024-12-30"
"61118","2024","COM","2022","112","5","117","2024-12-30"
"61120","2024","COM","2022","78","1","79","2024-12-30"
"61121","2024","COM","2022","292","6","298","2024-12-30"
"61122","2024","COM","2022","81","6","87","2024-12-30"
"61123","2024","COM","2022","212","7","219","2024-12-30"
"61124","2024","COM","2022","498","5","503","2024-12-30"
"61126","2024","COM","2022","486","9","495","2024-12-30"
"61129","2024","COM","2022","351","9","360","2024-12-30"
"61130","2024","COM","2022","460","5","465","2024-12-30"
"61133","2024","COM","2022","725","22","747","2024-12-30"
"61137","2024","COM","2022","128","3","131","2024-12-30"
"61138","2024","COM","2022","193","3","196","2024-12-30"
"61139","2024","COM","2022","304","5","309","2024-12-30"
"61140","2024","COM","2022","803","20","823","2024-12-30"
"61141","2024","COM","2022","436","13","449","2024-12-30"
"61142","2024","COM","2022","156","0","156","2024-12-30"
"61143","2024","COM","2022","2425","59","2484","2024-12-30"
"61145","2024","COM","2022","4131","116","4247","2024-12-30"
"61146","2024","COM","2022","384","6","390","2024-12-30"
"61148","2024","COM","2022","289","8","297","2024-12-30"
"61149","2024","COM","2022","328","10","338","2024-12-30"
"61150","2024","COM","2022","730","13","743","2024-12-30"
"61151","2024","COM","2022","376","7","383","2024-12-30"
"61152","2024","COM","2022","104","0","104","2024-12-30"
"61153","2024","COM","2022","2193","51","2244","2024-12-30"
"61156","2024","COM","2022","543","9","552","2024-12-30"
"61158","2024","COM","2022","132","3","135","2024-12-30"
"61159","2024","COM","2022","69","0","69","2024-12-30"
"61160","2024","COM","2022","191","3","194","2024-12-30"
"61162","2024","COM","2022","156","2","158","2024-12-30"
"61163","2024","COM","2022","1531","21","1552","2024-12-30"
"61164","2024","COM","2022","250","2","252","2024-12-30"
"61165","2024","COM","2022","706","19","725","2024-12-30"
"61166","2024","COM","2022","148","3","151","2024-12-30"
"61167","2024","COM","2022","2960","62","3022","2024-12-30"
"61168","2024","COM","2022","5095","296","5391","2024-12-30"
"61169","2024","COM","2022","14308","316","14624","2024-12-30"
"61170","2024","COM","2022","205","8","213","2024-12-30"
"61171","2024","COM","2022","115","2","117","2024-12-30"
"61176","2024","COM","2022","132","2","134","2024-12-30"
"61178","2024","COM","2022","51","1","52","2024-12-30"
"61180","2024","COM","2022","108","1","109","2024-12-30"
"61181","2024","COM","2022","1771","57","1828","2024-12-30"
"61182","2024","COM","2022","416","9","425","2024-12-30"
"61183","2024","COM","2022","144","2","146","2024-12-30"
"61187","2024","COM","2022","162","1","163","2024-12-30"
"61188","2024","COM","2022","91","2","93","2024-12-30"
"61189","2024","COM","2022","484","207","691","2024-12-30"
"61190","2024","COM","2022","72","0","72","2024-12-30"
"61192","2024","COM","2022","103","4","107","2024-12-30"
"61193","2024","COM","2022","274","3","277","2024-12-30"
"61194","2024","COM","2022","874","25","899","2024-12-30"
"61195","2024","COM","2022","206","1","207","2024-12-30"
"61196","2024","COM","2022","1486","39","1525","2024-12-30"
"61197","2024","COM","2022","146","4","150","2024-12-30"
"61198","2024","COM","2022","133","0","133","2024-12-30"
"61199","2024","COM","2022","335","9","344","2024-12-30"
"61202","2024","COM","2022","459","8","467","2024-12-30"
"61203","2024","COM","2022","887","23","910","2024-12-30"
"61206","2024","COM","2022","260","6","266","2024-12-30"
"61207","2024","COM","2022","589","12","601","2024-12-30"
"61208","2024","COM","2022","609","11","620","2024-12-30"
"61209","2024","COM","2022","386","7","393","2024-12-30"
"61210","2024","COM","2022","237","6","243","2024-12-30"
"61211","2024","COM","2022","2104","33","2137","2024-12-30"
"61212","2024","COM","2022","119","5","124","2024-12-30"
"61213","2024","COM","2022","266","10","276","2024-12-30"
"61214","2024","COM","2022","7771","230","8001","2024-12-30"
"61215","2024","COM","2022","361","4","365","2024-12-30"
"61216","2024","COM","2022","186","5","191","2024-12-30"
"61217","2024","COM","2022","57","1","58","2024-12-30"
"61218","2024","COM","2022","1752","43","1795","2024-12-30"
"61219","2024","COM","2022","163","2","165","2024-12-30"
"61221","2024","COM","2022","432","12","444","2024-12-30"
"61222","2024","COM","2022","772","21","793","2024-12-30"
"61224","2024","COM","2022","467","6","473","2024-12-30"
"61225","2024","COM","2022","29","0","29","2024-12-30"
"61227","2024","COM","2022","139","5","144","2024-12-30"
"61228","2024","COM","2022","730","11","741","2024-12-30"
"61229","2024","COM","2022","134","2","136","2024-12-30"
"61230","2024","COM","2022","2826","40","2866","2024-12-30"
"61232","2024","COM","2022","1118","27","1145","2024-12-30"
"61233","2024","COM","2022","229","5","234","2024-12-30"
"61234","2024","COM","2022","1084","35","1119","2024-12-30"
"61237","2024","COM","2022","314","0","314","2024-12-30"
"61238","2024","COM","2022","95","1","96","2024-12-30"
"61240","2024","COM","2022","443","9","452","2024-12-30"
"61241","2024","COM","2022","416","7","423","2024-12-30"
"61242","2024","COM","2022","217","9","226","2024-12-30"
"61243","2024","COM","2022","1386","33","1419","2024-12-30"
"61244","2024","COM","2022","275","6","281","2024-12-30"
"61248","2024","COM","2022","511","9","520","2024-12-30"
"61251","2024","COM","2022","157","2","159","2024-12-30"
"61252","2024","COM","2022","133","4","137","2024-12-30"
"61255","2024","COM","2022","524","12","536","2024-12-30"
"61256","2024","COM","2022","153","5","158","2024-12-30"
"61257","2024","COM","2022","121","2","123","2024-12-30"
"61258","2024","COM","2022","659","13","672","2024-12-30"
"61259","2024","COM","2022","68","0","68","2024-12-30"
"61260","2024","COM","2022","529","10","539","2024-12-30"
"61261","2024","COM","2022","176","3","179","2024-12-30"
"61262","2024","COM","2022","117","0","117","2024-12-30"
"61263","2024","COM","2022","195","6","201","2024-12-30"
"61264","2024","COM","2022","62","1","63","2024-12-30"
"61265","2024","COM","2022","157","2","159","2024-12-30"
"61266","2024","COM","2022","83","2","85","2024-12-30"
"61267","2024","COM","2022","201","3","204","2024-12-30"
"61268","2024","COM","2022","120","1","121","2024-12-30"
"61269","2024","COM","2022","487","9","496","2024-12-30"
"61271","2024","COM","2022","87","1","88","2024-12-30"
"61272","2024","COM","2022","26","0","26","2024-12-30"
"61273","2024","COM","2022","48","3","51","2024-12-30"
"61274","2024","COM","2022","241","4","245","2024-12-30"
"61275","2024","COM","2022","754","18","772","2024-12-30"
"61276","2024","COM","2022","151","3","154","2024-12-30"
"61277","2024","COM","2022","277","10","287","2024-12-30"
"61278","2024","COM","2022","1819","52","1871","2024-12-30"
"61279","2024","COM","2022","611","15","626","2024-12-30"
"61281","2024","COM","2022","265","5","270","2024-12-30"
"61283","2024","COM","2022","284","3","287","2024-12-30"
"61284","2024","COM","2022","233","2","235","2024-12-30"
"61286","2024","COM","2022","99","1","100","2024-12-30"
"61287","2024","COM","2022","719","16","735","2024-12-30"
"61288","2024","COM","2022","555","6","561","2024-12-30"
"61289","2024","COM","2022","49","3","52","2024-12-30"
"61290","2024","COM","2022","127","2","129","2024-12-30"
"61291","2024","COM","2022","80","2","82","2024-12-30"
"61292","2024","COM","2022","656","9","665","2024-12-30"
"61293","2024","COM","2022","3857","256","4113","2024-12-30"
"61294","2024","COM","2022","1125","23","1148","2024-12-30"
"61295","2024","COM","2022","159","0","159","2024-12-30"
"61297","2024","COM","2022","717","16","733","2024-12-30"
"61298","2024","COM","2022","309","11","320","2024-12-30"
"61300","2024","COM","2022","370","12","382","2024-12-30"
"61301","2024","COM","2022","214","1","215","2024-12-30"
"61302","2024","COM","2022","132","3","135","2024-12-30"
"61303","2024","COM","2022","526","14","540","2024-12-30"
"61304","2024","COM","2022","275","10","285","2024-12-30"
"61307","2024","COM","2022","237","3","240","2024-12-30"
"61308","2024","COM","2022","198","5","203","2024-12-30"
"61309","2024","COM","2022","1974","55","2029","2024-12-30"
"61310","2024","COM","2022","411","28","439","2024-12-30"
"61314","2024","COM","2022","673","17","690","2024-12-30"
"61316","2024","COM","2022","109","3","112","2024-12-30"
"61317","2024","COM","2022","182","2","184","2024-12-30"
"61319","2024","COM","2022","249","7","256","2024-12-30"
"61321","2024","COM","2022","411","7","418","2024-12-30"
"61322","2024","COM","2022","104","2","106","2024-12-30"
"61323","2024","COM","2022","128","4","132","2024-12-30"
"61324","2024","COM","2022","1159","16","1175","2024-12-30"
"61326","2024","COM","2022","325","5","330","2024-12-30"
"61327","2024","COM","2022","342","10","352","2024-12-30"
"61328","2024","COM","2022","253","3","256","2024-12-30"
"61329","2024","COM","2022","619","8","627","2024-12-30"
"61330","2024","COM","2022","181","3","184","2024-12-30"
"61331","2024","COM","2022","126","3","129","2024-12-30"
"61332","2024","COM","2022","305","29","334","2024-12-30"
"61333","2024","COM","2022","184","1","185","2024-12-30"
"61336","2024","COM","2022","103","1","104","2024-12-30"
"61339","2024","COM","2022","2115","32","2147","2024-12-30"
"61341","2024","COM","2022","1673","43","1716","2024-12-30"
"61342","2024","COM","2022","1437","20","1457","2024-12-30"
"61344","2024","COM","2022","1042","25","1067","2024-12-30"
"61345","2024","COM","2022","1892","36","1928","2024-12-30"
"61346","2024","COM","2022","203","2","205","2024-12-30"
"61347","2024","COM","2022","174","0","174","2024-12-30"
"61348","2024","COM","2022","356","8","364","2024-12-30"
"61349","2024","COM","2022","157","3","160","2024-12-30"
"61350","2024","COM","2022","162","5","167","2024-12-30"
"61351","2024","COM","2022","133","4","137","2024-12-30"
"61352","2024","COM","2022","180","3","183","2024-12-30"
"61357","2024","COM","2022","175","5","180","2024-12-30"
"61358","2024","COM","2022","227","5","232","2024-12-30"
"61360","2024","COM","2022","87","3","90","2024-12-30"
"61361","2024","COM","2022","175","4","179","2024-12-30"
"61362","2024","COM","2022","522","18","540","2024-12-30"
"61363","2024","COM","2022","54","1","55","2024-12-30"
"61365","2024","COM","2022","435","8","443","2024-12-30"
"61366","2024","COM","2022","131","2","133","2024-12-30"
"61367","2024","COM","2022","130","2","132","2024-12-30"
"61369","2024","COM","2022","1023","33","1056","2024-12-30"
"61370","2024","COM","2022","149","2","151","2024-12-30"
"61371","2024","COM","2022","139","3","142","2024-12-30"
"61372","2024","COM","2022","112","5","117","2024-12-30"
"61373","2024","COM","2022","249","6","255","2024-12-30"
"61374","2024","COM","2022","88","3","91","2024-12-30"
"61375","2024","COM","2022","1173","36","1209","2024-12-30"
"61376","2024","COM","2022","821","17","838","2024-12-30"
"61379","2024","COM","2022","234","4","238","2024-12-30"
"61381","2024","COM","2022","60","4","64","2024-12-30"
"61382","2024","COM","2022","1078","24","1102","2024-12-30"
"61384","2024","COM","2022","257","4","261","2024-12-30"
"61385","2024","COM","2022","359","6","365","2024-12-30"
"61386","2024","COM","2022","440","10","450","2024-12-30"
"61387","2024","COM","2022","542","9","551","2024-12-30"
"61388","2024","COM","2022","174","8","182","2024-12-30"
"61389","2024","COM","2022","1013","20","1033","2024-12-30"
"61390","2024","COM","2022","167","0","167","2024-12-30"
"61391","2024","COM","2022","3169","83","3252","2024-12-30"
"61392","2024","COM","2022","117","1","118","2024-12-30"
"61393","2024","COM","2022","132","3","135","2024-12-30"
"61394","2024","COM","2022","828","24","852","2024-12-30"
"61395","2024","COM","2022","204","3","207","2024-12-30"
"61396","2024","COM","2022","83","5","88","2024-12-30"
"61397","2024","COM","2022","3648","89","3737","2024-12-30"
"61398","2024","COM","2022","65","1","66","2024-12-30"
"61399","2024","COM","2022","71","2","73","2024-12-30"
"61400","2024","COM","2022","346","3","349","2024-12-30"
"61401","2024","COM","2022","106","4","110","2024-12-30"
"61402","2024","COM","2022","299","4","303","2024-12-30"
"61404","2024","COM","2022","668","12","680","2024-12-30"
"61405","2024","COM","2022","486","17","503","2024-12-30"
"61406","2024","COM","2022","291","4","295","2024-12-30"
"61407","2024","COM","2022","681","14","695","2024-12-30"
"61408","2024","COM","2022","348","7","355","2024-12-30"
"61411","2024","COM","2022","307","7","314","2024-12-30"
"61412","2024","COM","2022","679","11","690","2024-12-30"
"61413","2024","COM","2022","133","4","137","2024-12-30"
"61414","2024","COM","2022","871","20","891","2024-12-30"
"61415","2024","COM","2022","314","5","319","2024-12-30"
"61416","2024","COM","2022","76","1","77","2024-12-30"
"61418","2024","COM","2022","397","5","402","2024-12-30"
"61419","2024","COM","2022","211","6","217","2024-12-30"
"61420","2024","COM","2022","87","1","88","2024-12-30"
"61421","2024","COM","2022","640","18","658","2024-12-30"
"61422","2024","COM","2022","620","15","635","2024-12-30"
"61423","2024","COM","2022","630","27","657","2024-12-30"
"61424","2024","COM","2022","187","4","191","2024-12-30"
"61425","2024","COM","2022","121","3","124","2024-12-30"
"61426","2024","COM","2022","540","15","555","2024-12-30"
"61427","2024","COM","2022","186","3","189","2024-12-30"
"61429","2024","COM","2022","755","14","769","2024-12-30"
"61432","2024","COM","2022","576","20","596","2024-12-30"
"61433","2024","COM","2022","284","9","293","2024-12-30"
"61435","2024","COM","2022","266","5","271","2024-12-30"
"61436","2024","COM","2022","243","2","245","2024-12-30"
"61438","2024","COM","2022","159","7","166","2024-12-30"
"61439","2024","COM","2022","125","2","127","2024-12-30"
"61440","2024","COM","2022","827","32","859","2024-12-30"
"61442","2024","COM","2022","232","6","238","2024-12-30"
"61443","2024","COM","2022","652","12","664","2024-12-30"
"61444","2024","COM","2022","112","0","112","2024-12-30"
"61445","2024","COM","2022","659","13","672","2024-12-30"
"61446","2024","COM","2022","160","6","166","2024-12-30"
"61447","2024","COM","2022","1335","30","1365","2024-12-30"
"61448","2024","COM","2022","428","8","436","2024-12-30"
"61450","2024","COM","2022","77","1","78","2024-12-30"
"61451","2024","COM","2022","317","6","323","2024-12-30"
"61452","2024","COM","2022","150","5","155","2024-12-30"
"61453","2024","COM","2022","239","3","242","2024-12-30"
"61454","2024","COM","2022","584","11","595","2024-12-30"
"61456","2024","COM","2022","1587","35","1622","2024-12-30"
"61457","2024","COM","2022","483","9","492","2024-12-30"
"61459","2024","COM","2022","296","5","301","2024-12-30"
"61460","2024","COM","2022","942","12","954","2024-12-30"
"61461","2024","COM","2022","125","2","127","2024-12-30"
"61462","2024","COM","2022","1047","33","1080","2024-12-30"
"61463","2024","COM","2022","1727","34","1761","2024-12-30"
"61464","2024","COM","2022","4182","434","4616","2024-12-30"
"61466","2024","COM","2022","1396","32","1428","2024-12-30"
"61467","2024","COM","2022","364","5","369","2024-12-30"
"61472","2024","COM","2022","309","12","321","2024-12-30"
"61473","2024","COM","2022","285","8","293","2024-12-30"
"61474","2024","COM","2022","3644","80","3724","2024-12-30"
"61475","2024","COM","2022","633","11","644","2024-12-30"
"61476","2024","COM","2022","278","6","284","2024-12-30"
"61479","2024","COM","2022","157","4","161","2024-12-30"
"61480","2024","COM","2022","228","6","234","2024-12-30"
"61481","2024","COM","2022","72","1","73","2024-12-30"
"61482","2024","COM","2022","377","9","386","2024-12-30"
"61483","2024","COM","2022","2698","46","2744","2024-12-30"
"61484","2024","COM","2022","3324","70","3394","2024-12-30"
"61485","2024","COM","2022","195","2","197","2024-12-30"
"61486","2024","COM","2022","4850","63","4913","2024-12-30"
"61487","2024","COM","2022","300","4","304","2024-12-30"
"61488","2024","COM","2022","75","2","77","2024-12-30"
"61490","2024","COM","2022","295","4","299","2024-12-30"
"61491","2024","COM","2022","2989","36","3025","2024-12-30"
"61492","2024","COM","2022","121","3","124","2024-12-30"
"61493","2024","COM","2022","64","3","67","2024-12-30"
"61494","2024","COM","2022","1183","61","1244","2024-12-30"
"61497","2024","COM","2022","1699","31","1730","2024-12-30"
"61498","2024","COM","2022","95","4","99","2024-12-30"
"61499","2024","COM","2022","146","4","150","2024-12-30"
"61500","2024","COM","2022","122","3","125","2024-12-30"
"61501","2024","COM","2022","420","8","428","2024-12-30"
"61502","2024","COM","2022","73","2","75","2024-12-30"
"61503","2024","COM","2022","200","1","201","2024-12-30"
"61505","2024","COM","2022","207","4","211","2024-12-30"
"61507","2024","COM","2022","241","6","247","2024-12-30"
"61508","2024","COM","2022","3041","91","3132","2024-12-30"
"61510","2024","COM","2022","213","6","219","2024-12-30"
"61512","2024","COM","2022","100","2","102","2024-12-30"
"62001","2024","COM","2022","1966","39","2005","2024-12-30"
"62002","2024","COM","2022","220","3","223","2024-12-30"
"62003","2024","COM","2022","579","23","602","2024-12-30"
"62004","2024","COM","2022","7899","117","8016","2024-12-30"
"62005","2024","COM","2022","969","13","982","2024-12-30"
"62006","2024","COM","2022","311","5","316","2024-12-30"
"62007","2024","COM","2022","790","12","802","2024-12-30"
"62008","2024","COM","2022","799","11","810","2024-12-30"
"62009","2024","COM","2022","283","7","290","2024-12-30"
"62010","2024","COM","2022","255","6","261","2024-12-30"
"62011","2024","COM","2022","635","18","653","2024-12-30"
"62012","2024","COM","2022","255","4","259","2024-12-30"
"62013","2024","COM","2022","1863","34","1897","2024-12-30"
"62014","2024","COM","2022","9568","260","9828","2024-12-30"
"62015","2024","COM","2022","259","6","265","2024-12-30"
"62016","2024","COM","2022","189","4","193","2024-12-30"
"62017","2024","COM","2022","201","1","202","2024-12-30"
"62018","2024","COM","2022","267","7","274","2024-12-30"
"62019","2024","COM","2022","3915","43","3958","2024-12-30"
"62020","2024","COM","2022","626","11","637","2024-12-30"
"62021","2024","COM","2022","372","7","379","2024-12-30"
"62022","2024","COM","2022","296","10","306","2024-12-30"
"62023","2024","COM","2022","2837","36","2873","2024-12-30"
"62024","2024","COM","2022","985","13","998","2024-12-30"
"62025","2024","COM","2022","2010","35","2045","2024-12-30"
"62026","2024","COM","2022","119","9","128","2024-12-30"
"62027","2024","COM","2022","212","0","212","2024-12-30"
"62028","2024","COM","2022","660","8","668","2024-12-30"
"62029","2024","COM","2022","466","2","468","2024-12-30"
"62030","2024","COM","2022","303","4","307","2024-12-30"
"62031","2024","COM","2022","1534","23","1557","2024-12-30"
"62032","2024","COM","2022","4719","45","4764","2024-12-30"
"62033","2024","COM","2022","4544","36","4580","2024-12-30"
"62034","2024","COM","2022","2147","12","2159","2024-12-30"
"62035","2024","COM","2022","5819","58","5877","2024-12-30"
"62036","2024","COM","2022","709","13","722","2024-12-30"
"62037","2024","COM","2022","2833","75","2908","2024-12-30"
"62038","2024","COM","2022","4393","50","4443","2024-12-30"
"62039","2024","COM","2022","933","21","954","2024-12-30"
"62040","2024","COM","2022","9526","118","9644","2024-12-30"
"62041","2024","COM","2022","42621","875","43496","2024-12-30"
"62042","2024","COM","2022","1049","17","1066","2024-12-30"
"62043","2024","COM","2022","2065","20","2085","2024-12-30"
"62044","2024","COM","2022","864","7","871","2024-12-30"
"62045","2024","COM","2022","1484","18","1502","2024-12-30"
"62046","2024","COM","2022","735","6","741","2024-12-30"
"62047","2024","COM","2022","142","2","144","2024-12-30"
"62048","2024","COM","2022","10124","48","10172","2024-12-30"
"62049","2024","COM","2022","549","1","550","2024-12-30"
"62050","2024","COM","2022","1517","15","1532","2024-12-30"
"62051","2024","COM","2022","4642","33","4675","2024-12-30"
"62052","2024","COM","2022","435","13","448","2024-12-30"
"62053","2024","COM","2022","680","6","686","2024-12-30"
"62054","2024","COM","2022","623","9","632","2024-12-30"
"62055","2024","COM","2022","522","9","531","2024-12-30"
"62056","2024","COM","2022","616","7","623","2024-12-30"
"62057","2024","COM","2022","5349","57","5406","2024-12-30"
"62058","2024","COM","2022","194","4","198","2024-12-30"
"62059","2024","COM","2022","291","14","305","2024-12-30"
"62060","2024","COM","2022","2549","30","2579","2024-12-30"
"62061","2024","COM","2022","293","1","294","2024-12-30"
"62062","2024","COM","2022","49","0","49","2024-12-30"
"62063","2024","COM","2022","1817","15","1832","2024-12-30"
"62064","2024","COM","2022","170","2","172","2024-12-30"
"62065","2024","COM","2022","17571","120","17691","2024-12-30"
"62066","2024","COM","2022","33","2","35","2024-12-30"
"62067","2024","COM","2022","541","7","548","2024-12-30"
"62068","2024","COM","2022","328","7","335","2024-12-30"
"62069","2024","COM","2022","304","8","312","2024-12-30"
"62070","2024","COM","2022","267","6","273","2024-12-30"
"62071","2024","COM","2022","409","9","418","2024-12-30"
"62072","2024","COM","2022","216","3","219","2024-12-30"
"62073","2024","COM","2022","1432","25","1457","2024-12-30"
"62074","2024","COM","2022","233","5","238","2024-12-30"
"62075","2024","COM","2022","1321","34","1355","2024-12-30"
"62076","2024","COM","2022","214","1","215","2024-12-30"
"62077","2024","COM","2022","358","11","369","2024-12-30"
"62078","2024","COM","2022","1225","22","1247","2024-12-30"
"62079","2024","COM","2022","84","1","85","2024-12-30"
"62080","2024","COM","2022","3718","321","4039","2024-12-30"
"62081","2024","COM","2022","435","8","443","2024-12-30"
"62082","2024","COM","2022","314","5","319","2024-12-30"
"62083","2024","COM","2022","7330","43","7373","2024-12-30"
"62084","2024","COM","2022","203","7","210","2024-12-30"
"62085","2024","COM","2022","131","4","135","2024-12-30"
"62086","2024","COM","2022","419","6","425","2024-12-30"
"62087","2024","COM","2022","1019","24","1043","2024-12-30"
"62088","2024","COM","2022","345","3","348","2024-12-30"
"62089","2024","COM","2022","408","9","417","2024-12-30"
"62090","2024","COM","2022","133","0","133","2024-12-30"
"62091","2024","COM","2022","98","2","100","2024-12-30"
"62092","2024","COM","2022","404","4","408","2024-12-30"
"62093","2024","COM","2022","232","6","238","2024-12-30"
"62094","2024","COM","2022","384","9","393","2024-12-30"
"62095","2024","COM","2022","228","2","230","2024-12-30"
"62096","2024","COM","2022","536","9","545","2024-12-30"
"62097","2024","COM","2022","1000","12","1012","2024-12-30"
"62099","2024","COM","2022","5530","63","5593","2024-12-30"
"62100","2024","COM","2022","2028","28","2056","2024-12-30"
"62101","2024","COM","2022","133","2","135","2024-12-30"
"62102","2024","COM","2022","281","3","284","2024-12-30"
"62103","2024","COM","2022","121","1","122","2024-12-30"
"62104","2024","COM","2022","429","7","436","2024-12-30"
"62105","2024","COM","2022","524","12","536","2024-12-30"
"62106","2024","COM","2022","213","1","214","2024-12-30"
"62107","2024","COM","2022","337","8","345","2024-12-30"
"62108","2024","COM","2022","12967","318","13285","2024-12-30"
"62109","2024","COM","2022","215","1","216","2024-12-30"
"62111","2024","COM","2022","273","79","352","2024-12-30"
"62112","2024","COM","2022","538","7","545","2024-12-30"
"62113","2024","COM","2022","487","13","500","2024-12-30"
"62114","2024","COM","2022","167","3","170","2024-12-30"
"62115","2024","COM","2022","475","10","485","2024-12-30"
"62116","2024","COM","2022","165","2","167","2024-12-30"
"62117","2024","COM","2022","918","12","930","2024-12-30"
"62118","2024","COM","2022","150","4","154","2024-12-30"
"62119","2024","COM","2022","25342","337","25679","2024-12-30"
"62120","2024","COM","2022","465","8","473","2024-12-30"
"62121","2024","COM","2022","181","5","186","2024-12-30"
"62122","2024","COM","2022","353","4","357","2024-12-30"
"62123","2024","COM","2022","551","4","555","2024-12-30"
"62124","2024","COM","2022","434","5","439","2024-12-30"
"62125","2024","COM","2022","459","12","471","2024-12-30"
"62126","2024","COM","2022","9078","157","9235","2024-12-30"
"62127","2024","COM","2022","374","12","386","2024-12-30"
"62128","2024","COM","2022","4519","46","4565","2024-12-30"
"62129","2024","COM","2022","94","0","94","2024-12-30"
"62130","2024","COM","2022","665","3","668","2024-12-30"
"62131","2024","COM","2022","310","6","316","2024-12-30"
"62132","2024","COM","2022","5076","50","5126","2024-12-30"
"62133","2024","COM","2022","8027","42","8069","2024-12-30"
"62134","2024","COM","2022","103","2","105","2024-12-30"
"62135","2024","COM","2022","306","2","308","2024-12-30"
"62137","2024","COM","2022","93","2","95","2024-12-30"
"62138","2024","COM","2022","700","13","713","2024-12-30"
"62139","2024","COM","2022","4891","219","5110","2024-12-30"
"62140","2024","COM","2022","485","6","491","2024-12-30"
"62141","2024","COM","2022","904","18","922","2024-12-30"
"62142","2024","COM","2022","159","6","165","2024-12-30"
"62143","2024","COM","2022","47","0","47","2024-12-30"
"62144","2024","COM","2022","473","10","483","2024-12-30"
"62145","2024","COM","2022","443","2","445","2024-12-30"
"62146","2024","COM","2022","258","2","260","2024-12-30"
"62147","2024","COM","2022","386","4","390","2024-12-30"
"62148","2024","COM","2022","833","8","841","2024-12-30"
"62149","2024","COM","2022","255","4","259","2024-12-30"
"62150","2024","COM","2022","513","12","525","2024-12-30"
"62151","2024","COM","2022","522","10","532","2024-12-30"
"62152","2024","COM","2022","256","2","258","2024-12-30"
"62153","2024","COM","2022","628","15","643","2024-12-30"
"62154","2024","COM","2022","667","10","677","2024-12-30"
"62155","2024","COM","2022","620","14","634","2024-12-30"
"62156","2024","COM","2022","598","19","617","2024-12-30"
"62157","2024","COM","2022","70","2","72","2024-12-30"
"62158","2024","COM","2022","577","6","583","2024-12-30"
"62160","2024","COM","2022","41039","400","41439","2024-12-30"
"62161","2024","COM","2022","794","6","800","2024-12-30"
"62162","2024","COM","2022","575","7","582","2024-12-30"
"62163","2024","COM","2022","245","3","248","2024-12-30"
"62164","2024","COM","2022","1148","16","1164","2024-12-30"
"62165","2024","COM","2022","226","4","230","2024-12-30"
"62166","2024","COM","2022","588","10","598","2024-12-30"
"62167","2024","COM","2022","242","10","252","2024-12-30"
"62168","2024","COM","2022","851","20","871","2024-12-30"
"62169","2024","COM","2022","255","6","261","2024-12-30"
"62170","2024","COM","2022","2385","82","2467","2024-12-30"
"62171","2024","COM","2022","138","1","139","2024-12-30"
"62172","2024","COM","2022","366","5","371","2024-12-30"
"62173","2024","COM","2022","5210","73","5283","2024-12-30"
"62174","2024","COM","2022","1311","12","1323","2024-12-30"
"62175","2024","COM","2022","157","4","161","2024-12-30"
"62176","2024","COM","2022","639","18","657","2024-12-30"
"62177","2024","COM","2022","872","17","889","2024-12-30"
"62178","2024","COM","2022","21997","354","22351","2024-12-30"
"62179","2024","COM","2022","394","7","401","2024-12-30"
"62180","2024","COM","2022","297","6","303","2024-12-30"
"62181","2024","COM","2022","1506","119","1625","2024-12-30"
"62182","2024","COM","2022","238","3","241","2024-12-30"
"62183","2024","COM","2022","752","3","755","2024-12-30"
"62184","2024","COM","2022","287","3","290","2024-12-30"
"62185","2024","COM","2022","227","2","229","2024-12-30"
"62186","2024","COM","2022","12172","85","12257","2024-12-30"
"62187","2024","COM","2022","177","3","180","2024-12-30"
"62188","2024","COM","2022","2827","20","2847","2024-12-30"
"62189","2024","COM","2022","134","1","135","2024-12-30"
"62190","2024","COM","2022","1242","18","1260","2024-12-30"
"62191","2024","COM","2022","726","3","729","2024-12-30"
"62192","2024","COM","2022","422","12","434","2024-12-30"
"62193","2024","COM","2022","67585","646","68231","2024-12-30"
"62194","2024","COM","2022","5416","28","5444","2024-12-30"
"62195","2024","COM","2022","1578","25","1603","2024-12-30"
"62196","2024","COM","2022","586","11","597","2024-12-30"
"62197","2024","COM","2022","1766","15","1781","2024-12-30"
"62198","2024","COM","2022","347","10","357","2024-12-30"
"62199","2024","COM","2022","681","121","802","2024-12-30"
"62200","2024","COM","2022","1250","15","1265","2024-12-30"
"62201","2024","COM","2022","2633","33","2666","2024-12-30"
"62202","2024","COM","2022","675","117","792","2024-12-30"
"62203","2024","COM","2022","414","5","419","2024-12-30"
"62204","2024","COM","2022","1944","32","1976","2024-12-30"
"62205","2024","COM","2022","1300","27","1327","2024-12-30"
"62206","2024","COM","2022","289","16","305","2024-12-30"
"62207","2024","COM","2022","529","13","542","2024-12-30"
"62208","2024","COM","2022","68","1","69","2024-12-30"
"62209","2024","COM","2022","163","5","168","2024-12-30"
"62211","2024","COM","2022","221","2","223","2024-12-30"
"62212","2024","COM","2022","491","19","510","2024-12-30"
"62213","2024","COM","2022","820","11","831","2024-12-30"
"62214","2024","COM","2022","633","12","645","2024-12-30"
"62215","2024","COM","2022","17966","96","18062","2024-12-30"
"62216","2024","COM","2022","210","4","214","2024-12-30"
"62217","2024","COM","2022","2645","25","2670","2024-12-30"
"62218","2024","COM","2022","332","4","336","2024-12-30"
"62219","2024","COM","2022","153","2","155","2024-12-30"
"62220","2024","COM","2022","432","6","438","2024-12-30"
"62221","2024","COM","2022","244","5","249","2024-12-30"
"62222","2024","COM","2022","169","0","169","2024-12-30"
"62223","2024","COM","2022","291","5","296","2024-12-30"
"62224","2024","COM","2022","2808","27","2835","2024-12-30"
"62225","2024","COM","2022","579","10","589","2024-12-30"
"62227","2024","COM","2022","185","2","187","2024-12-30"
"62228","2024","COM","2022","314","4","318","2024-12-30"
"62229","2024","COM","2022","809","17","826","2024-12-30"
"62230","2024","COM","2022","907","16","923","2024-12-30"
"62231","2024","COM","2022","129","1","130","2024-12-30"
"62232","2024","COM","2022","884","16","900","2024-12-30"
"62233","2024","COM","2022","1087","14","1101","2024-12-30"
"62234","2024","COM","2022","222","4","226","2024-12-30"
"62235","2024","COM","2022","2456","69","2525","2024-12-30"
"62236","2024","COM","2022","349","5","354","2024-12-30"
"62237","2024","COM","2022","531","11","542","2024-12-30"
"62238","2024","COM","2022","81","1","82","2024-12-30"
"62239","2024","COM","2022","2625","34","2659","2024-12-30"
"62240","2024","COM","2022","2268","14","2282","2024-12-30"
"62241","2024","COM","2022","309","7","316","2024-12-30"
"62242","2024","COM","2022","79","4","83","2024-12-30"
"62243","2024","COM","2022","116","2","118","2024-12-30"
"62244","2024","COM","2022","5403","209","5612","2024-12-30"
"62245","2024","COM","2022","771","7","778","2024-12-30"
"62246","2024","COM","2022","146","2","148","2024-12-30"
"62247","2024","COM","2022","567","6","573","2024-12-30"
"62248","2024","COM","2022","479","6","485","2024-12-30"
"62249","2024","COM","2022","8015","30","8045","2024-12-30"
"62250","2024","COM","2022","10160","81","10241","2024-12-30"
"62251","2024","COM","2022","509","189","698","2024-12-30"
"62252","2024","COM","2022","2608","68","2676","2024-12-30"
"62253","2024","COM","2022","76","0","76","2024-12-30"
"62254","2024","COM","2022","598","8","606","2024-12-30"
"62255","2024","COM","2022","802","15","817","2024-12-30"
"62256","2024","COM","2022","158","2","160","2024-12-30"
"62257","2024","COM","2022","463","10","473","2024-12-30"
"62258","2024","COM","2022","300","7","307","2024-12-30"
"62259","2024","COM","2022","1929","25","1954","2024-12-30"
"62260","2024","COM","2022","332","8","340","2024-12-30"
"62261","2024","COM","2022","5165","82","5247","2024-12-30"
"62262","2024","COM","2022","1784","23","1807","2024-12-30"
"62263","2024","COM","2022","5718","92","5810","2024-12-30"
"62264","2024","COM","2022","1317","10","1327","2024-12-30"
"62265","2024","COM","2022","1146","22","1168","2024-12-30"
"62266","2024","COM","2022","93","2","95","2024-12-30"
"62267","2024","COM","2022","394","2","396","2024-12-30"
"62268","2024","COM","2022","4827","34","4861","2024-12-30"
"62269","2024","COM","2022","715","12","727","2024-12-30"
"62270","2024","COM","2022","6830","40","6870","2024-12-30"
"62271","2024","COM","2022","830","11","841","2024-12-30"
"62272","2024","COM","2022","295","1","296","2024-12-30"
"62273","2024","COM","2022","605","16","621","2024-12-30"
"62274","2024","COM","2022","6068","26","6094","2024-12-30"
"62275","2024","COM","2022","291","7","298","2024-12-30"
"62276","2024","COM","2022","5799","50","5849","2024-12-30"
"62277","2024","COM","2022","2952","15","2967","2024-12-30"
"62278","2024","COM","2022","610","20","630","2024-12-30"
"62279","2024","COM","2022","1393","23","1416","2024-12-30"
"62280","2024","COM","2022","306","2","308","2024-12-30"
"62281","2024","COM","2022","377","9","386","2024-12-30"
"62282","2024","COM","2022","180","0","180","2024-12-30"
"62283","2024","COM","2022","126","1","127","2024-12-30"
"62284","2024","COM","2022","1692","19","1711","2024-12-30"
"62285","2024","COM","2022","484","8","492","2024-12-30"
"62286","2024","COM","2022","510","4","514","2024-12-30"
"62288","2024","COM","2022","2176","44","2220","2024-12-30"
"62289","2024","COM","2022","686","17","703","2024-12-30"
"62290","2024","COM","2022","374","12","386","2024-12-30"
"62291","2024","COM","2022","2815","35","2850","2024-12-30"
"62292","2024","COM","2022","847","9","856","2024-12-30"
"62293","2024","COM","2022","235","4","239","2024-12-30"
"62295","2024","COM","2022","1600","24","1624","2024-12-30"
"62296","2024","COM","2022","243","8","251","2024-12-30"
"62297","2024","COM","2022","3740","52","3792","2024-12-30"
"62298","2024","COM","2022","509","12","521","2024-12-30"
"62299","2024","COM","2022","242","7","249","2024-12-30"
"62300","2024","COM","2022","2596","33","2629","2024-12-30"
"62301","2024","COM","2022","77","2","79","2024-12-30"
"62302","2024","COM","2022","232","3","235","2024-12-30"
"62303","2024","COM","2022","220","3","223","2024-12-30"
"62304","2024","COM","2022","337","2","339","2024-12-30"
"62306","2024","COM","2022","389","4","393","2024-12-30"
"62307","2024","COM","2022","218","9","227","2024-12-30"
"62308","2024","COM","2022","475","4","479","2024-12-30"
"62309","2024","COM","2022","1607","22","1629","2024-12-30"
"62310","2024","COM","2022","1765","19","1784","2024-12-30"
"62311","2024","COM","2022","2002","16","2018","2024-12-30"
"62312","2024","COM","2022","296","5","301","2024-12-30"
"62313","2024","COM","2022","906","6","912","2024-12-30"
"62314","2024","COM","2022","353","2","355","2024-12-30"
"62315","2024","COM","2022","343","11","354","2024-12-30"
"62316","2024","COM","2022","218","6","224","2024-12-30"
"62317","2024","COM","2022","465","6","471","2024-12-30"
"62318","2024","COM","2022","10693","102","10795","2024-12-30"
"62319","2024","COM","2022","254","7","261","2024-12-30"
"62320","2024","COM","2022","326","6","332","2024-12-30"
"62321","2024","COM","2022","4657","22","4679","2024-12-30"
"62322","2024","COM","2022","111","1","112","2024-12-30"
"62323","2024","COM","2022","1243","15","1258","2024-12-30"
"62324","2024","COM","2022","631","12","643","2024-12-30"
"62325","2024","COM","2022","942","18","960","2024-12-30"
"62326","2024","COM","2022","237","2","239","2024-12-30"
"62327","2024","COM","2022","612","3","615","2024-12-30"
"62328","2024","COM","2022","868","7","875","2024-12-30"
"62329","2024","COM","2022","1788","22","1810","2024-12-30"
"62330","2024","COM","2022","1253","22","1275","2024-12-30"
"62331","2024","COM","2022","1003","10","1013","2024-12-30"
"62332","2024","COM","2022","497","10","507","2024-12-30"
"62333","2024","COM","2022","372","3","375","2024-12-30"
"62334","2024","COM","2022","849","17","866","2024-12-30"
"62335","2024","COM","2022","512","7","519","2024-12-30"
"62336","2024","COM","2022","473","7","480","2024-12-30"
"62337","2024","COM","2022","217","4","221","2024-12-30"
"62338","2024","COM","2022","2944","53","2997","2024-12-30"
"62339","2024","COM","2022","106","1","107","2024-12-30"
"62340","2024","COM","2022","883","7","890","2024-12-30"
"62341","2024","COM","2022","393","7","400","2024-12-30"
"62342","2024","COM","2022","103","1","104","2024-12-30"
"62343","2024","COM","2022","259","1","260","2024-12-30"
"62344","2024","COM","2022","107","2","109","2024-12-30"
"62345","2024","COM","2022","94","1","95","2024-12-30"
"62346","2024","COM","2022","215","4","219","2024-12-30"
"62347","2024","COM","2022","126","4","130","2024-12-30"
"62348","2024","COM","2022","147","2","149","2024-12-30"
"62349","2024","COM","2022","1630","24","1654","2024-12-30"
"62350","2024","COM","2022","1111","19","1130","2024-12-30"
"62351","2024","COM","2022","6134","32","6166","2024-12-30"
"62352","2024","COM","2022","115","3","118","2024-12-30"
"62353","2024","COM","2022","239","3","242","2024-12-30"
"62354","2024","COM","2022","899","10","909","2024-12-30"
"62355","2024","COM","2022","604","5","609","2024-12-30"
"62356","2024","COM","2022","808","7","815","2024-12-30"
"62357","2024","COM","2022","65","1","66","2024-12-30"
"62358","2024","COM","2022","234","6","240","2024-12-30"
"62359","2024","COM","2022","580","12","592","2024-12-30"
"62360","2024","COM","2022","1393","14","1407","2024-12-30"
"62361","2024","COM","2022","3288","46","3334","2024-12-30"
"62362","2024","COM","2022","239","3","242","2024-12-30"
"62363","2024","COM","2022","393","5","398","2024-12-30"
"62364","2024","COM","2022","2349","216","2565","2024-12-30"
"62365","2024","COM","2022","203","1","204","2024-12-30"
"62366","2024","COM","2022","300","7","307","2024-12-30"
"62367","2024","COM","2022","781","8","789","2024-12-30"
"62368","2024","COM","2022","213","0","213","2024-12-30"
"62369","2024","COM","2022","785","9","794","2024-12-30"
"62370","2024","COM","2022","123","1","124","2024-12-30"
"62371","2024","COM","2022","2049","37","2086","2024-12-30"
"62372","2024","COM","2022","152","4","156","2024-12-30"
"62373","2024","COM","2022","989","10","999","2024-12-30"
"62374","2024","COM","2022","152","1","153","2024-12-30"
"62375","2024","COM","2022","87","1","88","2024-12-30"
"62376","2024","COM","2022","2532","38","2570","2024-12-30"
"62377","2024","COM","2022","946","7","953","2024-12-30"
"62378","2024","COM","2022","197","1","198","2024-12-30"
"62379","2024","COM","2022","326","8","334","2024-12-30"
"62380","2024","COM","2022","357","9","366","2024-12-30"
"62381","2024","COM","2022","128","1","129","2024-12-30"
"62382","2024","COM","2022","661","13","674","2024-12-30"
"62383","2024","COM","2022","1394","15","1409","2024-12-30"
"62384","2024","COM","2022","644","6","650","2024-12-30"
"62385","2024","COM","2022","380","4","384","2024-12-30"
"62386","2024","COM","2022","6674","26","6700","2024-12-30"
"62387","2024","COM","2022","354","7","361","2024-12-30"
"62388","2024","COM","2022","292","3","295","2024-12-30"
"62389","2024","COM","2022","30","0","30","2024-12-30"
"62390","2024","COM","2022","1478","40","1518","2024-12-30"
"62391","2024","COM","2022","1375","24","1399","2024-12-30"
"62392","2024","COM","2022","410","10","420","2024-12-30"
"62393","2024","COM","2022","1092","19","1111","2024-12-30"
"62395","2024","COM","2022","143","1","144","2024-12-30"
"62396","2024","COM","2022","14","1","15","2024-12-30"
"62397","2024","COM","2022","5508","75","5583","2024-12-30"
"62398","2024","COM","2022","273","12","285","2024-12-30"
"62399","2024","COM","2022","656","15","671","2024-12-30"
"62400","2024","COM","2022","4974","32","5006","2024-12-30"
"62401","2024","COM","2022","4411","28","4439","2024-12-30"
"62402","2024","COM","2022","309","6","315","2024-12-30"
"62403","2024","COM","2022","1202","14","1216","2024-12-30"
"62404","2024","COM","2022","196","2","198","2024-12-30"
"62405","2024","COM","2022","458","10","468","2024-12-30"
"62406","2024","COM","2022","262","9","271","2024-12-30"
"62407","2024","COM","2022","947","13","960","2024-12-30"
"62408","2024","COM","2022","1428","19","1447","2024-12-30"
"62409","2024","COM","2022","200","4","204","2024-12-30"
"62410","2024","COM","2022","191","2","193","2024-12-30"
"62411","2024","COM","2022","52","1","53","2024-12-30"
"62412","2024","COM","2022","1245","12","1257","2024-12-30"
"62413","2024","COM","2022","12264","77","12341","2024-12-30"
"62414","2024","COM","2022","203","2","205","2024-12-30"
"62415","2024","COM","2022","462","10","472","2024-12-30"
"62416","2024","COM","2022","215","6","221","2024-12-30"
"62418","2024","COM","2022","306","9","315","2024-12-30"
"62419","2024","COM","2022","185","1","186","2024-12-30"
"62421","2024","COM","2022","357","4","361","2024-12-30"
"62422","2024","COM","2022","522","5","527","2024-12-30"
"62423","2024","COM","2022","1728","28","1756","2024-12-30"
"62424","2024","COM","2022","297","3","300","2024-12-30"
"62425","2024","COM","2022","142","4","146","2024-12-30"
"62426","2024","COM","2022","188","2","190","2024-12-30"
"62427","2024","COM","2022","25764","326","26090","2024-12-30"
"62428","2024","COM","2022","528","7","535","2024-12-30"
"62429","2024","COM","2022","274","4","278","2024-12-30"
"62430","2024","COM","2022","151","1","152","2024-12-30"
"62432","2024","COM","2022","423","9","432","2024-12-30"
"62433","2024","COM","2022","79","7","86","2024-12-30"
"62434","2024","COM","2022","136","2","138","2024-12-30"
"62435","2024","COM","2022","106","0","106","2024-12-30"
"62436","2024","COM","2022","161","3","164","2024-12-30"
"62437","2024","COM","2022","319","3","322","2024-12-30"
"62438","2024","COM","2022","532","8","540","2024-12-30"
"62439","2024","COM","2022","406","8","414","2024-12-30"
"62440","2024","COM","2022","1076","22","1098","2024-12-30"
"62441","2024","COM","2022","207","5","212","2024-12-30"
"62442","2024","COM","2022","513","11","524","2024-12-30"
"62443","2024","COM","2022","6098","44","6142","2024-12-30"
"62444","2024","COM","2022","220","6","226","2024-12-30"
"62445","2024","COM","2022","842","18","860","2024-12-30"
"62446","2024","COM","2022","835","30","865","2024-12-30"
"62447","2024","COM","2022","2225","14","2239","2024-12-30"
"62448","2024","COM","2022","1870","29","1899","2024-12-30"
"62449","2024","COM","2022","164","4","168","2024-12-30"
"62450","2024","COM","2022","219","6","225","2024-12-30"
"62451","2024","COM","2022","485","10","495","2024-12-30"
"62452","2024","COM","2022","1389","37","1426","2024-12-30"
"62453","2024","COM","2022","127","3","130","2024-12-30"
"62454","2024","COM","2022","2450","50","2500","2024-12-30"
"62455","2024","COM","2022","116","0","116","2024-12-30"
"62456","2024","COM","2022","735","7","742","2024-12-30"
"62457","2024","COM","2022","6990","56","7046","2024-12-30"
"62458","2024","COM","2022","1131","21","1152","2024-12-30"
"62459","2024","COM","2022","244","6","250","2024-12-30"
"62460","2024","COM","2022","267","5","272","2024-12-30"
"62461","2024","COM","2022","840","8","848","2024-12-30"
"62462","2024","COM","2022","155","5","160","2024-12-30"
"62463","2024","COM","2022","490","56","546","2024-12-30"
"62464","2024","COM","2022","3377","18","3395","2024-12-30"
"62465","2024","COM","2022","219","6","225","2024-12-30"
"62466","2024","COM","2022","251","1","252","2024-12-30"
"62467","2024","COM","2022","179","1","180","2024-12-30"
"62468","2024","COM","2022","207","1","208","2024-12-30"
"62469","2024","COM","2022","576","6","582","2024-12-30"
"62470","2024","COM","2022","90","0","90","2024-12-30"
"62471","2024","COM","2022","1075","19","1094","2024-12-30"
"62472","2024","COM","2022","157","5","162","2024-12-30"
"62473","2024","COM","2022","8653","99","8752","2024-12-30"
"62474","2024","COM","2022","1141","22","1163","2024-12-30"
"62475","2024","COM","2022","240","3","243","2024-12-30"
"62476","2024","COM","2022","1049","16","1065","2024-12-30"
"62477","2024","COM","2022","740","18","758","2024-12-30"
"62478","2024","COM","2022","306","3","309","2024-12-30"
"62479","2024","COM","2022","1651","13","1664","2024-12-30"
"62480","2024","COM","2022","2876","31","2907","2024-12-30"
"62481","2024","COM","2022","143","3","146","2024-12-30"
"62483","2024","COM","2022","249","6","255","2024-12-30"
"62484","2024","COM","2022","309","6","315","2024-12-30"
"62485","2024","COM","2022","368","3","371","2024-12-30"
"62486","2024","COM","2022","1066","9","1075","2024-12-30"
"62487","2024","COM","2022","1242","22","1264","2024-12-30"
"62488","2024","COM","2022","792","11","803","2024-12-30"
"62489","2024","COM","2022","3500","37","3537","2024-12-30"
"62490","2024","COM","2022","318","2","320","2024-12-30"
"62491","2024","COM","2022","5007","92","5099","2024-12-30"
"62492","2024","COM","2022","232","3","235","2024-12-30"
"62493","2024","COM","2022","232","5","237","2024-12-30"
"62494","2024","COM","2022","45","0","45","2024-12-30"
"62495","2024","COM","2022","317","6","323","2024-12-30"
"62496","2024","COM","2022","222","6","228","2024-12-30"
"62497","2024","COM","2022","7120","67","7187","2024-12-30"
"62498","2024","COM","2022","32697","202","32899","2024-12-30"
"62499","2024","COM","2022","289","7","296","2024-12-30"
"62500","2024","COM","2022","401","6","407","2024-12-30"
"62501","2024","COM","2022","243","4","247","2024-12-30"
"62502","2024","COM","2022","5041","85","5126","2024-12-30"
"62503","2024","COM","2022","294","12","306","2024-12-30"
"62504","2024","COM","2022","263","5","268","2024-12-30"
"62505","2024","COM","2022","535","9","544","2024-12-30"
"62506","2024","COM","2022","1657","21","1678","2024-12-30"
"62507","2024","COM","2022","301","7","308","2024-12-30"
"62508","2024","COM","2022","340","7","347","2024-12-30"
"62509","2024","COM","2022","368","9","377","2024-12-30"
"62510","2024","COM","2022","30113","352","30465","2024-12-30"
"62511","2024","COM","2022","140","1","141","2024-12-30"
"62512","2024","COM","2022","564","10","574","2024-12-30"
"62513","2024","COM","2022","188","3","191","2024-12-30"
"62514","2024","COM","2022","238","3","241","2024-12-30"
"62515","2024","COM","2022","517","3","520","2024-12-30"
"62516","2024","COM","2022","10200","96","10296","2024-12-30"
"62517","2024","COM","2022","205","0","205","2024-12-30"
"62518","2024","COM","2022","172","1","173","2024-12-30"
"62519","2024","COM","2022","591","2","593","2024-12-30"
"62520","2024","COM","2022","2332","58","2390","2024-12-30"
"62521","2024","COM","2022","218","3","221","2024-12-30"
"62522","2024","COM","2022","261","5","266","2024-12-30"
"62523","2024","COM","2022","5202","27","5229","2024-12-30"
"62524","2024","COM","2022","1515","17","1532","2024-12-30"
"62525","2024","COM","2022","10559","461","11020","2024-12-30"
"62526","2024","COM","2022","147","2","149","2024-12-30"
"62527","2024","COM","2022","255","5","260","2024-12-30"
"62528","2024","COM","2022","6850","50","6900","2024-12-30"
"62529","2024","COM","2022","1630","28","1658","2024-12-30"
"62530","2024","COM","2022","541","8","549","2024-12-30"
"62531","2024","COM","2022","948","19","967","2024-12-30"
"62532","2024","COM","2022","1271","8","1279","2024-12-30"
"62533","2024","COM","2022","138","2","140","2024-12-30"
"62534","2024","COM","2022","3577","65","3642","2024-12-30"
"62535","2024","COM","2022","148","8","156","2024-12-30"
"62536","2024","COM","2022","645","5","650","2024-12-30"
"62537","2024","COM","2022","106","3","109","2024-12-30"
"62538","2024","COM","2022","453","7","460","2024-12-30"
"62539","2024","COM","2022","257","6","263","2024-12-30"
"62540","2024","COM","2022","1685","20","1705","2024-12-30"
"62541","2024","COM","2022","121","4","125","2024-12-30"
"62542","2024","COM","2022","204","0","204","2024-12-30"
"62543","2024","COM","2022","1985","27","2012","2024-12-30"
"62544","2024","COM","2022","182","3","185","2024-12-30"
"62545","2024","COM","2022","150","3","153","2024-12-30"
"62546","2024","COM","2022","329","10","339","2024-12-30"
"62547","2024","COM","2022","69","1","70","2024-12-30"
"62548","2024","COM","2022","10468","132","10600","2024-12-30"
"62549","2024","COM","2022","1067","69","1136","2024-12-30"
"62550","2024","COM","2022","1076","20","1096","2024-12-30"
"62551","2024","COM","2022","264","1","265","2024-12-30"
"62552","2024","COM","2022","1054","8","1062","2024-12-30"
"62553","2024","COM","2022","280","4","284","2024-12-30"
"62554","2024","COM","2022","94","4","98","2024-12-30"
"62555","2024","COM","2022","5437","24","5461","2024-12-30"
"62556","2024","COM","2022","313","5","318","2024-12-30"
"62557","2024","COM","2022","2430","53","2483","2024-12-30"
"62558","2024","COM","2022","173","5","178","2024-12-30"
"62559","2024","COM","2022","1016","21","1037","2024-12-30"
"62560","2024","COM","2022","5169","70","5239","2024-12-30"
"62561","2024","COM","2022","179","3","182","2024-12-30"
"62562","2024","COM","2022","174","3","177","2024-12-30"
"62563","2024","COM","2022","8164","34","8198","2024-12-30"
"62564","2024","COM","2022","458","9","467","2024-12-30"
"62565","2024","COM","2022","73","0","73","2024-12-30"
"62566","2024","COM","2022","652","17","669","2024-12-30"
"62567","2024","COM","2022","653","7","660","2024-12-30"
"62568","2024","COM","2022","726","13","739","2024-12-30"
"62569","2024","COM","2022","664","7","671","2024-12-30"
"62570","2024","COM","2022","11651","49","11700","2024-12-30"
"62571","2024","COM","2022","3348","69","3417","2024-12-30"
"62572","2024","COM","2022","606","10","616","2024-12-30"
"62573","2024","COM","2022","3715","23","3738","2024-12-30"
"62574","2024","COM","2022","231","4","235","2024-12-30"
"62576","2024","COM","2022","137","1","138","2024-12-30"
"62577","2024","COM","2022","73","2","75","2024-12-30"
"62578","2024","COM","2022","104","4","108","2024-12-30"
"62579","2024","COM","2022","546","3","549","2024-12-30"
"62580","2024","COM","2022","527","6","533","2024-12-30"
"62581","2024","COM","2022","289","5","294","2024-12-30"
"62582","2024","COM","2022","656","38","694","2024-12-30"
"62583","2024","COM","2022","579","9","588","2024-12-30"
"62584","2024","COM","2022","1319","32","1351","2024-12-30"
"62585","2024","COM","2022","389","5","394","2024-12-30"
"62586","2024","COM","2022","444","5","449","2024-12-30"
"62587","2024","COM","2022","9667","28","9695","2024-12-30"
"62588","2024","COM","2022","1902","125","2027","2024-12-30"
"62589","2024","COM","2022","1023","20","1043","2024-12-30"
"62590","2024","COM","2022","64","0","64","2024-12-30"
"62591","2024","COM","2022","210","4","214","2024-12-30"
"62592","2024","COM","2022","555","12","567","2024-12-30"
"62593","2024","COM","2022","87","0","87","2024-12-30"
"62594","2024","COM","2022","302","5","307","2024-12-30"
"62595","2024","COM","2022","1166","30","1196","2024-12-30"
"62596","2024","COM","2022","238","4","242","2024-12-30"
"62597","2024","COM","2022","289","3","292","2024-12-30"
"62598","2024","COM","2022","683","12","695","2024-12-30"
"62599","2024","COM","2022","233","8","241","2024-12-30"
"62600","2024","COM","2022","156","2","158","2024-12-30"
"62601","2024","COM","2022","347","5","352","2024-12-30"
"62602","2024","COM","2022","200","3","203","2024-12-30"
"62603","2024","COM","2022","1081","7","1088","2024-12-30"
"62604","2024","COM","2022","3993","73","4066","2024-12-30"
"62605","2024","COM","2022","22","0","22","2024-12-30"
"62606","2024","COM","2022","1404","23","1427","2024-12-30"
"62607","2024","COM","2022","62","3","65","2024-12-30"
"62608","2024","COM","2022","170","2","172","2024-12-30"
"62609","2024","COM","2022","1626","35","1661","2024-12-30"
"62610","2024","COM","2022","633","5","638","2024-12-30"
"62611","2024","COM","2022","484","13","497","2024-12-30"
"62612","2024","COM","2022","575","5","580","2024-12-30"
"62613","2024","COM","2022","913","8","921","2024-12-30"
"62614","2024","COM","2022","586","14","600","2024-12-30"
"62615","2024","COM","2022","281","7","288","2024-12-30"
"62616","2024","COM","2022","185","2","187","2024-12-30"
"62617","2024","COM","2022","11384","34","11418","2024-12-30"
"62618","2024","COM","2022","1293","12","1305","2024-12-30"
"62619","2024","COM","2022","133","2","135","2024-12-30"
"62620","2024","COM","2022","1372","26","1398","2024-12-30"
"62621","2024","COM","2022","1753","31","1784","2024-12-30"
"62622","2024","COM","2022","268","4","272","2024-12-30"
"62623","2024","COM","2022","709","8","717","2024-12-30"
"62624","2024","COM","2022","5949","26","5975","2024-12-30"
"62625","2024","COM","2022","57","2","59","2024-12-30"
"62626","2024","COM","2022","2278","20","2298","2024-12-30"
"62627","2024","COM","2022","848","14","862","2024-12-30"
"62628","2024","COM","2022","6757","33","6790","2024-12-30"
"62629","2024","COM","2022","156","1","157","2024-12-30"
"62630","2024","COM","2022","270","7","277","2024-12-30"
"62631","2024","COM","2022","473","6","479","2024-12-30"
"62632","2024","COM","2022","384","6","390","2024-12-30"
"62633","2024","COM","2022","253","4","257","2024-12-30"
"62634","2024","COM","2022","1288","10","1298","2024-12-30"
"62635","2024","COM","2022","203","2","205","2024-12-30"
"62636","2024","COM","2022","273","3","276","2024-12-30"
"62637","2024","COM","2022","10260","50","10310","2024-12-30"
"62638","2024","COM","2022","1200","7","1207","2024-12-30"
"62639","2024","COM","2022","379","9","388","2024-12-30"
"62640","2024","COM","2022","350","1","351","2024-12-30"
"62641","2024","COM","2022","215","4","219","2024-12-30"
"62642","2024","COM","2022","724","5","729","2024-12-30"
"62643","2024","COM","2022","13398","129","13527","2024-12-30"
"62644","2024","COM","2022","496","11","507","2024-12-30"
"62645","2024","COM","2022","5716","84","5800","2024-12-30"
"62646","2024","COM","2022","562","7","569","2024-12-30"
"62647","2024","COM","2022","717","14","731","2024-12-30"
"62648","2024","COM","2022","551","9","560","2024-12-30"
"62649","2024","COM","2022","763","4","767","2024-12-30"
"62650","2024","COM","2022","777","7","784","2024-12-30"
"62651","2024","COM","2022","468","9","477","2024-12-30"
"62652","2024","COM","2022","1586","25","1611","2024-12-30"
"62653","2024","COM","2022","419","14","433","2024-12-30"
"62654","2024","COM","2022","789","12","801","2024-12-30"
"62655","2024","COM","2022","326","9","335","2024-12-30"
"62656","2024","COM","2022","928","26","954","2024-12-30"
"62657","2024","COM","2022","530","11","541","2024-12-30"
"62658","2024","COM","2022","115","9","124","2024-12-30"
"62659","2024","COM","2022","104","3","107","2024-12-30"
"62660","2024","COM","2022","454","8","462","2024-12-30"
"62661","2024","COM","2022","511","1","512","2024-12-30"
"62662","2024","COM","2022","874","21","895","2024-12-30"
"62663","2024","COM","2022","308","6","314","2024-12-30"
"62664","2024","COM","2022","241","6","247","2024-12-30"
"62665","2024","COM","2022","212","6","218","2024-12-30"
"62666","2024","COM","2022","3099","18","3117","2024-12-30"
"62667","2024","COM","2022","8824","112","8936","2024-12-30"
"62668","2024","COM","2022","214","3","217","2024-12-30"
"62669","2024","COM","2022","299","4","303","2024-12-30"
"62670","2024","COM","2022","624","7","631","2024-12-30"
"62671","2024","COM","2022","308","5","313","2024-12-30"
"62672","2024","COM","2022","666","7","673","2024-12-30"
"62673","2024","COM","2022","635","7","642","2024-12-30"
"62674","2024","COM","2022","536","18","554","2024-12-30"
"62675","2024","COM","2022","286","3","289","2024-12-30"
"62676","2024","COM","2022","429","12","441","2024-12-30"
"62677","2024","COM","2022","325","5","330","2024-12-30"
"62678","2024","COM","2022","722","9","731","2024-12-30"
"62679","2024","COM","2022","333","8","341","2024-12-30"
"62680","2024","COM","2022","711","11","722","2024-12-30"
"62681","2024","COM","2022","654","24","678","2024-12-30"
"62682","2024","COM","2022","65","0","65","2024-12-30"
"62683","2024","COM","2022","215","2","217","2024-12-30"
"62684","2024","COM","2022","2197","31","2228","2024-12-30"
"62685","2024","COM","2022","261","150","411","2024-12-30"
"62686","2024","COM","2022","351","7","358","2024-12-30"
"62688","2024","COM","2022","4339","123","4462","2024-12-30"
"62689","2024","COM","2022","400","5","405","2024-12-30"
"62690","2024","COM","2022","228","6","234","2024-12-30"
"62691","2024","COM","2022","861","18","879","2024-12-30"
"62692","2024","COM","2022","397","4","401","2024-12-30"
"62693","2024","COM","2022","1071","25","1096","2024-12-30"
"62694","2024","COM","2022","188","2","190","2024-12-30"
"62695","2024","COM","2022","253","2","255","2024-12-30"
"62696","2024","COM","2022","234","2","236","2024-12-30"
"62697","2024","COM","2022","295","5","300","2024-12-30"
"62698","2024","COM","2022","268","10","278","2024-12-30"
"62699","2024","COM","2022","671","7","678","2024-12-30"
"62700","2024","COM","2022","210","1","211","2024-12-30"
"62701","2024","COM","2022","459","2","461","2024-12-30"
"62702","2024","COM","2022","360","4","364","2024-12-30"
"62703","2024","COM","2022","386","3","389","2024-12-30"
"62704","2024","COM","2022","589","12","601","2024-12-30"
"62705","2024","COM","2022","2050","17","2067","2024-12-30"
"62706","2024","COM","2022","2653","52","2705","2024-12-30"
"62708","2024","COM","2022","32","0","32","2024-12-30"
"62709","2024","COM","2022","249","4","253","2024-12-30"
"62710","2024","COM","2022","184","4","188","2024-12-30"
"62711","2024","COM","2022","3007","31","3038","2024-12-30"
"62712","2024","COM","2022","1124","17","1141","2024-12-30"
"62713","2024","COM","2022","1320","23","1343","2024-12-30"
"62714","2024","COM","2022","786","17","803","2024-12-30"
"62715","2024","COM","2022","273","3","276","2024-12-30"
"62716","2024","COM","2022","555","13","568","2024-12-30"
"62717","2024","COM","2022","520","8","528","2024-12-30"
"62718","2024","COM","2022","1393","24","1417","2024-12-30"
"62719","2024","COM","2022","273","35","308","2024-12-30"
"62720","2024","COM","2022","50","1","51","2024-12-30"
"62721","2024","COM","2022","1967","48","2015","2024-12-30"
"62722","2024","COM","2022","89","3","92","2024-12-30"
"62723","2024","COM","2022","247","7","254","2024-12-30"
"62724","2024","COM","2022","8675","28","8703","2024-12-30"
"62725","2024","COM","2022","127","1","128","2024-12-30"
"62726","2024","COM","2022","208","3","211","2024-12-30"
"62727","2024","COM","2022","1493","24","1517","2024-12-30"
"62728","2024","COM","2022","696","9","705","2024-12-30"
"62729","2024","COM","2022","239","8","247","2024-12-30"
"62730","2024","COM","2022","1607","20","1627","2024-12-30"
"62731","2024","COM","2022","284","1","285","2024-12-30"
"62732","2024","COM","2022","320","2","322","2024-12-30"
"62733","2024","COM","2022","287","5","292","2024-12-30"
"62734","2024","COM","2022","667","8","675","2024-12-30"
"62735","2024","COM","2022","2535","28","2563","2024-12-30"
"62736","2024","COM","2022","3932","75","4007","2024-12-30"
"62737","2024","COM","2022","5972","41","6013","2024-12-30"
"62738","2024","COM","2022","152","2","154","2024-12-30"
"62739","2024","COM","2022","318","5","323","2024-12-30"
"62740","2024","COM","2022","303","6","309","2024-12-30"
"62741","2024","COM","2022","119","0","119","2024-12-30"
"62742","2024","COM","2022","278","6","284","2024-12-30"
"62743","2024","COM","2022","362","9","371","2024-12-30"
"62744","2024","COM","2022","3533","63","3596","2024-12-30"
"62745","2024","COM","2022","171","6","177","2024-12-30"
"62746","2024","COM","2022","5051","51","5102","2024-12-30"
"62747","2024","COM","2022","629","15","644","2024-12-30"
"62748","2024","COM","2022","2339","28","2367","2024-12-30"
"62749","2024","COM","2022","325","5","330","2024-12-30"
"62750","2024","COM","2022","823","9","832","2024-12-30"
"62751","2024","COM","2022","814","13","827","2024-12-30"
"62752","2024","COM","2022","1055","39","1094","2024-12-30"
"62753","2024","COM","2022","6492","62","6554","2024-12-30"
"62754","2024","COM","2022","527","2","529","2024-12-30"
"62755","2024","COM","2022","3346","50","3396","2024-12-30"
"62756","2024","COM","2022","1715","18","1733","2024-12-30"
"62757","2024","COM","2022","5863","131","5994","2024-12-30"
"62758","2024","COM","2022","11036","147","11183","2024-12-30"
"62759","2024","COM","2022","444","10","454","2024-12-30"
"62760","2024","COM","2022","267","6","273","2024-12-30"
"62761","2024","COM","2022","214","3","217","2024-12-30"
"62762","2024","COM","2022","129","7","136","2024-12-30"
"62763","2024","COM","2022","838","35","873","2024-12-30"
"62764","2024","COM","2022","4548","51","4599","2024-12-30"
"62765","2024","COM","2022","14358","566","14924","2024-12-30"
"62766","2024","COM","2022","1100","13","1113","2024-12-30"
"62767","2024","COM","2022","4759","124","4883","2024-12-30"
"62768","2024","COM","2022","106","2","108","2024-12-30"
"62769","2024","COM","2022","775","14","789","2024-12-30"
"62770","2024","COM","2022","3002","103","3105","2024-12-30"
"62771","2024","COM","2022","9633","41","9674","2024-12-30"
"62772","2024","COM","2022","518","10","528","2024-12-30"
"62773","2024","COM","2022","4642","110","4752","2024-12-30"
"62774","2024","COM","2022","4755","150","4905","2024-12-30"
"62775","2024","COM","2022","327","6","333","2024-12-30"
"62776","2024","COM","2022","194","4","198","2024-12-30"
"62777","2024","COM","2022","156","1","157","2024-12-30"
"62778","2024","COM","2022","79","0","79","2024-12-30"
"62779","2024","COM","2022","187","3","190","2024-12-30"
"62780","2024","COM","2022","381","3","384","2024-12-30"
"62781","2024","COM","2022","445","4","449","2024-12-30"
"62782","2024","COM","2022","421","6","427","2024-12-30"
"62783","2024","COM","2022","322","5","327","2024-12-30"
"62784","2024","COM","2022","761","12","773","2024-12-30"
"62785","2024","COM","2022","912","169","1081","2024-12-30"
"62786","2024","COM","2022","304","5","309","2024-12-30"
"62787","2024","COM","2022","326","3","329","2024-12-30"
"62788","2024","COM","2022","686","18","704","2024-12-30"
"62789","2024","COM","2022","255","5","260","2024-12-30"
"62790","2024","COM","2022","161","7","168","2024-12-30"
"62791","2024","COM","2022","46","0","46","2024-12-30"
"62792","2024","COM","2022","1178","24","1202","2024-12-30"
"62793","2024","COM","2022","1146","18","1164","2024-12-30"
"62794","2024","COM","2022","594","11","605","2024-12-30"
"62795","2024","COM","2022","115","0","115","2024-12-30"
"62796","2024","COM","2022","567","12","579","2024-12-30"
"62797","2024","COM","2022","282","2","284","2024-12-30"
"62798","2024","COM","2022","206","5","211","2024-12-30"
"62799","2024","COM","2022","943","30","973","2024-12-30"
"62800","2024","COM","2022","376","4","380","2024-12-30"
"62801","2024","COM","2022","2664","53","2717","2024-12-30"
"62802","2024","COM","2022","194","2","196","2024-12-30"
"62803","2024","COM","2022","631","11","642","2024-12-30"
"62804","2024","COM","2022","362","5","367","2024-12-30"
"62805","2024","COM","2022","264","4","268","2024-12-30"
"62806","2024","COM","2022","150","5","155","2024-12-30"
"62808","2024","COM","2022","262","2","264","2024-12-30"
"62809","2024","COM","2022","130","0","130","2024-12-30"
"62810","2024","COM","2022","1303","24","1327","2024-12-30"
"62811","2024","COM","2022","1128","18","1146","2024-12-30"
"62812","2024","COM","2022","824","11","835","2024-12-30"
"62813","2024","COM","2022","470","2","472","2024-12-30"
"62814","2024","COM","2022","92","1","93","2024-12-30"
"62815","2024","COM","2022","168","1","169","2024-12-30"
"62816","2024","COM","2022","216","5","221","2024-12-30"
"62817","2024","COM","2022","1564","93","1657","2024-12-30"
"62818","2024","COM","2022","156","1","157","2024-12-30"
"62819","2024","COM","2022","1063","30","1093","2024-12-30"
"62820","2024","COM","2022","808","18","826","2024-12-30"
"62821","2024","COM","2022","293","5","298","2024-12-30"
"62822","2024","COM","2022","86","1","87","2024-12-30"
"62823","2024","COM","2022","172","5","177","2024-12-30"
"62824","2024","COM","2022","232","5","237","2024-12-30"
"62825","2024","COM","2022","884","7","891","2024-12-30"
"62826","2024","COM","2022","4223","297","4520","2024-12-30"
"62827","2024","COM","2022","1353","17","1370","2024-12-30"
"62828","2024","COM","2022","55","0","55","2024-12-30"
"62829","2024","COM","2022","425","10","435","2024-12-30"
"62830","2024","COM","2022","194","4","198","2024-12-30"
"62831","2024","COM","2022","288","10","298","2024-12-30"
"62832","2024","COM","2022","576","20","596","2024-12-30"
"62833","2024","COM","2022","70","2","72","2024-12-30"
"62834","2024","COM","2022","249","3","252","2024-12-30"
"62835","2024","COM","2022","544","17","561","2024-12-30"
"62836","2024","COM","2022","1129","20","1149","2024-12-30"
"62837","2024","COM","2022","488","7","495","2024-12-30"
"62838","2024","COM","2022","94","3","97","2024-12-30"
"62839","2024","COM","2022","1096","7","1103","2024-12-30"
"62840","2024","COM","2022","130","1","131","2024-12-30"
"62841","2024","COM","2022","2384","31","2415","2024-12-30"
"62842","2024","COM","2022","8596","45","8641","2024-12-30"
"62843","2024","COM","2022","233","2","235","2024-12-30"
"62844","2024","COM","2022","643","13","656","2024-12-30"
"62845","2024","COM","2022","514","4","518","2024-12-30"
"62846","2024","COM","2022","4729","39","4768","2024-12-30"
"62847","2024","COM","2022","2013","22","2035","2024-12-30"
"62848","2024","COM","2022","3452","36","3488","2024-12-30"
"62849","2024","COM","2022","2557","58","2615","2024-12-30"
"62850","2024","COM","2022","343","8","351","2024-12-30"
"62851","2024","COM","2022","888","19","907","2024-12-30"
"62852","2024","COM","2022","1496","13","1509","2024-12-30"
"62853","2024","COM","2022","385","10","395","2024-12-30"
"62854","2024","COM","2022","610","9","619","2024-12-30"
"62855","2024","COM","2022","243","2","245","2024-12-30"
"62856","2024","COM","2022","371","3","374","2024-12-30"
"62857","2024","COM","2022","127","4","131","2024-12-30"
"62858","2024","COM","2022","254","6","260","2024-12-30"
"62859","2024","COM","2022","257","2","259","2024-12-30"
"62860","2024","COM","2022","136","3","139","2024-12-30"
"62861","2024","COM","2022","4281","57","4338","2024-12-30"
"62862","2024","COM","2022","149","2","151","2024-12-30"
"62863","2024","COM","2022","3844","29","3873","2024-12-30"
"62864","2024","COM","2022","639","13","652","2024-12-30"
"62865","2024","COM","2022","4842","48","4890","2024-12-30"
"62866","2024","COM","2022","440","8","448","2024-12-30"
"62867","2024","COM","2022","261","7","268","2024-12-30"
"62868","2024","COM","2022","253","6","259","2024-12-30"
"62869","2024","COM","2022","1076","32","1108","2024-12-30"
"62870","2024","COM","2022","1063","27","1090","2024-12-30"
"62871","2024","COM","2022","260","1","261","2024-12-30"
"62872","2024","COM","2022","242","3","245","2024-12-30"
"62873","2024","COM","2022","630","14","644","2024-12-30"
"62874","2024","COM","2022","737","13","750","2024-12-30"
"62875","2024","COM","2022","1338","18","1356","2024-12-30"
"62876","2024","COM","2022","133","2","135","2024-12-30"
"62877","2024","COM","2022","165","3","168","2024-12-30"
"62878","2024","COM","2022","379","8","387","2024-12-30"
"62879","2024","COM","2022","215","3","218","2024-12-30"
"62880","2024","COM","2022","203","4","207","2024-12-30"
"62881","2024","COM","2022","363","7","370","2024-12-30"
"62882","2024","COM","2022","1211","33","1244","2024-12-30"
"62883","2024","COM","2022","196","2","198","2024-12-30"
"62885","2024","COM","2022","248","2","250","2024-12-30"
"62886","2024","COM","2022","268","3","271","2024-12-30"
"62887","2024","COM","2022","247","1","248","2024-12-30"
"62888","2024","COM","2022","228","9","237","2024-12-30"
"62889","2024","COM","2022","845","24","869","2024-12-30"
"62890","2024","COM","2022","182","3","185","2024-12-30"
"62891","2024","COM","2022","138","4","142","2024-12-30"
"62892","2024","COM","2022","661","10","671","2024-12-30"
"62893","2024","COM","2022","6307","131","6438","2024-12-30"
"62894","2024","COM","2022","3839","50","3889","2024-12-30"
"62895","2024","COM","2022","8734","47","8781","2024-12-30"
"62896","2024","COM","2022","743","21","764","2024-12-30"
"62897","2024","COM","2022","503","6","509","2024-12-30"
"62898","2024","COM","2022","223","9","232","2024-12-30"
"62899","2024","COM","2022","847","16","863","2024-12-30"
"62900","2024","COM","2022","620","16","636","2024-12-30"
"62901","2024","COM","2022","985","15","1000","2024-12-30"
"62902","2024","COM","2022","3339","42","3381","2024-12-30"
"62903","2024","COM","2022","588","12","600","2024-12-30"
"62904","2024","COM","2022","590","8","598","2024-12-30"
"62905","2024","COM","2022","1061","51","1112","2024-12-30"
"62906","2024","COM","2022","1795","11","1806","2024-12-30"
"62907","2024","COM","2022","8047","37","8084","2024-12-30"
"62908","2024","COM","2022","1571","28","1599","2024-12-30"
"62909","2024","COM","2022","428","5","433","2024-12-30"
"63001","2024","COM","2022","2700","37","2737","2024-12-30"
"63002","2024","COM","2022","99","3","102","2024-12-30"
"63003","2024","COM","2022","6556","218","6774","2024-12-30"
"63004","2024","COM","2022","1714","29","1743","2024-12-30"
"63005","2024","COM","2022","416","7","423","2024-12-30"
"63006","2024","COM","2022","174","1","175","2024-12-30"
"63007","2024","COM","2022","159","1","160","2024-12-30"
"63008","2024","COM","2022","576","11","587","2024-12-30"
"63009","2024","COM","2022","599","2","601","2024-12-30"
"63010","2024","COM","2022","1767","38","1805","2024-12-30"
"63011","2024","COM","2022","221","14","235","2024-12-30"
"63012","2024","COM","2022","923","19","942","2024-12-30"
"63013","2024","COM","2022","1018","9","1027","2024-12-30"
"63014","2024","COM","2022","10273","144","10417","2024-12-30"
"63015","2024","COM","2022","216","2","218","2024-12-30"
"63016","2024","COM","2022","864","22","886","2024-12-30"
"63017","2024","COM","2022","196","1","197","2024-12-30"
"63019","2024","COM","2022","4127","40","4167","2024-12-30"
"63020","2024","COM","2022","379","13","392","2024-12-30"
"63021","2024","COM","2022","661","17","678","2024-12-30"
"63022","2024","COM","2022","1953","24","1977","2024-12-30"
"63023","2024","COM","2022","388","6","394","2024-12-30"
"63024","2024","COM","2022","159","4","163","2024-12-30"
"63025","2024","COM","2022","134","5","139","2024-12-30"
"63026","2024","COM","2022","2548","47","2595","2024-12-30"
"63027","2024","COM","2022","111","1","112","2024-12-30"
"63028","2024","COM","2022","402","12","414","2024-12-30"
"63029","2024","COM","2022","263","9","272","2024-12-30"
"63030","2024","COM","2022","346","4","350","2024-12-30"
"63031","2024","COM","2022","474","9","483","2024-12-30"
"63032","2024","COM","2022","10787","190","10977","2024-12-30"
"63033","2024","COM","2022","315","6","321","2024-12-30"
"63034","2024","COM","2022","1584","25","1609","2024-12-30"
"63035","2024","COM","2022","1323","20","1343","2024-12-30"
"63036","2024","COM","2022","316","5","321","2024-12-30"
"63037","2024","COM","2022","471","10","481","2024-12-30"
"63038","2024","COM","2022","1445","67","1512","2024-12-30"
"63039","2024","COM","2022","310","10","320","2024-12-30"
"63040","2024","COM","2022","4826","96","4922","2024-12-30"
"63041","2024","COM","2022","317","8","325","2024-12-30"
"63042","2024","COM","2022","3729","38","3767","2024-12-30"
"63043","2024","COM","2022","441","11","452","2024-12-30"
"63044","2024","COM","2022","452","13","465","2024-12-30"
"63045","2024","COM","2022","724","17","741","2024-12-30"
"63046","2024","COM","2022","262","5","267","2024-12-30"
"63047","2024","COM","2022","1739","26","1765","2024-12-30"
"63048","2024","COM","2022","873","14","887","2024-12-30"
"63049","2024","COM","2022","712","10","722","2024-12-30"
"63050","2024","COM","2022","3380","136","3516","2024-12-30"
"63051","2024","COM","2022","629","8","637","2024-12-30"
"63052","2024","COM","2022","1030","87","1117","2024-12-30"
"63053","2024","COM","2022","265","7","272","2024-12-30"
"63054","2024","COM","2022","632","16","648","2024-12-30"
"63055","2024","COM","2022","1016","10","1026","2024-12-30"
"63056","2024","COM","2022","358","7","365","2024-12-30"
"63057","2024","COM","2022","242","5","247","2024-12-30"
"63058","2024","COM","2022","588","10","598","2024-12-30"
"63059","2024","COM","2022","221","3","224","2024-12-30"
"63060","2024","COM","2022","107","1","108","2024-12-30"
"63061","2024","COM","2022","504","7","511","2024-12-30"
"63062","2024","COM","2022","242","3","245","2024-12-30"
"63063","2024","COM","2022","8949","96","9045","2024-12-30"
"63064","2024","COM","2022","80","0","80","2024-12-30"
"63065","2024","COM","2022","174","2","176","2024-12-30"
"63066","2024","COM","2022","1635","31","1666","2024-12-30"
"63067","2024","COM","2022","167","3","170","2024-12-30"
"63069","2024","COM","2022","5455","60","5515","2024-12-30"
"63070","2024","COM","2022","6548","133","6681","2024-12-30"
"63071","2024","COM","2022","694","13","707","2024-12-30"
"63072","2024","COM","2022","1164","12","1176","2024-12-30"
"63073","2024","COM","2022","429","12","441","2024-12-30"
"63074","2024","COM","2022","181","0","181","2024-12-30"
"63075","2024","COM","2022","17591","535","18126","2024-12-30"
"63076","2024","COM","2022","143","3","146","2024-12-30"
"63077","2024","COM","2022","407","13","420","2024-12-30"
"63079","2024","COM","2022","149","1","150","2024-12-30"
"63080","2024","COM","2022","1416","24","1440","2024-12-30"
"63081","2024","COM","2022","283","4","287","2024-12-30"
"63082","2024","COM","2022","421","14","435","2024-12-30"
"63083","2024","COM","2022","949","29","978","2024-12-30"
"63084","2024","COM","2022","1715","37","1752","2024-12-30"
"63085","2024","COM","2022","1139","23","1162","2024-12-30"
"63086","2024","COM","2022","351","11","362","2024-12-30"
"63087","2024","COM","2022","64","1","65","2024-12-30"
"63088","2024","COM","2022","86","1","87","2024-12-30"
"63089","2024","COM","2022","1609","30","1639","2024-12-30"
"63090","2024","COM","2022","492","11","503","2024-12-30"
"63091","2024","COM","2022","937","17","954","2024-12-30"
"63092","2024","COM","2022","1914","30","1944","2024-12-30"
"63093","2024","COM","2022","1161","20","1181","2024-12-30"
"63094","2024","COM","2022","474","5","479","2024-12-30"
"63095","2024","COM","2022","205","2","207","2024-12-30"
"63096","2024","COM","2022","368","9","377","2024-12-30"
"63097","2024","COM","2022","81","2","83","2024-12-30"
"63098","2024","COM","2022","233","3","236","2024-12-30"
"63099","2024","COM","2022","3143","47","3190","2024-12-30"
"63100","2024","COM","2022","311","12","323","2024-12-30"
"63101","2024","COM","2022","67","2","69","2024-12-30"
"63102","2024","COM","2022","752","17","769","2024-12-30"
"63103","2024","COM","2022","6294","177","6471","2024-12-30"
"63104","2024","COM","2022","116","5","121","2024-12-30"
"63105","2024","COM","2022","233","10","243","2024-12-30"
"63106","2024","COM","2022","1779","21","1800","2024-12-30"
"63107","2024","COM","2022","531","12","543","2024-12-30"
"63108","2024","COM","2022","689","18","707","2024-12-30"
"63109","2024","COM","2022","494","11","505","2024-12-30"
"63110","2024","COM","2022","450","6","456","2024-12-30"
"63111","2024","COM","2022","121","5","126","2024-12-30"
"63112","2024","COM","2022","631","19","650","2024-12-30"
"63113","2024","COM","2022","147751","2500","150251","2024-12-30"
"63114","2024","COM","2022","156","4","160","2024-12-30"
"63115","2024","COM","2022","213","4","217","2024-12-30"
"63116","2024","COM","2022","2142","40","2182","2024-12-30"
"63117","2024","COM","2022","126","1","127","2024-12-30"
"63118","2024","COM","2022","412","7","419","2024-12-30"
"63119","2024","COM","2022","230","8","238","2024-12-30"
"63120","2024","COM","2022","782","12","794","2024-12-30"
"63121","2024","COM","2022","1241","23","1264","2024-12-30"
"63122","2024","COM","2022","61","1","62","2024-12-30"
"63123","2024","COM","2022","230","6","236","2024-12-30"
"63124","2024","COM","2022","20020","365","20385","2024-12-30"
"63125","2024","COM","2022","4109","125","4234","2024-12-30"
"63126","2024","COM","2022","1300","19","1319","2024-12-30"
"63128","2024","COM","2022","964","16","980","2024-12-30"
"63129","2024","COM","2022","166","0","166","2024-12-30"
"63130","2024","COM","2022","259","11","270","2024-12-30"
"63131","2024","COM","2022","1149","19","1168","2024-12-30"
"63132","2024","COM","2022","1301","22","1323","2024-12-30"
"63134","2024","COM","2022","67","2","69","2024-12-30"
"63135","2024","COM","2022","646","11","657","2024-12-30"
"63136","2024","COM","2022","377","8","385","2024-12-30"
"63137","2024","COM","2022","172","4","176","2024-12-30"
"63138","2024","COM","2022","721","18","739","2024-12-30"
"63139","2024","COM","2022","664","9","673","2024-12-30"
"63140","2024","COM","2022","214","4","218","2024-12-30"
"63141","2024","COM","2022","1964","33","1997","2024-12-30"
"63142","2024","COM","2022","249","11","260","2024-12-30"
"63143","2024","COM","2022","1127","22","1149","2024-12-30"
"63144","2024","COM","2022","328","6","334","2024-12-30"
"63145","2024","COM","2022","156","5","161","2024-12-30"
"63146","2024","COM","2022","894","30","924","2024-12-30"
"63147","2024","COM","2022","309","6","315","2024-12-30"
"63148","2024","COM","2022","2658","64","2722","2024-12-30"
"63149","2024","COM","2022","732","12","744","2024-12-30"
"63150","2024","COM","2022","1581","21","1602","2024-12-30"
"63151","2024","COM","2022","1355","31","1386","2024-12-30"
"63152","2024","COM","2022","277","5","282","2024-12-30"
"63153","2024","COM","2022","73","2","75","2024-12-30"
"63154","2024","COM","2022","418","8","426","2024-12-30"
"63155","2024","COM","2022","508","15","523","2024-12-30"
"63156","2024","COM","2022","55","0","55","2024-12-30"
"63157","2024","COM","2022","381","7","388","2024-12-30"
"63158","2024","COM","2022","107","4","111","2024-12-30"
"63159","2024","COM","2022","136","2","138","2024-12-30"
"63160","2024","COM","2022","938","21","959","2024-12-30"
"63161","2024","COM","2022","316","13","329","2024-12-30"
"63162","2024","COM","2022","315","9","324","2024-12-30"
"63163","2024","COM","2022","931","61","992","2024-12-30"
"63164","2024","COM","2022","10268","98","10366","2024-12-30"
"63165","2024","COM","2022","791","10","801","2024-12-30"
"63166","2024","COM","2022","254","10","264","2024-12-30"
"63167","2024","COM","2022","388","8","396","2024-12-30"
"63168","2024","COM","2022","599","8","607","2024-12-30"
"63169","2024","COM","2022","17","1","18","2024-12-30"
"63170","2024","COM","2022","615","7","622","2024-12-30"
"63171","2024","COM","2022","310","8","318","2024-12-30"
"63172","2024","COM","2022","53","1","54","2024-12-30"
"63173","2024","COM","2022","203","7","210","2024-12-30"
"63174","2024","COM","2022","119","3","122","2024-12-30"
"63175","2024","COM","2022","264","6","270","2024-12-30"
"63176","2024","COM","2022","113","3","116","2024-12-30"
"63177","2024","COM","2022","422","9","431","2024-12-30"
"63178","2024","COM","2022","15078","385","15463","2024-12-30"
"63179","2024","COM","2022","994","28","1022","2024-12-30"
"63180","2024","COM","2022","1171","19","1190","2024-12-30"
"63181","2024","COM","2022","564","13","577","2024-12-30"
"63182","2024","COM","2022","563","14","577","2024-12-30"
"63183","2024","COM","2022","63","1","64","2024-12-30"
"63184","2024","COM","2022","276","5","281","2024-12-30"
"63185","2024","COM","2022","646","11","657","2024-12-30"
"63186","2024","COM","2022","223","6","229","2024-12-30"
"63187","2024","COM","2022","515","12","527","2024-12-30"
"63188","2024","COM","2022","597","16","613","2024-12-30"
"63189","2024","COM","2022","351","13","364","2024-12-30"
"63190","2024","COM","2022","290","5","295","2024-12-30"
"63191","2024","COM","2022","99","4","103","2024-12-30"
"63192","2024","COM","2022","631","27","658","2024-12-30"
"63193","2024","COM","2022","8646","430","9076","2024-12-30"
"63194","2024","COM","2022","405","5","410","2024-12-30"
"63195","2024","COM","2022","6468","72","6540","2024-12-30"
"63196","2024","COM","2022","729","19","748","2024-12-30"
"63197","2024","COM","2022","108","3","111","2024-12-30"
"63198","2024","COM","2022","1431","30","1461","2024-12-30"
"63199","2024","COM","2022","495","6","501","2024-12-30"
"63200","2024","COM","2022","944","9","953","2024-12-30"
"63201","2024","COM","2022","1157","19","1176","2024-12-30"
"63202","2024","COM","2022","136","1","137","2024-12-30"
"63203","2024","COM","2022","1160","21","1181","2024-12-30"
"63204","2024","COM","2022","1133","18","1151","2024-12-30"
"63205","2024","COM","2022","472","9","481","2024-12-30"
"63206","2024","COM","2022","1417","28","1445","2024-12-30"
"63207","2024","COM","2022","805","16","821","2024-12-30"
"63208","2024","COM","2022","342","4","346","2024-12-30"
"63209","2024","COM","2022","226","3","229","2024-12-30"
"63210","2024","COM","2022","3140","52","3192","2024-12-30"
"63211","2024","COM","2022","1391","40","1431","2024-12-30"
"63212","2024","COM","2022","1452","37","1489","2024-12-30"
"63213","2024","COM","2022","2237","28","2265","2024-12-30"
"63214","2024","COM","2022","3786","56","3842","2024-12-30"
"63215","2024","COM","2022","732","8","740","2024-12-30"
"63216","2024","COM","2022","132","5","137","2024-12-30"
"63218","2024","COM","2022","197","6","203","2024-12-30"
"63219","2024","COM","2022","708","12","720","2024-12-30"
"63220","2024","COM","2022","95","2","97","2024-12-30"
"63221","2024","COM","2022","116","2","118","2024-12-30"
"63222","2024","COM","2022","495","4","499","2024-12-30"
"63223","2024","COM","2022","543","17","560","2024-12-30"
"63224","2024","COM","2022","1641","12","1653","2024-12-30"
"63225","2024","COM","2022","1006","19","1025","2024-12-30"
"63226","2024","COM","2022","3102","61","3163","2024-12-30"
"63227","2024","COM","2022","2336","57","2393","2024-12-30"
"63228","2024","COM","2022","295","7","302","2024-12-30"
"63229","2024","COM","2022","1256","27","1283","2024-12-30"
"63230","2024","COM","2022","239","5","244","2024-12-30"
"63231","2024","COM","2022","1624","29","1653","2024-12-30"
"63232","2024","COM","2022","559","15","574","2024-12-30"
"63233","2024","COM","2022","977","8","985","2024-12-30"
"63234","2024","COM","2022","923","28","951","2024-12-30"
"63235","2024","COM","2022","559","7","566","2024-12-30"
"63236","2024","COM","2022","1200","12","1212","2024-12-30"
"63237","2024","COM","2022","417","5","422","2024-12-30"
"63238","2024","COM","2022","226","5","231","2024-12-30"
"63239","2024","COM","2022","730","15","745","2024-12-30"
"63240","2024","COM","2022","467","9","476","2024-12-30"
"63241","2024","COM","2022","325","9","334","2024-12-30"
"63242","2024","COM","2022","388","11","399","2024-12-30"
"63243","2024","COM","2022","376","8","384","2024-12-30"
"63244","2024","COM","2022","1779","33","1812","2024-12-30"
"63245","2024","COM","2022","3889","72","3961","2024-12-30"
"63246","2024","COM","2022","486","17","503","2024-12-30"
"63247","2024","COM","2022","670","15","685","2024-12-30"
"63248","2024","COM","2022","865","21","886","2024-12-30"
"63249","2024","COM","2022","485","10","495","2024-12-30"
"63250","2024","COM","2022","890","14","904","2024-12-30"
"63251","2024","COM","2022","320","3","323","2024-12-30"
"63252","2024","COM","2022","375","10","385","2024-12-30"
"63253","2024","COM","2022","230","2","232","2024-12-30"
"63254","2024","COM","2022","2246","36","2282","2024-12-30"
"63255","2024","COM","2022","618","16","634","2024-12-30"
"63256","2024","COM","2022","153","5","158","2024-12-30"
"63257","2024","COM","2022","862","11","873","2024-12-30"
"63258","2024","COM","2022","736","18","754","2024-12-30"
"63259","2024","COM","2022","325","8","333","2024-12-30"
"63260","2024","COM","2022","180","3","183","2024-12-30"
"63261","2024","COM","2022","881","23","904","2024-12-30"
"63262","2024","COM","2022","2867","35","2902","2024-12-30"
"63263","2024","COM","2022","3584","110","3694","2024-12-30"
"63264","2024","COM","2022","242","6","248","2024-12-30"
"63265","2024","COM","2022","2236","43","2279","2024-12-30"
"63267","2024","COM","2022","520","19","539","2024-12-30"
"63268","2024","COM","2022","301","6","307","2024-12-30"
"63269","2024","COM","2022","889","22","911","2024-12-30"
"63270","2024","COM","2022","481","17","498","2024-12-30"
"63271","2024","COM","2022","1487","33","1520","2024-12-30"
"63272","2024","COM","2022","2875","57","2932","2024-12-30"
"63273","2024","COM","2022","1492","22","1514","2024-12-30"
"63274","2024","COM","2022","422","17","439","2024-12-30"
"63275","2024","COM","2022","912","20","932","2024-12-30"
"63276","2024","COM","2022","2103","44","2147","2024-12-30"
"63277","2024","COM","2022","54","1","55","2024-12-30"
"63278","2024","COM","2022","744","15","759","2024-12-30"
"63279","2024","COM","2022","315","7","322","2024-12-30"
"63280","2024","COM","2022","340","8","348","2024-12-30"
"63281","2024","COM","2022","1042","19","1061","2024-12-30"
"63282","2024","COM","2022","1680","30","1710","2024-12-30"
"63283","2024","COM","2022","659","114","773","2024-12-30"
"63284","2024","COM","2022","12422","321","12743","2024-12-30"
"63285","2024","COM","2022","715","2","717","2024-12-30"
"63286","2024","COM","2022","270","1","271","2024-12-30"
"63287","2024","COM","2022","355","6","361","2024-12-30"
"63288","2024","COM","2022","476","10","486","2024-12-30"
"63289","2024","COM","2022","273","6","279","2024-12-30"
"63290","2024","COM","2022","409","11","420","2024-12-30"
"63291","2024","COM","2022","2644","48","2692","2024-12-30"
"63292","2024","COM","2022","138","4","142","2024-12-30"
"63293","2024","COM","2022","216","10","226","2024-12-30"
"63294","2024","COM","2022","282","4","286","2024-12-30"
"63295","2024","COM","2022","1622","15","1637","2024-12-30"
"63296","2024","COM","2022","767","19","786","2024-12-30"
"63297","2024","COM","2022","379","3","382","2024-12-30"
"63298","2024","COM","2022","131","0","131","2024-12-30"
"63299","2024","COM","2022","102","0","102","2024-12-30"
"63300","2024","COM","2022","18680","743","19423","2024-12-30"
"63301","2024","COM","2022","735","7","742","2024-12-30"
"63302","2024","COM","2022","3373","50","3423","2024-12-30"
"63303","2024","COM","2022","40","1","41","2024-12-30"
"63304","2024","COM","2022","114","0","114","2024-12-30"
"63305","2024","COM","2022","846","135","981","2024-12-30"
"63306","2024","COM","2022","630","11","641","2024-12-30"
"63307","2024","COM","2022","7905","145","8050","2024-12-30"
"63308","2024","COM","2022","4420","115","4535","2024-12-30"
"63309","2024","COM","2022","306","3","309","2024-12-30"
"63310","2024","COM","2022","171","5","176","2024-12-30"
"63311","2024","COM","2022","311","12","323","2024-12-30"
"63312","2024","COM","2022","136","2","138","2024-12-30"
"63313","2024","COM","2022","101","7","108","2024-12-30"
"63314","2024","COM","2022","532","10","542","2024-12-30"
"63315","2024","COM","2022","1811","37","1848","2024-12-30"
"63317","2024","COM","2022","554","5","559","2024-12-30"
"63318","2024","COM","2022","474","8","482","2024-12-30"
"63319","2024","COM","2022","708","23","731","2024-12-30"
"63320","2024","COM","2022","205","5","210","2024-12-30"
"63321","2024","COM","2022","942","15","957","2024-12-30"
"63322","2024","COM","2022","2210","32","2242","2024-12-30"
"63323","2024","COM","2022","180","4","184","2024-12-30"
"63324","2024","COM","2022","205","4","209","2024-12-30"
"63325","2024","COM","2022","426","7","433","2024-12-30"
"63326","2024","COM","2022","566","9","575","2024-12-30"
"63327","2024","COM","2022","2078","41","2119","2024-12-30"
"63328","2024","COM","2022","55","0","55","2024-12-30"
"63329","2024","COM","2022","124","5","129","2024-12-30"
"63330","2024","COM","2022","348","9","357","2024-12-30"
"63331","2024","COM","2022","237","8","245","2024-12-30"
"63332","2024","COM","2022","522","9","531","2024-12-30"
"63333","2024","COM","2022","247","2","249","2024-12-30"
"63334","2024","COM","2022","549","18","567","2024-12-30"
"63335","2024","COM","2022","541","16","557","2024-12-30"
"63336","2024","COM","2022","198","3","201","2024-12-30"
"63337","2024","COM","2022","63","1","64","2024-12-30"
"63338","2024","COM","2022","3484","142","3626","2024-12-30"
"63339","2024","COM","2022","126","1","127","2024-12-30"
"63340","2024","COM","2022","256","2","258","2024-12-30"
"63341","2024","COM","2022","549","17","566","2024-12-30"
"63342","2024","COM","2022","246","5","251","2024-12-30"
"63343","2024","COM","2022","272","7","279","2024-12-30"
"63344","2024","COM","2022","148","4","152","2024-12-30"
"63345","2024","COM","2022","3974","89","4063","2024-12-30"
"63346","2024","COM","2022","205","4","209","2024-12-30"
"63347","2024","COM","2022","463","18","481","2024-12-30"
"63348","2024","COM","2022","189","3","192","2024-12-30"
"63349","2024","COM","2022","2003","55","2058","2024-12-30"
"63350","2024","COM","2022","1352","21","1373","2024-12-30"
"63351","2024","COM","2022","62","2","64","2024-12-30"
"63352","2024","COM","2022","2020","52","2072","2024-12-30"
"63353","2024","COM","2022","488","29","517","2024-12-30"
"63354","2024","COM","2022","1226","160","1386","2024-12-30"
"63355","2024","COM","2022","214","4","218","2024-12-30"
"63356","2024","COM","2022","338","8","346","2024-12-30"
"63357","2024","COM","2022","111","4","115","2024-12-30"
"63358","2024","COM","2022","372","10","382","2024-12-30"
"63359","2024","COM","2022","84","2","86","2024-12-30"
"63360","2024","COM","2022","146","3","149","2024-12-30"
"63362","2024","COM","2022","917","17","934","2024-12-30"
"63363","2024","COM","2022","291","8","299","2024-12-30"
"63364","2024","COM","2022","698","14","712","2024-12-30"
"63365","2024","COM","2022","437","9","446","2024-12-30"
"63366","2024","COM","2022","352","6","358","2024-12-30"
"63367","2024","COM","2022","127","1","128","2024-12-30"
"63368","2024","COM","2022","1294","19","1313","2024-12-30"
"63369","2024","COM","2022","120","4","124","2024-12-30"
"63370","2024","COM","2022","363","6","369","2024-12-30"
"63371","2024","COM","2022","147","5","152","2024-12-30"
"63372","2024","COM","2022","694","7","701","2024-12-30"
"63373","2024","COM","2022","171","8","179","2024-12-30"
"63374","2024","COM","2022","312","4","316","2024-12-30"
"63375","2024","COM","2022","178","6","184","2024-12-30"
"63376","2024","COM","2022","146","7","153","2024-12-30"
"63377","2024","COM","2022","363","10","373","2024-12-30"
"63378","2024","COM","2022","990","8","998","2024-12-30"
"63379","2024","COM","2022","553","6","559","2024-12-30"
"63380","2024","COM","2022","796","7","803","2024-12-30"
"63381","2024","COM","2022","1691","35","1726","2024-12-30"
"63382","2024","COM","2022","428","13","441","2024-12-30"
"63383","2024","COM","2022","248","1","249","2024-12-30"
"63384","2024","COM","2022","135","5","140","2024-12-30"
"63385","2024","COM","2022","453","10","463","2024-12-30"
"63386","2024","COM","2022","500","11","511","2024-12-30"
"63387","2024","COM","2022","869","17","886","2024-12-30"
"63388","2024","COM","2022","726","11","737","2024-12-30"
"63389","2024","COM","2022","109","2","111","2024-12-30"
"63390","2024","COM","2022","387","11","398","2024-12-30"
"63391","2024","COM","2022","247","4","251","2024-12-30"
"63392","2024","COM","2022","628","8","636","2024-12-30"
"63393","2024","COM","2022","1760","34","1794","2024-12-30"
"63394","2024","COM","2022","197","6","203","2024-12-30"
"63395","2024","COM","2022","996","19","1015","2024-12-30"
"63396","2024","COM","2022","1167","64","1231","2024-12-30"
"63397","2024","COM","2022","1128","27","1155","2024-12-30"
"63398","2024","COM","2022","83","3","86","2024-12-30"
"63399","2024","COM","2022","85","0","85","2024-12-30"
"63400","2024","COM","2022","1065","23","1088","2024-12-30"
"63401","2024","COM","2022","242","5","247","2024-12-30"
"63402","2024","COM","2022","264","7","271","2024-12-30"
"63403","2024","COM","2022","417","10","427","2024-12-30"
"63404","2024","COM","2022","555","15","570","2024-12-30"
"63405","2024","COM","2022","566","12","578","2024-12-30"
"63406","2024","COM","2022","300","6","306","2024-12-30"
"63407","2024","COM","2022","287","5","292","2024-12-30"
"63408","2024","COM","2022","165","4","169","2024-12-30"
"63409","2024","COM","2022","248","0","248","2024-12-30"
"63410","2024","COM","2022","145","4","149","2024-12-30"
"63411","2024","COM","2022","465","14","479","2024-12-30"
"63412","2024","COM","2022","531","20","551","2024-12-30"
"63413","2024","COM","2022","725","14","739","2024-12-30"
"63414","2024","COM","2022","587","11","598","2024-12-30"
"63415","2024","COM","2022","1328","10","1338","2024-12-30"
"63416","2024","COM","2022","96","2","98","2024-12-30"
"63417","2024","COM","2022","2519","47","2566","2024-12-30"
"63418","2024","COM","2022","589","7","596","2024-12-30"
"63419","2024","COM","2022","559","13","572","2024-12-30"
"63420","2024","COM","2022","787","8","795","2024-12-30"
"63421","2024","COM","2022","154","4","158","2024-12-30"
"63422","2024","COM","2022","520","10","530","2024-12-30"
"63423","2024","COM","2022","632","13","645","2024-12-30"
"63424","2024","COM","2022","611","11","622","2024-12-30"
"63425","2024","COM","2022","1565","37","1602","2024-12-30"
"63426","2024","COM","2022","700","15","715","2024-12-30"
"63427","2024","COM","2022","519","14","533","2024-12-30"
"63428","2024","COM","2022","283","5","288","2024-12-30"
"63429","2024","COM","2022","49","1","50","2024-12-30"
"63430","2024","COM","2022","11686","363","12049","2024-12-30"
"63431","2024","COM","2022","162","3","165","2024-12-30"
"63432","2024","COM","2022","924","37","961","2024-12-30"
"63433","2024","COM","2022","79","2","81","2024-12-30"
"63434","2024","COM","2022","538","17","555","2024-12-30"
"63435","2024","COM","2022","202","6","208","2024-12-30"
"63436","2024","COM","2022","77","0","77","2024-12-30"
"63437","2024","COM","2022","144","3","147","2024-12-30"
"63438","2024","COM","2022","502","8","510","2024-12-30"
"63439","2024","COM","2022","297","9","306","2024-12-30"
"63440","2024","COM","2022","145","0","145","2024-12-30"
"63441","2024","COM","2022","229","4","233","2024-12-30"
"63442","2024","COM","2022","53","2","55","2024-12-30"
"63443","2024","COM","2022","432","11","443","2024-12-30"
"63444","2024","COM","2022","315","5","320","2024-12-30"
"63445","2024","COM","2022","295","4","299","2024-12-30"
"63446","2024","COM","2022","550","6","556","2024-12-30"
"63447","2024","COM","2022","66","4","70","2024-12-30"
"63448","2024","COM","2022","780","94","874","2024-12-30"
"63449","2024","COM","2022","329","9","338","2024-12-30"
"63450","2024","COM","2022","227","4","231","2024-12-30"
"63451","2024","COM","2022","427","18","445","2024-12-30"
"63452","2024","COM","2022","74","1","75","2024-12-30"
"63453","2024","COM","2022","3442","48","3490","2024-12-30"
"63454","2024","COM","2022","551","14","565","2024-12-30"
"63455","2024","COM","2022","3698","50","3748","2024-12-30"
"63456","2024","COM","2022","333","16","349","2024-12-30"
"63457","2024","COM","2022","5336","95","5431","2024-12-30"
"63458","2024","COM","2022","139","2","141","2024-12-30"
"63459","2024","COM","2022","506","6","512","2024-12-30"
"63460","2024","COM","2022","365","8","373","2024-12-30"
"63461","2024","COM","2022","371","3","374","2024-12-30"
"63462","2024","COM","2022","268","5","273","2024-12-30"
"63463","2024","COM","2022","503","6","509","2024-12-30"
"63464","2024","COM","2022","338","13","351","2024-12-30"
"63465","2024","COM","2022","443","7","450","2024-12-30"
"63466","2024","COM","2022","188","3","191","2024-12-30"
"63467","2024","COM","2022","57","1","58","2024-12-30"
"63468","2024","COM","2022","312","9","321","2024-12-30"
"63469","2024","COM","2022","714","21","735","2024-12-30"
"63470","2024","COM","2022","4779","72","4851","2024-12-30"
"63471","2024","COM","2022","871","26","897","2024-12-30"
"63472","2024","COM","2022","643","17","660","2024-12-30"
"63473","2024","COM","2022","396","10","406","2024-12-30"
"64001","2024","COM","2022","196","6","202","2024-12-30"
"64002","2024","COM","2022","159","1","160","2024-12-30"
"64003","2024","COM","2022","215","4","219","2024-12-30"
"64004","2024","COM","2022","115","2","117","2024-12-30"
"64005","2024","COM","2022","522","9","531","2024-12-30"
"64006","2024","COM","2022","465","9","474","2024-12-30"
"64007","2024","COM","2022","1042","23","1065","2024-12-30"
"64008","2024","COM","2022","262","9","271","2024-12-30"
"64009","2024","COM","2022","2070","31","2101","2024-12-30"
"64010","2024","COM","2022","695","23","718","2024-12-30"
"64011","2024","COM","2022","114","6","120","2024-12-30"
"64012","2024","COM","2022","128","4","132","2024-12-30"
"64013","2024","COM","2022","167","5","172","2024-12-30"
"64014","2024","COM","2022","665","8","673","2024-12-30"
"64015","2024","COM","2022","207","2","209","2024-12-30"
"64016","2024","COM","2022","327","8","335","2024-12-30"
"64017","2024","COM","2022","305","7","312","2024-12-30"
"64018","2024","COM","2022","466","14","480","2024-12-30"
"64019","2024","COM","2022","224","9","233","2024-12-30"
"64021","2024","COM","2022","724","26","750","2024-12-30"
"64022","2024","COM","2022","138","2","140","2024-12-30"
"64023","2024","COM","2022","895","26","921","2024-12-30"
"64024","2024","COM","2022","42288","1095","43383","2024-12-30"
"64025","2024","COM","2022","94","5","99","2024-12-30"
"64026","2024","COM","2022","383","12","395","2024-12-30"
"64027","2024","COM","2022","178","7","185","2024-12-30"
"64028","2024","COM","2022","134","5","139","2024-12-30"
"64029","2024","COM","2022","658","12","670","2024-12-30"
"64031","2024","COM","2022","183","3","186","2024-12-30"
"64032","2024","COM","2022","185","4","189","2024-12-30"
"64033","2024","COM","2022","134","1","135","2024-12-30"
"64034","2024","COM","2022","328","5","333","2024-12-30"
"64035","2024","COM","2022","2364","68","2432","2024-12-30"
"64036","2024","COM","2022","312","7","319","2024-12-30"
"64037","2024","COM","2022","1235","30","1265","2024-12-30"
"64038","2024","COM","2022","3588","71","3659","2024-12-30"
"64039","2024","COM","2022","246","9","255","2024-12-30"
"64040","2024","COM","2022","1052","35","1087","2024-12-30"
"64041","2024","COM","2022","846","11","857","2024-12-30"
"64042","2024","COM","2022","699","9","708","2024-12-30"
"64043","2024","COM","2022","274","10","284","2024-12-30"
"64044","2024","COM","2022","80","1","81","2024-12-30"
"64045","2024","COM","2022","67","0","67","2024-12-30"
"64046","2024","COM","2022","392","16","408","2024-12-30"
"64047","2024","COM","2022","238","2","240","2024-12-30"
"64048","2024","COM","2022","134","2","136","2024-12-30"
"64049","2024","COM","2022","231","8","239","2024-12-30"
"64050","2024","COM","2022","92","3","95","2024-12-30"
"64051","2024","COM","2022","435","4","439","2024-12-30"
"64052","2024","COM","2022","105","4","109","2024-12-30"
"64053","2024","COM","2022","198","2","200","2024-12-30"
"64054","2024","COM","2022","816","19","835","2024-12-30"
"64056","2024","COM","2022","136","9","145","2024-12-30"
"64057","2024","COM","2022","1829","43","1872","2024-12-30"
"64058","2024","COM","2022","458","9","467","2024-12-30"
"64059","2024","COM","2022","1100","28","1128","2024-12-30"
"64060","2024","COM","2022","2025","42","2067","2024-12-30"
"64061","2024","COM","2022","3446","68","3514","2024-12-30"
"64062","2024","COM","2022","2238","43","2281","2024-12-30"
"64063","2024","COM","2022","1052","22","1074","2024-12-30"
"64064","2024","COM","2022","492","5","497","2024-12-30"
"64065","2024","COM","2022","4561","91","4652","2024-12-30"
"64066","2024","COM","2022","344","11","355","2024-12-30"
"64067","2024","COM","2022","2055","56","2111","2024-12-30"
"64068","2024","COM","2022","1997","47","2044","2024-12-30"
"64069","2024","COM","2022","225","7","232","2024-12-30"
"64070","2024","COM","2022","350","2","352","2024-12-30"
"64071","2024","COM","2022","211","4","215","2024-12-30"
"64072","2024","COM","2022","662","14","676","2024-12-30"
"64073","2024","COM","2022","266","5","271","2024-12-30"
"64074","2024","COM","2022","45","2","47","2024-12-30"
"64075","2024","COM","2022","168","6","174","2024-12-30"
"64077","2024","COM","2022","185","3","188","2024-12-30"
"64078","2024","COM","2022","234","5","239","2024-12-30"
"64079","2024","COM","2022","108","2","110","2024-12-30"
"64080","2024","COM","2022","833","24","857","2024-12-30"
"64081","2024","COM","2022","235","3","238","2024-12-30"
"64082","2024","COM","2022","143","3","146","2024-12-30"
"64083","2024","COM","2022","213","2","215","2024-12-30"
"64084","2024","COM","2022","134","3","137","2024-12-30"
"64085","2024","COM","2022","103","1","104","2024-12-30"
"64086","2024","COM","2022","1133","36","1169","2024-12-30"
"64087","2024","COM","2022","867","23","890","2024-12-30"
"64088","2024","COM","2022","313","9","322","2024-12-30"
"64089","2024","COM","2022","131","4","135","2024-12-30"
"64090","2024","COM","2022","117","2","119","2024-12-30"
"64091","2024","COM","2022","504","7","511","2024-12-30"
"64092","2024","COM","2022","355","1","356","2024-12-30"
"64093","2024","COM","2022","645","13","658","2024-12-30"
"64094","2024","COM","2022","1905","50","1955","2024-12-30"
"64095","2024","COM","2022","584","10","594","2024-12-30"
"64096","2024","COM","2022","187","3","190","2024-12-30"
"64097","2024","COM","2022","627","11","638","2024-12-30"
"64098","2024","COM","2022","65","1","66","2024-12-30"
"64099","2024","COM","2022","96","5","101","2024-12-30"
"64100","2024","COM","2022","3317","98","3415","2024-12-30"
"64101","2024","COM","2022","585","109","694","2024-12-30"
"64102","2024","COM","2022","53312","1272","54584","2024-12-30"
"64103","2024","COM","2022","207","3","210","2024-12-30"
"64104","2024","COM","2022","574","14","588","2024-12-30"
"64105","2024","COM","2022","263","0","263","2024-12-30"
"64106","2024","COM","2022","505","9","514","2024-12-30"
"64107","2024","COM","2022","69","1","70","2024-12-30"
"64108","2024","COM","2022","911","12","923","2024-12-30"
"64109","2024","COM","2022","1987","41","2028","2024-12-30"
"64110","2024","COM","2022","228","4","232","2024-12-30"
"64111","2024","COM","2022","108","3","111","2024-12-30"
"64112","2024","COM","2022","423","8","431","2024-12-30"
"64113","2024","COM","2022","120","8","128","2024-12-30"
"64114","2024","COM","2022","587","2","589","2024-12-30"
"64115","2024","COM","2022","156","85","241","2024-12-30"
"64116","2024","COM","2022","248","6","254","2024-12-30"
"64117","2024","COM","2022","146","2","148","2024-12-30"
"64118","2024","COM","2022","48","0","48","2024-12-30"
"64119","2024","COM","2022","675","11","686","2024-12-30"
"64120","2024","COM","2022","536","10","546","2024-12-30"
"64121","2024","COM","2022","195","4","199","2024-12-30"
"64122","2024","COM","2022","25810","688","26498","2024-12-30"
"64123","2024","COM","2022","1347","24","1371","2024-12-30"
"64124","2024","COM","2022","675","18","693","2024-12-30"
"64125","2024","COM","2022","7674","141","7815","2024-12-30"
"64126","2024","COM","2022","1109","31","1140","2024-12-30"
"64127","2024","COM","2022","377","14","391","2024-12-30"
"64128","2024","COM","2022","155","5","160","2024-12-30"
"64129","2024","COM","2022","14037","240","14277","2024-12-30"
"64130","2024","COM","2022","1259","27","1286","2024-12-30"
"64131","2024","COM","2022","607","20","627","2024-12-30"
"64132","2024","COM","2022","4570","99","4669","2024-12-30"
"64133","2024","COM","2022","1330","24","1354","2024-12-30"
"64134","2024","COM","2022","371","7","378","2024-12-30"
"64135","2024","COM","2022","801","19","820","2024-12-30"
"64136","2024","COM","2022","114","2","116","2024-12-30"
"64137","2024","COM","2022","676","21","697","2024-12-30"
"64138","2024","COM","2022","2878","53","2931","2024-12-30"
"64139","2024","COM","2022","969","22","991","2024-12-30"
"64140","2024","COM","2022","8934","156","9090","2024-12-30"
"64141","2024","COM","2022","391","9","400","2024-12-30"
"64142","2024","COM","2022","857","18","875","2024-12-30"
"64143","2024","COM","2022","158","0","158","2024-12-30"
"64144","2024","COM","2022","156","4","160","2024-12-30"
"64145","2024","COM","2022","506","12","518","2024-12-30"
"64146","2024","COM","2022","341","3","344","2024-12-30"
"64147","2024","COM","2022","2920","72","2992","2024-12-30"
"64148","2024","COM","2022","850","24","874","2024-12-30"
"64149","2024","COM","2022","227","4","231","2024-12-30"
"64150","2024","COM","2022","134","3","137","2024-12-30"
"64151","2024","COM","2022","98","4","102","2024-12-30"
"64152","2024","COM","2022","1988","59","2047","2024-12-30"
"64153","2024","COM","2022","81","1","82","2024-12-30"
"64154","2024","COM","2022","211","2","213","2024-12-30"
"64155","2024","COM","2022","104","1","105","2024-12-30"
"64156","2024","COM","2022","477","15","492","2024-12-30"
"64157","2024","COM","2022","1011","21","1032","2024-12-30"
"64158","2024","COM","2022","170","5","175","2024-12-30"
"64159","2024","COM","2022","103","4","107","2024-12-30"
"64160","2024","COM","2022","6715","101","6816","2024-12-30"
"64161","2024","COM","2022","1019","28","1047","2024-12-30"
"64162","2024","COM","2022","105","2","107","2024-12-30"
"64165","2024","COM","2022","294","10","304","2024-12-30"
"64166","2024","COM","2022","174","8","182","2024-12-30"
"64167","2024","COM","2022","217","3","220","2024-12-30"
"64168","2024","COM","2022","662","14","676","2024-12-30"
"64170","2024","COM","2022","200","2","202","2024-12-30"
"64171","2024","COM","2022","271","1","272","2024-12-30"
"64172","2024","COM","2022","293","6","299","2024-12-30"
"64173","2024","COM","2022","159","2","161","2024-12-30"
"64174","2024","COM","2022","51","1","52","2024-12-30"
"64175","2024","COM","2022","141","3","144","2024-12-30"
"64176","2024","COM","2022","152","3","155","2024-12-30"
"64177","2024","COM","2022","644","15","659","2024-12-30"
"64178","2024","COM","2022","456","14","470","2024-12-30"
"64179","2024","COM","2022","137","1","138","2024-12-30"
"64180","2024","COM","2022","213","5","218","2024-12-30"
"64181","2024","COM","2022","336","11","347","2024-12-30"
"64182","2024","COM","2022","78","2","80","2024-12-30"
"64183","2024","COM","2022","675","20","695","2024-12-30"
"64184","2024","COM","2022","624","29","653","2024-12-30"
"64185","2024","COM","2022","59","1","60","2024-12-30"
"64186","2024","COM","2022","220","2","222","2024-12-30"
"64187","2024","COM","2022","245","7","252","2024-12-30"
"64188","2024","COM","2022","1048","139","1187","2024-12-30"
"64189","2024","COM","2022","5957","126","6083","2024-12-30"
"64190","2024","COM","2022","237","9","246","2024-12-30"
"64191","2024","COM","2022","2170","174","2344","2024-12-30"
"64192","2024","COM","2022","112","1","113","2024-12-30"
"64193","2024","COM","2022","95","2","97","2024-12-30"
"64194","2024","COM","2022","376","11","387","2024-12-30"
"64195","2024","COM","2022","89","2","91","2024-12-30"
"64196","2024","COM","2022","119","3","122","2024-12-30"
"64197","2024","COM","2022","189","4","193","2024-12-30"
"64198","2024","COM","2022","1774","51","1825","2024-12-30"
"64199","2024","COM","2022","144","4","148","2024-12-30"
"64200","2024","COM","2022","184","4","188","2024-12-30"
"64201","2024","COM","2022","230","8","238","2024-12-30"
"64202","2024","COM","2022","468","15","483","2024-12-30"
"64203","2024","COM","2022","327","7","334","2024-12-30"
"64204","2024","COM","2022","203","7","210","2024-12-30"
"64205","2024","COM","2022","237","2","239","2024-12-30"
"64206","2024","COM","2022","120","2","122","2024-12-30"
"64207","2024","COM","2022","430","12","442","2024-12-30"
"64208","2024","COM","2022","424","10","434","2024-12-30"
"64209","2024","COM","2022","426","8","434","2024-12-30"
"64210","2024","COM","2022","143","5","148","2024-12-30"
"64211","2024","COM","2022","376","5","381","2024-12-30"
"64212","2024","COM","2022","157","3","160","2024-12-30"
"64213","2024","COM","2022","2094","48","2142","2024-12-30"
"64214","2024","COM","2022","501","9","510","2024-12-30"
"64215","2024","COM","2022","110","1","111","2024-12-30"
"64216","2024","COM","2022","1206","47","1253","2024-12-30"
"64217","2024","COM","2022","531","13","544","2024-12-30"
"64218","2024","COM","2022","304","2","306","2024-12-30"
"64219","2024","COM","2022","260","6","266","2024-12-30"
"64220","2024","COM","2022","488","11","499","2024-12-30"
"64221","2024","COM","2022","147","41","188","2024-12-30"
"64222","2024","COM","2022","74","0","74","2024-12-30"
"64223","2024","COM","2022","63","0","63","2024-12-30"
"64224","2024","COM","2022","617","18","635","2024-12-30"
"64225","2024","COM","2022","619","16","635","2024-12-30"
"64226","2024","COM","2022","203","2","205","2024-12-30"
"64227","2024","COM","2022","676","15","691","2024-12-30"
"64228","2024","COM","2022","276","6","282","2024-12-30"
"64229","2024","COM","2022","127","4","131","2024-12-30"
"64230","2024","COM","2022","5649","124","5773","2024-12-30"
"64231","2024","COM","2022","459","10","469","2024-12-30"
"64232","2024","COM","2022","219","2","221","2024-12-30"
"64233","2024","COM","2022","1331","24","1355","2024-12-30"
"64234","2024","COM","2022","263","5","268","2024-12-30"
"64235","2024","COM","2022","317","9","326","2024-12-30"
"64236","2024","COM","2022","55","0","55","2024-12-30"
"64237","2024","COM","2022","3595","132","3727","2024-12-30"
"64238","2024","COM","2022","2118","51","2169","2024-12-30"
"64239","2024","COM","2022","140","7","147","2024-12-30"
"64240","2024","COM","2022","186","5","191","2024-12-30"
"64241","2024","COM","2022","490","8","498","2024-12-30"
"64242","2024","COM","2022","75","1","76","2024-12-30"
"64243","2024","COM","2022","218","4","222","2024-12-30"
"64244","2024","COM","2022","262","6","268","2024-12-30"
"64245","2024","COM","2022","540","14","554","2024-12-30"
"64246","2024","COM","2022","302","7","309","2024-12-30"
"64247","2024","COM","2022","473","11","484","2024-12-30"
"64249","2024","COM","2022","1315","29","1344","2024-12-30"
"64250","2024","COM","2022","1054","28","1082","2024-12-30"
"64251","2024","COM","2022","225","10","235","2024-12-30"
"64252","2024","COM","2022","887","28","915","2024-12-30"
"64253","2024","COM","2022","418","9","427","2024-12-30"
"64254","2024","COM","2022","570","11","581","2024-12-30"
"64255","2024","COM","2022","605","15","620","2024-12-30"
"64256","2024","COM","2022","7615","259","7874","2024-12-30"
"64257","2024","COM","2022","325","3","328","2024-12-30"
"64258","2024","COM","2022","85","1","86","2024-12-30"
"64259","2024","COM","2022","751","16","767","2024-12-30"
"64260","2024","COM","2022","18074","450","18524","2024-12-30"
"64261","2024","COM","2022","389","7","396","2024-12-30"
"64262","2024","COM","2022","276","6","282","2024-12-30"
"64263","2024","COM","2022","131","4","135","2024-12-30"
"64264","2024","COM","2022","56","2","58","2024-12-30"
"64265","2024","COM","2022","100","0","100","2024-12-30"
"64266","2024","COM","2022","230","9","239","2024-12-30"
"64267","2024","COM","2022","73","2","75","2024-12-30"
"64268","2024","COM","2022","271","6","277","2024-12-30"
"64269","2024","COM","2022","5134","143","5277","2024-12-30"
"64270","2024","COM","2022","1008","47","1055","2024-12-30"
"64271","2024","COM","2022","540","18","558","2024-12-30"
"64272","2024","COM","2022","150","2","152","2024-12-30"
"64273","2024","COM","2022","892","30","922","2024-12-30"
"64274","2024","COM","2022","366","10","376","2024-12-30"
"64275","2024","COM","2022","671","9","680","2024-12-30"
"64276","2024","COM","2022","248","6","254","2024-12-30"
"64277","2024","COM","2022","533","14","547","2024-12-30"
"64279","2024","COM","2022","2204","44","2248","2024-12-30"
"64280","2024","COM","2022","441","2","443","2024-12-30"
"64281","2024","COM","2022","149","3","152","2024-12-30"
"64282","2024","COM","2022","1258","33","1291","2024-12-30"
"64283","2024","COM","2022","210","1","211","2024-12-30"
"64284","2024","COM","2022","7063","238","7301","2024-12-30"
"64285","2024","COM","2022","200","7","207","2024-12-30"
"64286","2024","COM","2022","428","19","447","2024-12-30"
"64287","2024","COM","2022","138","2","140","2024-12-30"
"64288","2024","COM","2022","582","15","597","2024-12-30"
"64289","2024","COM","2022","987","21","1008","2024-12-30"
"64290","2024","COM","2022","594","16","610","2024-12-30"
"64291","2024","COM","2022","332","12","344","2024-12-30"
"64292","2024","COM","2022","258","3","261","2024-12-30"
"64293","2024","COM","2022","170","2","172","2024-12-30"
"64294","2024","COM","2022","144","2","146","2024-12-30"
"64295","2024","COM","2022","106","5","111","2024-12-30"
"64296","2024","COM","2022","145","5","150","2024-12-30"
"64297","2024","COM","2022","175","4","179","2024-12-30"
"64298","2024","COM","2022","117","1","118","2024-12-30"
"64299","2024","COM","2022","175","7","182","2024-12-30"
"64300","2024","COM","2022","1034","21","1055","2024-12-30"
"64301","2024","COM","2022","1134","31","1165","2024-12-30"
"64302","2024","COM","2022","468","9","477","2024-12-30"
"64303","2024","COM","2022","155","4","159","2024-12-30"
"64304","2024","COM","2022","2736","60","2796","2024-12-30"
"64305","2024","COM","2022","531","11","542","2024-12-30"
"64306","2024","COM","2022","710","18","728","2024-12-30"
"64307","2024","COM","2022","199","3","202","2024-12-30"
"64308","2024","COM","2022","251","6","257","2024-12-30"
"64309","2024","COM","2022","211","2","213","2024-12-30"
"64310","2024","COM","2022","479","8","487","2024-12-30"
"64311","2024","COM","2022","144","3","147","2024-12-30"
"64312","2024","COM","2022","303","9","312","2024-12-30"
"64313","2024","COM","2022","287","7","294","2024-12-30"
"64314","2024","COM","2022","446","3","449","2024-12-30"
"64315","2024","COM","2022","1035","27","1062","2024-12-30"
"64316","2024","COM","2022","185","5","190","2024-12-30"
"64317","2024","COM","2022","2123","49","2172","2024-12-30"
"64318","2024","COM","2022","192","2","194","2024-12-30"
"64319","2024","COM","2022","185","4","189","2024-12-30"
"64320","2024","COM","2022","1178","20","1198","2024-12-30"
"64321","2024","COM","2022","248","3","251","2024-12-30"
"64322","2024","COM","2022","337","3","340","2024-12-30"
"64323","2024","COM","2022","114","3","117","2024-12-30"
"64324","2024","COM","2022","1737","53","1790","2024-12-30"
"64325","2024","COM","2022","195","9","204","2024-12-30"
"64326","2024","COM","2022","126","1","127","2024-12-30"
"64327","2024","COM","2022","184","4","188","2024-12-30"
"64328","2024","COM","2022","1028","36","1064","2024-12-30"
"64329","2024","COM","2022","1266","49","1315","2024-12-30"
"64330","2024","COM","2022","232","10","242","2024-12-30"
"64331","2024","COM","2022","804","14","818","2024-12-30"
"64332","2024","COM","2022","168","5","173","2024-12-30"
"64334","2024","COM","2022","211","4","215","2024-12-30"
"64335","2024","COM","2022","9540","425","9965","2024-12-30"
"64336","2024","COM","2022","167","4","171","2024-12-30"
"64337","2024","COM","2022","152","3","155","2024-12-30"
"64338","2024","COM","2022","183","4","187","2024-12-30"
"64339","2024","COM","2022","795","55","850","2024-12-30"
"64340","2024","COM","2022","85","1","86","2024-12-30"
"64341","2024","COM","2022","133","1","134","2024-12-30"
"64342","2024","COM","2022","192","6","198","2024-12-30"
"64343","2024","COM","2022","706","6","712","2024-12-30"
"64344","2024","COM","2022","364","13","377","2024-12-30"
"64345","2024","COM","2022","194","5","199","2024-12-30"
"64346","2024","COM","2022","208","1","209","2024-12-30"
"64347","2024","COM","2022","222","3","225","2024-12-30"
"64348","2024","COM","2022","13708","244","13952","2024-12-30"
"64349","2024","COM","2022","493","19","512","2024-12-30"
"64350","2024","COM","2022","871","31","902","2024-12-30"
"64351","2024","COM","2022","141","1","142","2024-12-30"
"64352","2024","COM","2022","415","12","427","2024-12-30"
"64353","2024","COM","2022","1073","40","1113","2024-12-30"
"64354","2024","COM","2022","130","4","134","2024-12-30"
"64355","2024","COM","2022","136","2","138","2024-12-30"
"64356","2024","COM","2022","106","3","109","2024-12-30"
"64357","2024","COM","2022","64","0","64","2024-12-30"
"64358","2024","COM","2022","265","3","268","2024-12-30"
"64359","2024","COM","2022","926","31","957","2024-12-30"
"64360","2024","COM","2022","206","5","211","2024-12-30"
"64361","2024","COM","2022","184","7","191","2024-12-30"
"64362","2024","COM","2022","399","32","431","2024-12-30"
"64363","2024","COM","2022","322","11","333","2024-12-30"
"64364","2024","COM","2022","594","10","604","2024-12-30"
"64365","2024","COM","2022","444","8","452","2024-12-30"
"64366","2024","COM","2022","112","1","113","2024-12-30"
"64367","2024","COM","2022","888","30","918","2024-12-30"
"64368","2024","COM","2022","271","8","279","2024-12-30"
"64369","2024","COM","2022","238","11","249","2024-12-30"
"64370","2024","COM","2022","567","10","577","2024-12-30"
"64371","2024","COM","2022","2975","238","3213","2024-12-30"
"64372","2024","COM","2022","88","1","89","2024-12-30"
"64373","2024","COM","2022","1831","39","1870","2024-12-30"
"64374","2024","COM","2022","1188","25","1213","2024-12-30"
"64375","2024","COM","2022","278","6","284","2024-12-30"
"64376","2024","COM","2022","948","26","974","2024-12-30"
"64377","2024","COM","2022","849","19","868","2024-12-30"
"64378","2024","COM","2022","207","124","331","2024-12-30"
"64379","2024","COM","2022","162","5","167","2024-12-30"
"64380","2024","COM","2022","234","6","240","2024-12-30"
"64381","2024","COM","2022","279","9","288","2024-12-30"
"64382","2024","COM","2022","328","9","337","2024-12-30"
"64383","2024","COM","2022","140","2","142","2024-12-30"
"64385","2024","COM","2022","281","8","289","2024-12-30"
"64386","2024","COM","2022","1254","27","1281","2024-12-30"
"64387","2024","COM","2022","612","7","619","2024-12-30"
"64388","2024","COM","2022","110","1","111","2024-12-30"
"64389","2024","COM","2022","372","6","378","2024-12-30"
"64390","2024","COM","2022","154","13","167","2024-12-30"
"64391","2024","COM","2022","289","9","298","2024-12-30"
"64392","2024","COM","2022","85","1","86","2024-12-30"
"64393","2024","COM","2022","4436","110","4546","2024-12-30"
"64394","2024","COM","2022","81","5","86","2024-12-30"
"64395","2024","COM","2022","134","1","135","2024-12-30"
"64396","2024","COM","2022","1136","83","1219","2024-12-30"
"64397","2024","COM","2022","117","6","123","2024-12-30"
"64398","2024","COM","2022","416","7","423","2024-12-30"
"64399","2024","COM","2022","2420","311","2731","2024-12-30"
"64400","2024","COM","2022","1121","43","1164","2024-12-30"
"64401","2024","COM","2022","81","1","82","2024-12-30"
"64403","2024","COM","2022","189","5","194","2024-12-30"
"64404","2024","COM","2022","314","9","323","2024-12-30"
"64405","2024","COM","2022","4367","199","4566","2024-12-30"
"64406","2024","COM","2022","613","16","629","2024-12-30"
"64407","2024","COM","2022","5353","154","5507","2024-12-30"
"64408","2024","COM","2022","69","1","70","2024-12-30"
"64409","2024","COM","2022","818","26","844","2024-12-30"
"64410","2024","COM","2022","5744","168","5912","2024-12-30"
"64411","2024","COM","2022","225","7","232","2024-12-30"
"64412","2024","COM","2022","84","1","85","2024-12-30"
"64413","2024","COM","2022","756","16","772","2024-12-30"
"64414","2024","COM","2022","122","5","127","2024-12-30"
"64415","2024","COM","2022","1547","35","1582","2024-12-30"
"64416","2024","COM","2022","1046","22","1068","2024-12-30"
"64417","2024","COM","2022","3203","187","3390","2024-12-30"
"64418","2024","COM","2022","125","2","127","2024-12-30"
"64419","2024","COM","2022","1591","30","1621","2024-12-30"
"64420","2024","COM","2022","242","3","245","2024-12-30"
"64421","2024","COM","2022","1274","29","1303","2024-12-30"
"64422","2024","COM","2022","10658","651","11309","2024-12-30"
"64423","2024","COM","2022","187","4","191","2024-12-30"
"64424","2024","COM","2022","552","7","559","2024-12-30"
"64425","2024","COM","2022","517","11","528","2024-12-30"
"64426","2024","COM","2022","266","6","272","2024-12-30"
"64427","2024","COM","2022","148","2","150","2024-12-30"
"64428","2024","COM","2022","142","1","143","2024-12-30"
"64429","2024","COM","2022","103","2","105","2024-12-30"
"64430","2024","COM","2022","10836","644","11480","2024-12-30"
"64431","2024","COM","2022","548","10","558","2024-12-30"
"64432","2024","COM","2022","89","1","90","2024-12-30"
"64433","2024","COM","2022","332","19","351","2024-12-30"
"64434","2024","COM","2022","52","0","52","2024-12-30"
"64435","2024","COM","2022","228","8","236","2024-12-30"
"64436","2024","COM","2022","876","18","894","2024-12-30"
"64437","2024","COM","2022","224","5","229","2024-12-30"
"64438","2024","COM","2022","552","18","570","2024-12-30"
"64439","2024","COM","2022","1667","56","1723","2024-12-30"
"64440","2024","COM","2022","378","12","390","2024-12-30"
"64441","2024","COM","2022","251","10","261","2024-12-30"
"64442","2024","COM","2022","321","7","328","2024-12-30"
"64443","2024","COM","2022","920","24","944","2024-12-30"
"64444","2024","COM","2022","447","14","461","2024-12-30"
"64445","2024","COM","2022","78620","1362","79982","2024-12-30"
"64446","2024","COM","2022","146","2","148","2024-12-30"
"64447","2024","COM","2022","139","1","140","2024-12-30"
"64448","2024","COM","2022","1860","50","1910","2024-12-30"
"64449","2024","COM","2022","165","2","167","2024-12-30"
"64450","2024","COM","2022","297","8","305","2024-12-30"
"64451","2024","COM","2022","98","3","101","2024-12-30"
"64452","2024","COM","2022","258","6","264","2024-12-30"
"64453","2024","COM","2022","2916","59","2975","2024-12-30"
"64454","2024","COM","2022","176","1","177","2024-12-30"
"64455","2024","COM","2022","162","1","163","2024-12-30"
"64456","2024","COM","2022","50","1","51","2024-12-30"
"64457","2024","COM","2022","184","5","189","2024-12-30"
"64458","2024","COM","2022","295","10","305","2024-12-30"
"64459","2024","COM","2022","179","2","181","2024-12-30"
"64460","2024","COM","2022","405","8","413","2024-12-30"
"64461","2024","COM","2022","1089","20","1109","2024-12-30"
"64462","2024","COM","2022","484","6","490","2024-12-30"
"64463","2024","COM","2022","643","7","650","2024-12-30"
"64464","2024","COM","2022","81","1","82","2024-12-30"
"64465","2024","COM","2022","238","1","239","2024-12-30"
"64466","2024","COM","2022","271","14","285","2024-12-30"
"64467","2024","COM","2022","868","16","884","2024-12-30"
"64468","2024","COM","2022","121","3","124","2024-12-30"
"64469","2024","COM","2022","300","6","306","2024-12-30"
"64470","2024","COM","2022","614","12","626","2024-12-30"
"64471","2024","COM","2022","370","2","372","2024-12-30"
"64472","2024","COM","2022","857","12","869","2024-12-30"
"64473","2024","COM","2022","356","6","362","2024-12-30"
"64474","2024","COM","2022","159","4","163","2024-12-30"
"64475","2024","COM","2022","172","4","176","2024-12-30"
"64476","2024","COM","2022","443","8","451","2024-12-30"
"64477","2024","COM","2022","1540","29","1569","2024-12-30"
"64478","2024","COM","2022","740","18","758","2024-12-30"
"64479","2024","COM","2022","179","7","186","2024-12-30"
"64480","2024","COM","2022","198","6","204","2024-12-30"
"64481","2024","COM","2022","224","6","230","2024-12-30"
"64482","2024","COM","2022","634","17","651","2024-12-30"
"64483","2024","COM","2022","14690","385","15075","2024-12-30"
"64484","2024","COM","2022","878","14","892","2024-12-30"
"64485","2024","COM","2022","1487","299","1786","2024-12-30"
"64486","2024","COM","2022","74","4","78","2024-12-30"
"64487","2024","COM","2022","195","6","201","2024-12-30"
"64488","2024","COM","2022","444","9","453","2024-12-30"
"64489","2024","COM","2022","348","11","359","2024-12-30"
"64490","2024","COM","2022","544","7","551","2024-12-30"
"64491","2024","COM","2022","198","7","205","2024-12-30"
"64492","2024","COM","2022","288","6","294","2024-12-30"
"64493","2024","COM","2022","2155","86","2241","2024-12-30"
"64494","2024","COM","2022","268","6","274","2024-12-30"
"64495","2024","COM","2022","7238","194","7432","2024-12-30"
"64496","2024","COM","2022","5779","102","5881","2024-12-30"
"64498","2024","COM","2022","395","8","403","2024-12-30"
"64499","2024","COM","2022","4642","119","4761","2024-12-30"
"64500","2024","COM","2022","312","7","319","2024-12-30"
"64501","2024","COM","2022","585","13","598","2024-12-30"
"64502","2024","COM","2022","703","25","728","2024-12-30"
"64503","2024","COM","2022","95","3","98","2024-12-30"
"64504","2024","COM","2022","2736","40","2776","2024-12-30"
"64505","2024","COM","2022","290","14","304","2024-12-30"
"64506","2024","COM","2022","155","2","157","2024-12-30"
"64507","2024","COM","2022","150","2","152","2024-12-30"
"64508","2024","COM","2022","126","3","129","2024-12-30"
"64509","2024","COM","2022","169","4","173","2024-12-30"
"64510","2024","COM","2022","944","17","961","2024-12-30"
"64511","2024","COM","2022","3542","89","3631","2024-12-30"
"64512","2024","COM","2022","276","4","280","2024-12-30"
"64513","2024","COM","2022","1361","95","1456","2024-12-30"
"64514","2024","COM","2022","210","0","210","2024-12-30"
"64515","2024","COM","2022","228","5","233","2024-12-30"
"64516","2024","COM","2022","391","8","399","2024-12-30"
"64517","2024","COM","2022","156","8","164","2024-12-30"
"64518","2024","COM","2022","1156","30","1186","2024-12-30"
"64519","2024","COM","2022","4411","131","4542","2024-12-30"
"64520","2024","COM","2022","856","25","881","2024-12-30"
"64521","2024","COM","2022","601","17","618","2024-12-30"
"64522","2024","COM","2022","573","9","582","2024-12-30"
"64523","2024","COM","2022","796","14","810","2024-12-30"
"64524","2024","COM","2022","422","10","432","2024-12-30"
"64525","2024","COM","2022","840","11","851","2024-12-30"
"64526","2024","COM","2022","1587","21","1608","2024-12-30"
"64527","2024","COM","2022","1489","30","1519","2024-12-30"
"64528","2024","COM","2022","165","2","167","2024-12-30"
"64529","2024","COM","2022","383","11","394","2024-12-30"
"64530","2024","COM","2022","351","10","361","2024-12-30"
"64531","2024","COM","2022","47","0","47","2024-12-30"
"64532","2024","COM","2022","73","1","74","2024-12-30"
"64533","2024","COM","2022","579","9","588","2024-12-30"
"64534","2024","COM","2022","171","3","174","2024-12-30"
"64535","2024","COM","2022","543","4","547","2024-12-30"
"64536","2024","COM","2022","890","18","908","2024-12-30"
"64537","2024","COM","2022","141","2","143","2024-12-30"
"64538","2024","COM","2022","795","20","815","2024-12-30"
"64539","2024","COM","2022","217","5","222","2024-12-30"
"64540","2024","COM","2022","3006","80","3086","2024-12-30"
"64542","2024","COM","2022","70","1","71","2024-12-30"
"64543","2024","COM","2022","274","1","275","2024-12-30"
"64544","2024","COM","2022","77","2","79","2024-12-30"
"64545","2024","COM","2022","10594","162","10756","2024-12-30"
"64546","2024","COM","2022","2342","51","2393","2024-12-30"
"64547","2024","COM","2022","7684","230","7914","2024-12-30"
"64548","2024","COM","2022","164","4","168","2024-12-30"
"64549","2024","COM","2022","1320","21","1341","2024-12-30"
"64550","2024","COM","2022","851","16","867","2024-12-30"
"64551","2024","COM","2022","304","4","308","2024-12-30"
"64552","2024","COM","2022","146","8","154","2024-12-30"
"64554","2024","COM","2022","227","1","228","2024-12-30"
"64555","2024","COM","2022","162","2","164","2024-12-30"
"64556","2024","COM","2022","381","3","384","2024-12-30"
"64557","2024","COM","2022","456","17","473","2024-12-30"
"64558","2024","COM","2022","2957","81","3038","2024-12-30"
"64559","2024","COM","2022","748","16","764","2024-12-30"
"64560","2024","COM","2022","175","0","175","2024-12-30"
"65001","2024","COM","2022","302","3","305","2024-12-30"
"65002","2024","COM","2022","834","12","846","2024-12-30"
"65003","2024","COM","2022","147","5","152","2024-12-30"
"65004","2024","COM","2022","393","11","404","2024-12-30"
"65005","2024","COM","2022","441","10","451","2024-12-30"
"65006","2024","COM","2022","286","8","294","2024-12-30"
"65007","2024","COM","2022","1349","23","1372","2024-12-30"
"65009","2024","COM","2022","168","8","176","2024-12-30"
"65010","2024","COM","2022","227","7","234","2024-12-30"
"65011","2024","COM","2022","131","4","135","2024-12-30"
"65012","2024","COM","2022","82","3","85","2024-12-30"
"65013","2024","COM","2022","57","2","59","2024-12-30"
"65014","2024","COM","2022","40","0","40","2024-12-30"
"65015","2024","COM","2022","94","5","99","2024-12-30"
"65016","2024","COM","2022","187","3","190","2024-12-30"
"65017","2024","COM","2022","286","5","291","2024-12-30"
"65018","2024","COM","2022","78","1","79","2024-12-30"
"65019","2024","COM","2022","600","12","612","2024-12-30"
"65020","2024","COM","2022","254","7","261","2024-12-30"
"65021","2024","COM","2022","392","7","399","2024-12-30"
"65022","2024","COM","2022","115","7","122","2024-12-30"
"65023","2024","COM","2022","12","0","12","2024-12-30"
"65024","2024","COM","2022","103","1","104","2024-12-30"
"65025","2024","COM","2022","2805","151","2956","2024-12-30"
"65026","2024","COM","2022","86","2","88","2024-12-30"
"65028","2024","COM","2022","182","6","188","2024-12-30"
"65029","2024","COM","2022","494","13","507","2024-12-30"
"65031","2024","COM","2022","732","19","751","2024-12-30"
"65032","2024","COM","2022","696","20","716","2024-12-30"
"65033","2024","COM","2022","113","3","116","2024-12-30"
"65034","2024","COM","2022","23","1","24","2024-12-30"
"65035","2024","COM","2022","509","17","526","2024-12-30"
"65036","2024","COM","2022","135","3","138","2024-12-30"
"65037","2024","COM","2022","84","1","85","2024-12-30"
"65038","2024","COM","2022","13","1","14","2024-12-30"
"65039","2024","COM","2022","41","0","41","2024-12-30"
"65040","2024","COM","2022","301","8","309","2024-12-30"
"65041","2024","COM","2022","120","8","128","2024-12-30"
"65042","2024","COM","2022","572","12","584","2024-12-30"
"65043","2024","COM","2022","265","7","272","2024-12-30"
"65044","2024","COM","2022","286","6","292","2024-12-30"
"65045","2024","COM","2022","254","3","257","2024-12-30"
"65046","2024","COM","2022","99","3","102","2024-12-30"
"65047","2024","COM","2022","8033","124","8157","2024-12-30"
"65048","2024","COM","2022","768","13","781","2024-12-30"
"65049","2024","COM","2022","239","3","242","2024-12-30"
"65050","2024","COM","2022","81","2","83","2024-12-30"
"65051","2024","COM","2022","207","6","213","2024-12-30"
"65052","2024","COM","2022","86","1","87","2024-12-30"
"65053","2024","COM","2022","41","0","41","2024-12-30"
"65054","2024","COM","2022","582","10","592","2024-12-30"
"65055","2024","COM","2022","345","11","356","2024-12-30"
"65056","2024","COM","2022","463","12","475","2024-12-30"
"65057","2024","COM","2022","968","22","990","2024-12-30"
"65058","2024","COM","2022","146","1","147","2024-12-30"
"65059","2024","COM","2022","7060","268","7328","2024-12-30"
"65060","2024","COM","2022","65","2","67","2024-12-30"
"65061","2024","COM","2022","42","3","45","2024-12-30"
"65062","2024","COM","2022","3495","67","3562","2024-12-30"
"65063","2024","COM","2022","164","9","173","2024-12-30"
"65064","2024","COM","2022","39","2","41","2024-12-30"
"65065","2024","COM","2022","320","2","322","2024-12-30"
"65066","2024","COM","2022","38","2","40","2024-12-30"
"65067","2024","COM","2022","133","6","139","2024-12-30"
"65068","2024","COM","2022","26","1","27","2024-12-30"
"65069","2024","COM","2022","1245","29","1274","2024-12-30"
"65070","2024","COM","2022","510","15","525","2024-12-30"
"65071","2024","COM","2022","36","0","36","2024-12-30"
"65072","2024","COM","2022","1877","14","1891","2024-12-30"
"65073","2024","COM","2022","369","7","376","2024-12-30"
"65074","2024","COM","2022","109","2","111","2024-12-30"
"65075","2024","COM","2022","144","6","150","2024-12-30"
"65076","2024","COM","2022","46","0","46","2024-12-30"
"65077","2024","COM","2022","417","24","441","2024-12-30"
"65078","2024","COM","2022","392","12","404","2024-12-30"
"65079","2024","COM","2022","191","3","194","2024-12-30"
"65080","2024","COM","2022","530","14","544","2024-12-30"
"65081","2024","COM","2022","137","3","140","2024-12-30"
"65082","2024","COM","2022","44","1","45","2024-12-30"
"65083","2024","COM","2022","739","18","757","2024-12-30"
"65084","2024","COM","2022","283","6","289","2024-12-30"
"65085","2024","COM","2022","99","5","104","2024-12-30"
"65086","2024","COM","2022","147","6","153","2024-12-30"
"65087","2024","COM","2022","155","3","158","2024-12-30"
"65088","2024","COM","2022","46","0","46","2024-12-30"
"65089","2024","COM","2022","80","5","85","2024-12-30"
"65090","2024","COM","2022","74","3","77","2024-12-30"
"65091","2024","COM","2022","60","1","61","2024-12-30"
"65092","2024","COM","2022","210","2","212","2024-12-30"
"65093","2024","COM","2022","208","6","214","2024-12-30"
"65094","2024","COM","2022","128","1","129","2024-12-30"
"65095","2024","COM","2022","319","7","326","2024-12-30"
"65096","2024","COM","2022","71","3","74","2024-12-30"
"65097","2024","COM","2022","193","6","199","2024-12-30"
"65098","2024","COM","2022","319","5","324","2024-12-30"
"65099","2024","COM","2022","143","1","144","2024-12-30"
"65100","2024","COM","2022","5394","120","5514","2024-12-30"
"65101","2024","COM","2022","753","11","764","2024-12-30"
"65102","2024","COM","2022","22","1","23","2024-12-30"
"65103","2024","COM","2022","121","0","121","2024-12-30"
"65104","2024","COM","2022","300","9","309","2024-12-30"
"65105","2024","COM","2022","196","1","197","2024-12-30"
"65106","2024","COM","2022","190","3","193","2024-12-30"
"65107","2024","COM","2022","118","2","120","2024-12-30"
"65108","2024","COM","2022","889","18","907","2024-12-30"
"65109","2024","COM","2022","30","0","30","2024-12-30"
"65110","2024","COM","2022","97","0","97","2024-12-30"
"65111","2024","COM","2022","59","0","59","2024-12-30"
"65112","2024","COM","2022","153","5","158","2024-12-30"
"65113","2024","COM","2022","278","4","282","2024-12-30"
"65114","2024","COM","2022","81","2","83","2024-12-30"
"65115","2024","COM","2022","304","6","310","2024-12-30"
"65116","2024","COM","2022","304","9","313","2024-12-30"
"65117","2024","COM","2022","45","1","46","2024-12-30"
"65118","2024","COM","2022","30","0","30","2024-12-30"
"65119","2024","COM","2022","346","11","357","2024-12-30"
"65120","2024","COM","2022","332","14","346","2024-12-30"
"65121","2024","COM","2022","377","11","388","2024-12-30"
"65123","2024","COM","2022","1264","26","1290","2024-12-30"
"65124","2024","COM","2022","51","3","54","2024-12-30"
"65125","2024","COM","2022","314","7","321","2024-12-30"
"65126","2024","COM","2022","144","4","148","2024-12-30"
"65127","2024","COM","2022","1286","26","1312","2024-12-30"
"65128","2024","COM","2022","137","4","141","2024-12-30"
"65129","2024","COM","2022","765","13","778","2024-12-30"
"65130","2024","COM","2022","648","3","651","2024-12-30"
"65131","2024","COM","2022","243","5","248","2024-12-30"
"65132","2024","COM","2022","45","2","47","2024-12-30"
"65133","2024","COM","2022","225","4","229","2024-12-30"
"65134","2024","COM","2022","17","1","18","2024-12-30"
"65135","2024","COM","2022","76","1","77","2024-12-30"
"65136","2024","COM","2022","30","0","30","2024-12-30"
"65137","2024","COM","2022","98","1","99","2024-12-30"
"65138","2024","COM","2022","859","19","878","2024-12-30"
"65139","2024","COM","2022","58","1","59","2024-12-30"
"65140","2024","COM","2022","33","1","34","2024-12-30"
"65141","2024","COM","2022","65","3","68","2024-12-30"
"65142","2024","COM","2022","215","3","218","2024-12-30"
"65143","2024","COM","2022","107","2","109","2024-12-30"
"65144","2024","COM","2022","86","1","87","2024-12-30"
"65145","2024","COM","2022","49","1","50","2024-12-30"
"65146","2024","COM","2022","302","6","308","2024-12-30"
"65147","2024","COM","2022","606","11","617","2024-12-30"
"65148","2024","COM","2022","136","0","136","2024-12-30"
"65149","2024","COM","2022","162","3","165","2024-12-30"
"65150","2024","COM","2022","502","17","519","2024-12-30"
"65151","2024","COM","2022","152","4","156","2024-12-30"
"65153","2024","COM","2022","110","4","114","2024-12-30"
"65154","2024","COM","2022","46","1","47","2024-12-30"
"65155","2024","COM","2022","50","2","52","2024-12-30"
"65156","2024","COM","2022","219","6","225","2024-12-30"
"65157","2024","COM","2022","25","0","25","2024-12-30"
"65158","2024","COM","2022","79","0","79","2024-12-30"
"65159","2024","COM","2022","351","11","362","2024-12-30"
"65160","2024","COM","2022","117","3","120","2024-12-30"
"65161","2024","COM","2022","281","3","284","2024-12-30"
"65162","2024","COM","2022","34","0","34","2024-12-30"
"65163","2024","COM","2022","44","0","44","2024-12-30"
"65164","2024","COM","2022","94","0","94","2024-12-30"
"65165","2024","COM","2022","166","0","166","2024-12-30"
"65166","2024","COM","2022","42","1","43","2024-12-30"
"65167","2024","COM","2022","25","0","25","2024-12-30"
"65168","2024","COM","2022","417","12","429","2024-12-30"
"65169","2024","COM","2022","94","3","97","2024-12-30"
"65170","2024","COM","2022","74","3","77","2024-12-30"
"65171","2024","COM","2022","34","0","34","2024-12-30"
"65172","2024","COM","2022","45","1","46","2024-12-30"
"65173","2024","COM","2022","186","6","192","2024-12-30"
"65174","2024","COM","2022","103","4","107","2024-12-30"
"65175","2024","COM","2022","38","2","40","2024-12-30"
"65176","2024","COM","2022","87","0","87","2024-12-30"
"65177","2024","COM","2022","168","3","171","2024-12-30"
"65178","2024","COM","2022","47","0","47","2024-12-30"
"65179","2024","COM","2022","31","1","32","2024-12-30"
"65180","2024","COM","2022","16","0","16","2024-12-30"
"65181","2024","COM","2022","173","3","176","2024-12-30"
"65182","2024","COM","2022","126","6","132","2024-12-30"
"65183","2024","COM","2022","698","9","707","2024-12-30"
"65184","2024","COM","2022","176","3","179","2024-12-30"
"65185","2024","COM","2022","440","12","452","2024-12-30"
"65186","2024","COM","2022","38","0","38","2024-12-30"
"65187","2024","COM","2022","94","4","98","2024-12-30"
"65189","2024","COM","2022","267","13","280","2024-12-30"
"65190","2024","COM","2022","70","2","72","2024-12-30"
"65191","2024","COM","2022","129","4","133","2024-12-30"
"65192","2024","COM","2022","341","8","349","2024-12-30"
"65193","2024","COM","2022","91","4","95","2024-12-30"
"65194","2024","COM","2022","93","2","95","2024-12-30"
"65195","2024","COM","2022","132","1","133","2024-12-30"
"65196","2024","COM","2022","87","2","89","2024-12-30"
"65197","2024","COM","2022","158","5","163","2024-12-30"
"65198","2024","COM","2022","1194","28","1222","2024-12-30"
"65199","2024","COM","2022","33","0","33","2024-12-30"
"65200","2024","COM","2022","101","1","102","2024-12-30"
"65201","2024","COM","2022","184","4","188","2024-12-30"
"65202","2024","COM","2022","328","13","341","2024-12-30"
"65203","2024","COM","2022","23","0","23","2024-12-30"
"65204","2024","COM","2022","29","0","29","2024-12-30"
"65205","2024","COM","2022","55","0","55","2024-12-30"
"65206","2024","COM","2022","239","6","245","2024-12-30"
"65207","2024","COM","2022","60","0","60","2024-12-30"
"65208","2024","COM","2022","23","0","23","2024-12-30"
"65209","2024","COM","2022","82","4","86","2024-12-30"
"65210","2024","COM","2022","37","0","37","2024-12-30"
"65211","2024","COM","2022","149","4","153","2024-12-30"
"65212","2024","COM","2022","313","7","320","2024-12-30"
"65213","2024","COM","2022","116","1","117","2024-12-30"
"65214","2024","COM","2022","46","1","47","2024-12-30"
"65215","2024","COM","2022","42","2","44","2024-12-30"
"65216","2024","COM","2022","96","0","96","2024-12-30"
"65217","2024","COM","2022","60","2","62","2024-12-30"
"65218","2024","COM","2022","589","12","601","2024-12-30"
"65219","2024","COM","2022","101","2","103","2024-12-30"
"65220","2024","COM","2022","233","2","235","2024-12-30"
"65221","2024","COM","2022","265","6","271","2024-12-30"
"65222","2024","COM","2022","137","8","145","2024-12-30"
"65223","2024","COM","2022","1201","25","1226","2024-12-30"
"65224","2024","COM","2022","284","8","292","2024-12-30"
"65225","2024","COM","2022","109","1","110","2024-12-30"
"65226","2024","COM","2022","2921","141","3062","2024-12-30"
"65228","2024","COM","2022","121","0","121","2024-12-30"
"65229","2024","COM","2022","53","0","53","2024-12-30"
"65230","2024","COM","2022","257","6","263","2024-12-30"
"65231","2024","COM","2022","210","13","223","2024-12-30"
"65232","2024","COM","2022","67","2","69","2024-12-30"
"65233","2024","COM","2022","303","10","313","2024-12-30"
"65234","2024","COM","2022","104","1","105","2024-12-30"
"65235","2024","COM","2022","4019","97","4116","2024-12-30"
"65236","2024","COM","2022","457","11","468","2024-12-30"
"65237","2024","COM","2022","167","4","171","2024-12-30"
"65238","2024","COM","2022","231","6","237","2024-12-30"
"65239","2024","COM","2022","148","6","154","2024-12-30"
"65240","2024","COM","2022","386","7","393","2024-12-30"
"65241","2024","COM","2022","84","3","87","2024-12-30"
"65242","2024","COM","2022","247","6","253","2024-12-30"
"65243","2024","COM","2022","439","18","457","2024-12-30"
"65244","2024","COM","2022","530","8","538","2024-12-30"
"65245","2024","COM","2022","255","4","259","2024-12-30"
"65247","2024","COM","2022","99","1","100","2024-12-30"
"65248","2024","COM","2022","262","15","277","2024-12-30"
"65249","2024","COM","2022","100","3","103","2024-12-30"
"65250","2024","COM","2022","118","2","120","2024-12-30"
"65251","2024","COM","2022","1858","64","1922","2024-12-30"
"65252","2024","COM","2022","867","21","888","2024-12-30"
"65253","2024","COM","2022","54","0","54","2024-12-30"
"65254","2024","COM","2022","150","3","153","2024-12-30"
"65255","2024","COM","2022","30","0","30","2024-12-30"
"65256","2024","COM","2022","144","4","148","2024-12-30"
"65257","2024","COM","2022","604","10","614","2024-12-30"
"65258","2024","COM","2022","5810","178","5988","2024-12-30"
"65259","2024","COM","2022","181","10","191","2024-12-30"
"65260","2024","COM","2022","91","3","94","2024-12-30"
"65261","2024","COM","2022","46","1","47","2024-12-30"
"65262","2024","COM","2022","382","8","390","2024-12-30"
"65263","2024","COM","2022","98","1","99","2024-12-30"
"65264","2024","COM","2022","312","32","344","2024-12-30"
"65265","2024","COM","2022","343","21","364","2024-12-30"
"65266","2024","COM","2022","37","0","37","2024-12-30"
"65267","2024","COM","2022","508","11","519","2024-12-30"
"65268","2024","COM","2022","245","3","248","2024-12-30"
"65269","2024","COM","2022","162","3","165","2024-12-30"
"65270","2024","COM","2022","207","7","214","2024-12-30"
"65271","2024","COM","2022","358","7","365","2024-12-30"
"65272","2024","COM","2022","76","1","77","2024-12-30"
"65273","2024","COM","2022","199","0","199","2024-12-30"
"65274","2024","COM","2022","136","4","140","2024-12-30"
"65275","2024","COM","2022","74","1","75","2024-12-30"
"65276","2024","COM","2022","112","4","116","2024-12-30"
"65277","2024","COM","2022","90","2","92","2024-12-30"
"65278","2024","COM","2022","36","0","36","2024-12-30"
"65279","2024","COM","2022","210","6","216","2024-12-30"
"65280","2024","COM","2022","435","5","440","2024-12-30"
"65281","2024","COM","2022","256","7","263","2024-12-30"
"65282","2024","COM","2022","348","9","357","2024-12-30"
"65283","2024","COM","2022","49","4","53","2024-12-30"
"65284","2024","COM","2022","1106","26","1132","2024-12-30"
"65285","2024","COM","2022","198","3","201","2024-12-30"
"65286","2024","COM","2022","13266","286","13552","2024-12-30"
"65287","2024","COM","2022","653","3","656","2024-12-30"
"65288","2024","COM","2022","61","1","62","2024-12-30"
"65289","2024","COM","2022","105","1","106","2024-12-30"
"65290","2024","COM","2022","175","1","176","2024-12-30"
"65291","2024","COM","2022","163","6","169","2024-12-30"
"65292","2024","COM","2022","422","13","435","2024-12-30"
"65293","2024","COM","2022","97","2","99","2024-12-30"
"65294","2024","COM","2022","214","5","219","2024-12-30"
"65295","2024","COM","2022","914","12","926","2024-12-30"
"65296","2024","COM","2022","424","12","436","2024-12-30"
"65297","2024","COM","2022","40","0","40","2024-12-30"
"65298","2024","COM","2022","86","0","86","2024-12-30"
"65299","2024","COM","2022","230","6","236","2024-12-30"
"65300","2024","COM","2022","65","2","67","2024-12-30"
"65301","2024","COM","2022","267","4","271","2024-12-30"
"65303","2024","COM","2022","368","16","384","2024-12-30"
"65304","2024","COM","2022","2232","25","2257","2024-12-30"
"65305","2024","COM","2022","103","0","103","2024-12-30"
"65306","2024","COM","2022","240","7","247","2024-12-30"
"65307","2024","COM","2022","346","4","350","2024-12-30"
"65308","2024","COM","2022","110","2","112","2024-12-30"
"65309","2024","COM","2022","14","0","14","2024-12-30"
"65310","2024","COM","2022","232","5","237","2024-12-30"
"65311","2024","COM","2022","98","3","101","2024-12-30"
"65313","2024","COM","2022","731","22","753","2024-12-30"
"65314","2024","COM","2022","203","8","211","2024-12-30"
"65315","2024","COM","2022","408","205","613","2024-12-30"
"65316","2024","COM","2022","109","1","110","2024-12-30"
"65317","2024","COM","2022","35","0","35","2024-12-30"
"65318","2024","COM","2022","238","1","239","2024-12-30"
"65319","2024","COM","2022","128","3","131","2024-12-30"
"65320","2024","COM","2022","813","16","829","2024-12-30"
"65321","2024","COM","2022","136","3","139","2024-12-30"
"65322","2024","COM","2022","248","8","256","2024-12-30"
"65323","2024","COM","2022","73","0","73","2024-12-30"
"65324","2024","COM","2022","212","5","217","2024-12-30"
"65325","2024","COM","2022","44","1","45","2024-12-30"
"65326","2024","COM","2022","77","3","80","2024-12-30"
"65327","2024","COM","2022","203","4","207","2024-12-30"
"65328","2024","COM","2022","94","1","95","2024-12-30"
"65329","2024","COM","2022","210","6","216","2024-12-30"
"65330","2024","COM","2022","230","2","232","2024-12-30"
"65331","2024","COM","2022","3291","85","3376","2024-12-30"
"65332","2024","COM","2022","183","2","185","2024-12-30"
"65333","2024","COM","2022","112","3","115","2024-12-30"
"65334","2024","COM","2022","222","18","240","2024-12-30"
"65335","2024","COM","2022","515","16","531","2024-12-30"
"65336","2024","COM","2022","29","0","29","2024-12-30"
"65337","2024","COM","2022","110","3","113","2024-12-30"
"65338","2024","COM","2022","251","3","254","2024-12-30"
"65339","2024","COM","2022","361","8","369","2024-12-30"
"65340","2024","COM","2022","1929","42","1971","2024-12-30"
"65341","2024","COM","2022","101","2","103","2024-12-30"
"65342","2024","COM","2022","91","2","93","2024-12-30"
"65343","2024","COM","2022","233","5","238","2024-12-30"
"65344","2024","COM","2022","2352","48","2400","2024-12-30"
"65345","2024","COM","2022","57","2","59","2024-12-30"
"65346","2024","COM","2022","151","6","157","2024-12-30"
"65347","2024","COM","2022","48","0","48","2024-12-30"
"65348","2024","COM","2022","43","1","44","2024-12-30"
"65349","2024","COM","2022","14","0","14","2024-12-30"
"65350","2024","COM","2022","1215","16","1231","2024-12-30"
"65351","2024","COM","2022","35","0","35","2024-12-30"
"65352","2024","COM","2022","206","6","212","2024-12-30"
"65353","2024","COM","2022","243","11","254","2024-12-30"
"65354","2024","COM","2022","83","3","86","2024-12-30"
"65355","2024","COM","2022","76","0","76","2024-12-30"
"65356","2024","COM","2022","62","2","64","2024-12-30"
"65357","2024","COM","2022","170","4","174","2024-12-30"
"65358","2024","COM","2022","63","2","65","2024-12-30"
"65359","2024","COM","2022","21","0","21","2024-12-30"
"65360","2024","COM","2022","274","6","280","2024-12-30"
"65361","2024","COM","2022","104","0","104","2024-12-30"
"65362","2024","COM","2022","1101","20","1121","2024-12-30"
"65363","2024","COM","2022","445","9","454","2024-12-30"
"65364","2024","COM","2022","22","2","24","2024-12-30"
"65366","2024","COM","2022","830","28","858","2024-12-30"
"65367","2024","COM","2022","154","5","159","2024-12-30"
"65368","2024","COM","2022","40","2","42","2024-12-30"
"65369","2024","COM","2022","650","18","668","2024-12-30"
"65370","2024","COM","2022","1108","36","1144","2024-12-30"
"65371","2024","COM","2022","240","10","250","2024-12-30"
"65372","2024","COM","2022","670","10","680","2024-12-30"
"65373","2024","COM","2022","158","5","163","2024-12-30"
"65374","2024","COM","2022","231","0","231","2024-12-30"
"65375","2024","COM","2022","1464","30","1494","2024-12-30"
"65376","2024","COM","2022","203","2","205","2024-12-30"
"65377","2024","COM","2022","150","8","158","2024-12-30"
"65378","2024","COM","2022","65","1","66","2024-12-30"
"65379","2024","COM","2022","13","1","14","2024-12-30"
"65380","2024","COM","2022","148","2","150","2024-12-30"
"65381","2024","COM","2022","33","0","33","2024-12-30"
"65382","2024","COM","2022","84","3","87","2024-12-30"
"65383","2024","COM","2022","196","1","197","2024-12-30"
"65384","2024","COM","2022","171","2","173","2024-12-30"
"65385","2024","COM","2022","98","3","101","2024-12-30"
"65386","2024","COM","2022","102","3","105","2024-12-30"
"65387","2024","COM","2022","121","3","124","2024-12-30"
"65388","2024","COM","2022","837","18","855","2024-12-30"
"65389","2024","COM","2022","960","35","995","2024-12-30"
"65390","2024","COM","2022","434","8","442","2024-12-30"
"65391","2024","COM","2022","59","0","59","2024-12-30"
"65392","2024","COM","2022","437","6","443","2024-12-30"
"65393","2024","COM","2022","149","5","154","2024-12-30"
"65394","2024","COM","2022","322","8","330","2024-12-30"
"65395","2024","COM","2022","1150","19","1169","2024-12-30"
"65396","2024","COM","2022","366","7","373","2024-12-30"
"65397","2024","COM","2022","158","4","162","2024-12-30"
"65398","2024","COM","2022","243","3","246","2024-12-30"
"65399","2024","COM","2022","89","2","91","2024-12-30"
"65400","2024","COM","2022","248","5","253","2024-12-30"
"65401","2024","COM","2022","568","25","593","2024-12-30"
"65402","2024","COM","2022","26","2","28","2024-12-30"
"65403","2024","COM","2022","100","6","106","2024-12-30"
"65404","2024","COM","2022","159","4","163","2024-12-30"
"65405","2024","COM","2022","78","1","79","2024-12-30"
"65406","2024","COM","2022","259","5","264","2024-12-30"
"65407","2024","COM","2022","106","5","111","2024-12-30"
"65408","2024","COM","2022","550","15","565","2024-12-30"
"65409","2024","COM","2022","273","4","277","2024-12-30"
"65410","2024","COM","2022","541","14","555","2024-12-30"
"65411","2024","COM","2022","72","9","81","2024-12-30"
"65412","2024","COM","2022","159","3","162","2024-12-30"
"65413","2024","COM","2022","152","5","157","2024-12-30"
"65414","2024","COM","2022","81","3","84","2024-12-30"
"65415","2024","COM","2022","259","5","264","2024-12-30"
"65416","2024","COM","2022","88","1","89","2024-12-30"
"65417","2024","COM","2022","5202","91","5293","2024-12-30"
"65418","2024","COM","2022","291","4","295","2024-12-30"
"65419","2024","COM","2022","77","1","78","2024-12-30"
"65420","2024","COM","2022","83","0","83","2024-12-30"
"65421","2024","COM","2022","41","4","45","2024-12-30"
"65422","2024","COM","2022","331","5","336","2024-12-30"
"65423","2024","COM","2022","128","1","129","2024-12-30"
"65424","2024","COM","2022","109","4","113","2024-12-30"
"65425","2024","COM","2022","462","5","467","2024-12-30"
"65426","2024","COM","2022","136","4","140","2024-12-30"
"65427","2024","COM","2022","287","5","292","2024-12-30"
"65428","2024","COM","2022","61","1","62","2024-12-30"
"65429","2024","COM","2022","198","5","203","2024-12-30"
"65430","2024","COM","2022","46","2","48","2024-12-30"
"65431","2024","COM","2022","99","1","100","2024-12-30"
"65432","2024","COM","2022","174","6","180","2024-12-30"
"65433","2024","COM","2022","3000","40","3040","2024-12-30"
"65435","2024","COM","2022","289","4","293","2024-12-30"
"65436","2024","COM","2022","300","11","311","2024-12-30"
"65437","2024","COM","2022","136","5","141","2024-12-30"
"65438","2024","COM","2022","76","2","78","2024-12-30"
"65439","2024","COM","2022","270","3","273","2024-12-30"
"65440","2024","COM","2022","44529","921","45450","2024-12-30"
"65441","2024","COM","2022","91","2","93","2024-12-30"
"65442","2024","COM","2022","230","6","236","2024-12-30"
"65443","2024","COM","2022","18","1","19","2024-12-30"
"65444","2024","COM","2022","330","1","331","2024-12-30"
"65445","2024","COM","2022","225","6","231","2024-12-30"
"65446","2024","COM","2022","547","4","551","2024-12-30"
"65447","2024","COM","2022","1296","21","1317","2024-12-30"
"65448","2024","COM","2022","78","4","82","2024-12-30"
"65449","2024","COM","2022","83","4","87","2024-12-30"
"65450","2024","COM","2022","35","0","35","2024-12-30"
"65451","2024","COM","2022","757","14","771","2024-12-30"
"65452","2024","COM","2022","993","26","1019","2024-12-30"
"65453","2024","COM","2022","75","1","76","2024-12-30"
"65454","2024","COM","2022","107","1","108","2024-12-30"
"65455","2024","COM","2022","425","8","433","2024-12-30"
"65456","2024","COM","2022","274","6","280","2024-12-30"
"65457","2024","COM","2022","86","1","87","2024-12-30"
"65458","2024","COM","2022","38","1","39","2024-12-30"
"65459","2024","COM","2022","104","0","104","2024-12-30"
"65460","2024","COM","2022","4830","261","5091","2024-12-30"
"65461","2024","COM","2022","81","2","83","2024-12-30"
"65462","2024","COM","2022","230","5","235","2024-12-30"
"65463","2024","COM","2022","83","1","84","2024-12-30"
"65464","2024","COM","2022","488","9","497","2024-12-30"
"65465","2024","COM","2022","304","11","315","2024-12-30"
"65466","2024","COM","2022","81","1","82","2024-12-30"
"65467","2024","COM","2022","94","6","100","2024-12-30"
"65468","2024","COM","2022","49","1","50","2024-12-30"
"65469","2024","COM","2022","19","1","20","2024-12-30"
"65470","2024","COM","2022","143","5","148","2024-12-30"
"65471","2024","COM","2022","201","8","209","2024-12-30"
"65472","2024","COM","2022","74","5","79","2024-12-30"
"65473","2024","COM","2022","353","10","363","2024-12-30"
"65474","2024","COM","2022","110","3","113","2024-12-30"
"65475","2024","COM","2022","65","3","68","2024-12-30"
"65476","2024","COM","2022","69","0","69","2024-12-30"
"65477","2024","COM","2022","110","2","112","2024-12-30"
"65478","2024","COM","2022","34","1","35","2024-12-30"
"65479","2024","COM","2022","368","10","378","2024-12-30"
"65481","2024","COM","2022","136","3","139","2024-12-30"
"65482","2024","COM","2022","433","11","444","2024-12-30"
"66001","2024","COM","2022","63","1","64","2024-12-30"
"66002","2024","COM","2022","3712","51","3763","2024-12-30"
"66003","2024","COM","2022","3553","46","3599","2024-12-30"
"66004","2024","COM","2022","584","10","594","2024-12-30"
"66005","2024","COM","2022","548","29","577","2024-12-30"
"66006","2024","COM","2022","168","5","173","2024-12-30"
"66007","2024","COM","2022","130","1","131","2024-12-30"
"66008","2024","COM","2022","10779","299","11078","2024-12-30"
"66009","2024","COM","2022","2805","35","2840","2024-12-30"
"66010","2024","COM","2022","44","0","44","2024-12-30"
"66011","2024","COM","2022","4519","54","4573","2024-12-30"
"66012","2024","COM","2022","3266","69","3335","2024-12-30"
"66013","2024","COM","2022","117","1","118","2024-12-30"
"66014","2024","COM","2022","2784","46","2830","2024-12-30"
"66015","2024","COM","2022","1397","15","1412","2024-12-30"
"66016","2024","COM","2022","4583","61","4644","2024-12-30"
"66017","2024","COM","2022","6203","39","6242","2024-12-30"
"66018","2024","COM","2022","62","0","62","2024-12-30"
"66019","2024","COM","2022","241","5","246","2024-12-30"
"66020","2024","COM","2022","805","31","836","2024-12-30"
"66021","2024","COM","2022","7712","104","7816","2024-12-30"
"66022","2024","COM","2022","64","1","65","2024-12-30"
"66023","2024","COM","2022","953","14","967","2024-12-30"
"66024","2024","COM","2022","5396","57","5453","2024-12-30"
"66025","2024","COM","2022","1194","75","1269","2024-12-30"
"66026","2024","COM","2022","1586","36","1622","2024-12-30"
"66027","2024","COM","2022","700","15","715","2024-12-30"
"66028","2024","COM","2022","10414","207","10621","2024-12-30"
"66029","2024","COM","2022","131","1","132","2024-12-30"
"66030","2024","COM","2022","224","4","228","2024-12-30"
"66032","2024","COM","2022","60","3","63","2024-12-30"
"66033","2024","COM","2022","463","12","475","2024-12-30"
"66034","2024","COM","2022","120","5","125","2024-12-30"
"66035","2024","COM","2022","42","0","42","2024-12-30"
"66036","2024","COM","2022","43","0","43","2024-12-30"
"66037","2024","COM","2022","13005","249","13254","2024-12-30"
"66038","2024","COM","2022","6575","97","6672","2024-12-30"
"66039","2024","COM","2022","130","0","130","2024-12-30"
"66040","2024","COM","2022","43","0","43","2024-12-30"
"66041","2024","COM","2022","978","22","1000","2024-12-30"
"66042","2024","COM","2022","290","0","290","2024-12-30"
"66043","2024","COM","2022","140","1","141","2024-12-30"
"66044","2024","COM","2022","286","6","292","2024-12-30"
"66045","2024","COM","2022","724","18","742","2024-12-30"
"66046","2024","COM","2022","585","6","591","2024-12-30"
"66047","2024","COM","2022","21","1","22","2024-12-30"
"66048","2024","COM","2022","1213","15","1228","2024-12-30"
"66049","2024","COM","2022","7544","219","7763","2024-12-30"
"66050","2024","COM","2022","4801","55","4856","2024-12-30"
"66051","2024","COM","2022","267","8","275","2024-12-30"
"66052","2024","COM","2022","353","8","361","2024-12-30"
"66053","2024","COM","2022","2637","32","2669","2024-12-30"
"66054","2024","COM","2022","63","1","64","2024-12-30"
"66055","2024","COM","2022","780","16","796","2024-12-30"
"66056","2024","COM","2022","1155","21","1176","2024-12-30"
"66057","2024","COM","2022","532","5","537","2024-12-30"
"66058","2024","COM","2022","2013","37","2050","2024-12-30"
"66059","2024","COM","2022","2679","37","2716","2024-12-30"
"66060","2024","COM","2022","247","21","268","2024-12-30"
"66061","2024","COM","2022","93","1","94","2024-12-30"
"66062","2024","COM","2022","178","5","183","2024-12-30"
"66063","2024","COM","2022","258","4","262","2024-12-30"
"66064","2024","COM","2022","418","13","431","2024-12-30"
"66065","2024","COM","2022","9479","102","9581","2024-12-30"
"66066","2024","COM","2022","614","19","633","2024-12-30"
"66067","2024","COM","2022","714","16","730","2024-12-30"
"66068","2024","COM","2022","127","2","129","2024-12-30"
"66069","2024","COM","2022","3525","118","3643","2024-12-30"
"66070","2024","COM","2022","220","6","226","2024-12-30"
"66071","2024","COM","2022","2124","23","2147","2024-12-30"
"66072","2024","COM","2022","455","11","466","2024-12-30"
"66073","2024","COM","2022","154","1","155","2024-12-30"
"66074","2024","COM","2022","381","15","396","2024-12-30"
"66075","2024","COM","2022","149","7","156","2024-12-30"
"66076","2024","COM","2022","60","0","60","2024-12-30"
"66077","2024","COM","2022","96","2","98","2024-12-30"
"66078","2024","COM","2022","208","4","212","2024-12-30"
"66079","2024","COM","2022","201","4","205","2024-12-30"
"66080","2024","COM","2022","122","1","123","2024-12-30"
"66081","2024","COM","2022","137","2","139","2024-12-30"
"66082","2024","COM","2022","491","16","507","2024-12-30"
"66083","2024","COM","2022","46","0","46","2024-12-30"
"66084","2024","COM","2022","1333","19","1352","2024-12-30"
"66085","2024","COM","2022","435","7","442","2024-12-30"
"66086","2024","COM","2022","16","0","16","2024-12-30"
"66088","2024","COM","2022","5546","73","5619","2024-12-30"
"66089","2024","COM","2022","396","7","403","2024-12-30"
"66090","2024","COM","2022","42","2","44","2024-12-30"
"66091","2024","COM","2022","54","2","56","2024-12-30"
"66092","2024","COM","2022","91","2","93","2024-12-30"
"66093","2024","COM","2022","2245","30","2275","2024-12-30"
"66094","2024","COM","2022","3224","47","3271","2024-12-30"
"66095","2024","COM","2022","472","14","486","2024-12-30"
"66096","2024","COM","2022","1044","15","1059","2024-12-30"
"66097","2024","COM","2022","142","4","146","2024-12-30"
"66098","2024","COM","2022","216","9","225","2024-12-30"
"66099","2024","COM","2022","314","3","317","2024-12-30"
"66100","2024","COM","2022","156","4","160","2024-12-30"
"66101","2024","COM","2022","2169","43","2212","2024-12-30"
"66102","2024","COM","2022","35","2","37","2024-12-30"
"66103","2024","COM","2022","585","11","596","2024-12-30"
"66104","2024","COM","2022","972","12","984","2024-12-30"
"66105","2024","COM","2022","279","6","285","2024-12-30"
"66106","2024","COM","2022","2859","44","2903","2024-12-30"
"66107","2024","COM","2022","780","12","792","2024-12-30"
"66108","2024","COM","2022","4325","71","4396","2024-12-30"
"66109","2024","COM","2022","248","4","252","2024-12-30"
"66111","2024","COM","2022","158","2","160","2024-12-30"
"66112","2024","COM","2022","251","4","255","2024-12-30"
"66113","2024","COM","2022","179","4","183","2024-12-30"
"66114","2024","COM","2022","1595","37","1632","2024-12-30"
"66115","2024","COM","2022","1283","26","1309","2024-12-30"
"66116","2024","COM","2022","216","2","218","2024-12-30"
"66117","2024","COM","2022","150","1","151","2024-12-30"
"66118","2024","COM","2022","328","7","335","2024-12-30"
"66119","2024","COM","2022","313","5","318","2024-12-30"
"66120","2024","COM","2022","75","1","76","2024-12-30"
"66121","2024","COM","2022","1371","24","1395","2024-12-30"
"66122","2024","COM","2022","60","0","60","2024-12-30"
"66123","2024","COM","2022","150","0","150","2024-12-30"
"66124","2024","COM","2022","1770","174","1944","2024-12-30"
"66125","2024","COM","2022","337","6","343","2024-12-30"
"66126","2024","COM","2022","354","5","359","2024-12-30"
"66127","2024","COM","2022","1218","17","1235","2024-12-30"
"66128","2024","COM","2022","27","1","28","2024-12-30"
"66129","2024","COM","2022","1889","23","1912","2024-12-30"
"66130","2024","COM","2022","1376","104","1480","2024-12-30"
"66132","2024","COM","2022","408","12","420","2024-12-30"
"66133","2024","COM","2022","3232","38","3270","2024-12-30"
"66134","2024","COM","2022","1079","15","1094","2024-12-30"
"66136","2024","COM","2022","120996","1510","122506","2024-12-30"
"66137","2024","COM","2022","565","2","567","2024-12-30"
"66138","2024","COM","2022","1808","18","1826","2024-12-30"
"66139","2024","COM","2022","37","0","37","2024-12-30"
"66140","2024","COM","2022","4048","58","4106","2024-12-30"
"66141","2024","COM","2022","11174","100","11274","2024-12-30"
"66142","2024","COM","2022","56","0","56","2024-12-30"
"66143","2024","COM","2022","96","2","98","2024-12-30"
"66144","2024","COM","2022","5489","91","5580","2024-12-30"
"66145","2024","COM","2022","3012","43","3055","2024-12-30"
"66146","2024","COM","2022","103","1","104","2024-12-30"
"66147","2024","COM","2022","102","1","103","2024-12-30"
"66148","2024","COM","2022","3976","81","4057","2024-12-30"
"66149","2024","COM","2022","6166","258","6424","2024-12-30"
"66150","2024","COM","2022","1114","14","1128","2024-12-30"
"66151","2024","COM","2022","77","4","81","2024-12-30"
"66152","2024","COM","2022","97","2","99","2024-12-30"
"66153","2024","COM","2022","45","0","45","2024-12-30"
"66154","2024","COM","2022","57","1","58","2024-12-30"
"66155","2024","COM","2022","79","1","80","2024-12-30"
"66156","2024","COM","2022","87","1","88","2024-12-30"
"66157","2024","COM","2022","23","0","23","2024-12-30"
"66158","2024","COM","2022","166","2","168","2024-12-30"
"66159","2024","COM","2022","75","1","76","2024-12-30"
"66160","2024","COM","2022","1234","22","1256","2024-12-30"
"66161","2024","COM","2022","1294","21","1315","2024-12-30"
"66162","2024","COM","2022","700","3","703","2024-12-30"
"66164","2024","COM","2022","9151","145","9296","2024-12-30"
"66165","2024","COM","2022","717","13","730","2024-12-30"
"66166","2024","COM","2022","399","3","402","2024-12-30"
"66167","2024","COM","2022","1161","29","1190","2024-12-30"
"66168","2024","COM","2022","3395","57","3452","2024-12-30"
"66169","2024","COM","2022","101","1","102","2024-12-30"
"66170","2024","COM","2022","172","5","177","2024-12-30"
"66171","2024","COM","2022","11995","141","12136","2024-12-30"
"66172","2024","COM","2022","11673","177","11850","2024-12-30"
"66173","2024","COM","2022","1262","27","1289","2024-12-30"
"66174","2024","COM","2022","2934","47","2981","2024-12-30"
"66175","2024","COM","2022","2985","30","3015","2024-12-30"
"66176","2024","COM","2022","3177","45","3222","2024-12-30"
"66177","2024","COM","2022","1578","16","1594","2024-12-30"
"66178","2024","COM","2022","2283","29","2312","2024-12-30"
"66179","2024","COM","2022","1020","12","1032","2024-12-30"
"66180","2024","COM","2022","9941","133","10074","2024-12-30"
"66181","2024","COM","2022","140","3","143","2024-12-30"
"66182","2024","COM","2022","4749","69","4818","2024-12-30"
"66183","2024","COM","2022","73","1","74","2024-12-30"
"66184","2024","COM","2022","48","1","49","2024-12-30"
"66185","2024","COM","2022","360","10","370","2024-12-30"
"66186","2024","COM","2022","2786","40","2826","2024-12-30"
"66187","2024","COM","2022","1740","20","1760","2024-12-30"
"66188","2024","COM","2022","261","9","270","2024-12-30"
"66189","2024","COM","2022","5724","92","5816","2024-12-30"
"66190","2024","COM","2022","3888","39","3927","2024-12-30"
"66191","2024","COM","2022","31","1","32","2024-12-30"
"66192","2024","COM","2022","102","3","105","2024-12-30"
"66193","2024","COM","2022","233","5","238","2024-12-30"
"66194","2024","COM","2022","243","3","246","2024-12-30"
"66195","2024","COM","2022","7896","136","8032","2024-12-30"
"66196","2024","COM","2022","3500","52","3552","2024-12-30"
"66197","2024","COM","2022","31","0","31","2024-12-30"
"66198","2024","COM","2022","480","3","483","2024-12-30"
"66199","2024","COM","2022","106","4","110","2024-12-30"
"66201","2024","COM","2022","43","0","43","2024-12-30"
"66202","2024","COM","2022","194","5","199","2024-12-30"
"66203","2024","COM","2022","58","0","58","2024-12-30"
"66204","2024","COM","2022","327","7","334","2024-12-30"
"66205","2024","COM","2022","911","13","924","2024-12-30"
"66206","2024","COM","2022","97","1","98","2024-12-30"
"66207","2024","COM","2022","799","14","813","2024-12-30"
"66208","2024","COM","2022","2181","99","2280","2024-12-30"
"66209","2024","COM","2022","26","0","26","2024-12-30"
"66210","2024","COM","2022","8215","154","8369","2024-12-30"
"66211","2024","COM","2022","186","4","190","2024-12-30"
"66212","2024","COM","2022","3793","70","3863","2024-12-30"
"66213","2024","COM","2022","7375","137","7512","2024-12-30"
"66214","2024","COM","2022","1171","15","1186","2024-12-30"
"66215","2024","COM","2022","188","1","189","2024-12-30"
"66216","2024","COM","2022","77","1","78","2024-12-30"
"66217","2024","COM","2022","2291","35","2326","2024-12-30"
"66218","2024","COM","2022","366","11","377","2024-12-30"
"66219","2024","COM","2022","45","0","45","2024-12-30"
"66220","2024","COM","2022","35","1","36","2024-12-30"
"66221","2024","COM","2022","34","0","34","2024-12-30"
"66222","2024","COM","2022","1441","40","1481","2024-12-30"
"66223","2024","COM","2022","205","8","213","2024-12-30"
"66224","2024","COM","2022","3318","53","3371","2024-12-30"
"66225","2024","COM","2022","1917","62","1979","2024-12-30"
"66226","2024","COM","2022","1289","16","1305","2024-12-30"
"66227","2024","COM","2022","4416","59","4475","2024-12-30"
"66228","2024","COM","2022","1360","22","1382","2024-12-30"
"66230","2024","COM","2022","2205","30","2235","2024-12-30"
"66231","2024","COM","2022","541","7","548","2024-12-30"
"66232","2024","COM","2022","28","0","28","2024-12-30"
"66233","2024","COM","2022","182","4","186","2024-12-30"
"66234","2024","COM","2022","66","0","66","2024-12-30"
"67001","2024","COM","2022","2570","21","2591","2024-12-30"
"67002","2024","COM","2022","406","3","409","2024-12-30"
"67003","2024","COM","2022","471","9","480","2024-12-30"
"67004","2024","COM","2022","1524","24","1548","2024-12-30"
"67005","2024","COM","2022","858","13","871","2024-12-30"
"67006","2024","COM","2022","228","2","230","2024-12-30"
"67008","2024","COM","2022","1445","24","1469","2024-12-30"
"67009","2024","COM","2022","374","10","384","2024-12-30"
"67010","2024","COM","2022","1759","70","1829","2024-12-30"
"67011","2024","COM","2022","1008","11","1019","2024-12-30"
"67012","2024","COM","2022","633","18","651","2024-12-30"
"67013","2024","COM","2022","269","1","270","2024-12-30"
"67016","2024","COM","2022","766","11","777","2024-12-30"
"67017","2024","COM","2022","301","10","311","2024-12-30"
"67018","2024","COM","2022","677","10","687","2024-12-30"
"67019","2024","COM","2022","1229","13","1242","2024-12-30"
"67020","2024","COM","2022","829","5","834","2024-12-30"
"67021","2024","COM","2022","7086","189","7275","2024-12-30"
"67022","2024","COM","2022","223","4","227","2024-12-30"
"67023","2024","COM","2022","968","22","990","2024-12-30"
"67025","2024","COM","2022","1904","21","1925","2024-12-30"
"67026","2024","COM","2022","170","3","173","2024-12-30"
"67027","2024","COM","2022","174","0","174","2024-12-30"
"67028","2024","COM","2022","5922","107","6029","2024-12-30"
"67029","2024","COM","2022","343","5","348","2024-12-30"
"67030","2024","COM","2022","725","11","736","2024-12-30"
"67031","2024","COM","2022","1466","23","1489","2024-12-30"
"67032","2024","COM","2022","199","7","206","2024-12-30"
"67033","2024","COM","2022","610","6","616","2024-12-30"
"67034","2024","COM","2022","2474","40","2514","2024-12-30"
"67035","2024","COM","2022","513","7","520","2024-12-30"
"67036","2024","COM","2022","302","5","307","2024-12-30"
"67037","2024","COM","2022","353","6","359","2024-12-30"
"67038","2024","COM","2022","317","2","319","2024-12-30"
"67039","2024","COM","2022","537","11","548","2024-12-30"
"67040","2024","COM","2022","1051","10","1061","2024-12-30"
"67043","2024","COM","2022","18289","233","18522","2024-12-30"
"67044","2024","COM","2022","251","0","251","2024-12-30"
"67045","2024","COM","2022","3360","59","3419","2024-12-30"
"67046","2024","COM","2022","12211","141","12352","2024-12-30"
"67047","2024","COM","2022","154","0","154","2024-12-30"
"67048","2024","COM","2022","461","9","470","2024-12-30"
"67049","2024","COM","2022","1408","14","1422","2024-12-30"
"67050","2024","COM","2022","30","0","30","2024-12-30"
"67051","2024","COM","2022","305","11","316","2024-12-30"
"67052","2024","COM","2022","2435","43","2478","2024-12-30"
"67053","2024","COM","2022","317","7","324","2024-12-30"
"67054","2024","COM","2022","572","6","578","2024-12-30"
"67055","2024","COM","2022","1383","21","1404","2024-12-30"
"67056","2024","COM","2022","795","11","806","2024-12-30"
"67057","2024","COM","2022","176","3","179","2024-12-30"
"67058","2024","COM","2022","383","4","387","2024-12-30"
"67059","2024","COM","2022","380","7","387","2024-12-30"
"67060","2024","COM","2022","643","5","648","2024-12-30"
"67061","2024","COM","2022","3706","79","3785","2024-12-30"
"67062","2024","COM","2022","337","5","342","2024-12-30"
"67063","2024","COM","2022","675","17","692","2024-12-30"
"67065","2024","COM","2022","1345","14","1359","2024-12-30"
"67066","2024","COM","2022","2577","87","2664","2024-12-30"
"67067","2024","COM","2022","10369","105","10474","2024-12-30"
"67068","2024","COM","2022","288","3","291","2024-12-30"
"67069","2024","COM","2022","508","7","515","2024-12-30"
"67070","2024","COM","2022","279","6","285","2024-12-30"
"67071","2024","COM","2022","462","11","473","2024-12-30"
"67072","2024","COM","2022","651","13","664","2024-12-30"
"67073","2024","COM","2022","4265","82","4347","2024-12-30"
"67074","2024","COM","2022","634","18","652","2024-12-30"
"67075","2024","COM","2022","474","4","478","2024-12-30"
"67076","2024","COM","2022","472","2","474","2024-12-30"
"67077","2024","COM","2022","593","11","604","2024-12-30"
"67078","2024","COM","2022","291","4","295","2024-12-30"
"67079","2024","COM","2022","181","3","184","2024-12-30"
"67080","2024","COM","2022","1755","22","1777","2024-12-30"
"67081","2024","COM","2022","787","12","799","2024-12-30"
"67082","2024","COM","2022","1218","15","1233","2024-12-30"
"67083","2024","COM","2022","755","12","767","2024-12-30"
"67084","2024","COM","2022","2186","24","2210","2024-12-30"
"67085","2024","COM","2022","689","13","702","2024-12-30"
"67086","2024","COM","2022","408","4","412","2024-12-30"
"67087","2024","COM","2022","1433","14","1447","2024-12-30"
"67088","2024","COM","2022","344","5","349","2024-12-30"
"67089","2024","COM","2022","2569","34","2603","2024-12-30"
"67090","2024","COM","2022","673","44","717","2024-12-30"
"67091","2024","COM","2022","329","7","336","2024-12-30"
"67092","2024","COM","2022","642","25","667","2024-12-30"
"67093","2024","COM","2022","335","16","351","2024-12-30"
"67094","2024","COM","2022","267","2","269","2024-12-30"
"67095","2024","COM","2022","1585","24","1609","2024-12-30"
"67096","2024","COM","2022","325","11","336","2024-12-30"
"67097","2024","COM","2022","1229","29","1258","2024-12-30"
"67098","2024","COM","2022","1486","16","1502","2024-12-30"
"67099","2024","COM","2022","276","6","282","2024-12-30"
"67100","2024","COM","2022","363","1","364","2024-12-30"
"67101","2024","COM","2022","2626","30","2656","2024-12-30"
"67102","2024","COM","2022","324","4","328","2024-12-30"
"67103","2024","COM","2022","1047","25","1072","2024-12-30"
"67104","2024","COM","2022","586","14","600","2024-12-30"
"67105","2024","COM","2022","1406","21","1427","2024-12-30"
"67106","2024","COM","2022","5357","47","5404","2024-12-30"
"67107","2024","COM","2022","656","8","664","2024-12-30"
"67108","2024","COM","2022","1873","13","1886","2024-12-30"
"67109","2024","COM","2022","686","9","695","2024-12-30"
"67110","2024","COM","2022","1103","13","1116","2024-12-30"
"67111","2024","COM","2022","419","9","428","2024-12-30"
"67112","2024","COM","2022","2957","41","2998","2024-12-30"
"67113","2024","COM","2022","433","8","441","2024-12-30"
"67115","2024","COM","2022","2295","19","2314","2024-12-30"
"67116","2024","COM","2022","571","32","603","2024-12-30"
"67117","2024","COM","2022","421","3","424","2024-12-30"
"67118","2024","COM","2022","7237","73","7310","2024-12-30"
"67119","2024","COM","2022","1428","19","1447","2024-12-30"
"67120","2024","COM","2022","501","11","512","2024-12-30"
"67121","2024","COM","2022","803","10","813","2024-12-30"
"67122","2024","COM","2022","1339","17","1356","2024-12-30"
"67123","2024","COM","2022","470","4","474","2024-12-30"
"67124","2024","COM","2022","2545","27","2572","2024-12-30"
"67125","2024","COM","2022","2239","72","2311","2024-12-30"
"67126","2024","COM","2022","289","5","294","2024-12-30"
"67127","2024","COM","2022","1467","20","1487","2024-12-30"
"67128","2024","COM","2022","1920","18","1938","2024-12-30"
"67129","2024","COM","2022","601","6","607","2024-12-30"
"67130","2024","COM","2022","11076","117","11193","2024-12-30"
"67131","2024","COM","2022","5847","65","5912","2024-12-30"
"67132","2024","COM","2022","958","13","971","2024-12-30"
"67133","2024","COM","2022","456","12","468","2024-12-30"
"67134","2024","COM","2022","174","3","177","2024-12-30"
"67135","2024","COM","2022","742","14","756","2024-12-30"
"67136","2024","COM","2022","272","5","277","2024-12-30"
"67137","2024","COM","2022","5769","68","5837","2024-12-30"
"67138","2024","COM","2022","577","8","585","2024-12-30"
"67139","2024","COM","2022","481","9","490","2024-12-30"
"67140","2024","COM","2022","810","4","814","2024-12-30"
"67141","2024","COM","2022","597","4","601","2024-12-30"
"67142","2024","COM","2022","282","2","284","2024-12-30"
"67143","2024","COM","2022","641","17","658","2024-12-30"
"67144","2024","COM","2022","345","3","348","2024-12-30"
"67145","2024","COM","2022","266","6","272","2024-12-30"
"67146","2024","COM","2022","617","8","625","2024-12-30"
"67147","2024","COM","2022","492","5","497","2024-12-30"
"67148","2024","COM","2022","157","3","160","2024-12-30"
"67149","2024","COM","2022","391","14","405","2024-12-30"
"67150","2024","COM","2022","1563","14","1577","2024-12-30"
"67151","2024","COM","2022","5263","57","5320","2024-12-30"
"67152","2024","COM","2022","7759","75","7834","2024-12-30"
"67153","2024","COM","2022","388","3","391","2024-12-30"
"67154","2024","COM","2022","3457","56","3513","2024-12-30"
"67155","2024","COM","2022","1281","14","1295","2024-12-30"
"67156","2024","COM","2022","2719","22","2741","2024-12-30"
"67159","2024","COM","2022","204","1","205","2024-12-30"
"67160","2024","COM","2022","1054","28","1082","2024-12-30"
"67161","2024","COM","2022","369","10","379","2024-12-30"
"67162","2024","COM","2022","355","1","356","2024-12-30"
"67163","2024","COM","2022","540","14","554","2024-12-30"
"67164","2024","COM","2022","835","20","855","2024-12-30"
"67165","2024","COM","2022","391","3","394","2024-12-30"
"67166","2024","COM","2022","258","8","266","2024-12-30"
"67167","2024","COM","2022","1224","16","1240","2024-12-30"
"67168","2024","COM","2022","1677","27","1704","2024-12-30"
"67169","2024","COM","2022","2886","34","2920","2024-12-30"
"67172","2024","COM","2022","2341","31","2372","2024-12-30"
"67173","2024","COM","2022","1223","17","1240","2024-12-30"
"67174","2024","COM","2022","1109","20","1129","2024-12-30"
"67176","2024","COM","2022","3808","53","3861","2024-12-30"
"67177","2024","COM","2022","621","9","630","2024-12-30"
"67178","2024","COM","2022","286","4","290","2024-12-30"
"67179","2024","COM","2022","657","8","665","2024-12-30"
"67180","2024","COM","2022","36070","498","36568","2024-12-30"
"67181","2024","COM","2022","278","6","284","2024-12-30"
"67182","2024","COM","2022","1788","28","1816","2024-12-30"
"67183","2024","COM","2022","894","14","908","2024-12-30"
"67184","2024","COM","2022","1923","24","1947","2024-12-30"
"67185","2024","COM","2022","627","9","636","2024-12-30"
"67186","2024","COM","2022","435","6","441","2024-12-30"
"67187","2024","COM","2022","572","8","580","2024-12-30"
"67188","2024","COM","2022","695","11","706","2024-12-30"
"67189","2024","COM","2022","927","27","954","2024-12-30"
"67190","2024","COM","2022","196","2","198","2024-12-30"
"67191","2024","COM","2022","1835","25","1860","2024-12-30"
"67192","2024","COM","2022","963","10","973","2024-12-30"
"67194","2024","COM","2022","4701","73","4774","2024-12-30"
"67195","2024","COM","2022","614","10","624","2024-12-30"
"67196","2024","COM","2022","2615","32","2647","2024-12-30"
"67197","2024","COM","2022","1552","18","1570","2024-12-30"
"67198","2024","COM","2022","117","4","121","2024-12-30"
"67199","2024","COM","2022","79","1","80","2024-12-30"
"67200","2024","COM","2022","1014","7","1021","2024-12-30"
"67201","2024","COM","2022","294","4","298","2024-12-30"
"67202","2024","COM","2022","4039","53","4092","2024-12-30"
"67203","2024","COM","2022","421","3","424","2024-12-30"
"67204","2024","COM","2022","11413","83","11496","2024-12-30"
"67205","2024","COM","2022","4557","51","4608","2024-12-30"
"67206","2024","COM","2022","1141","18","1159","2024-12-30"
"67208","2024","COM","2022","538","4","542","2024-12-30"
"67209","2024","COM","2022","275","4","279","2024-12-30"
"67210","2024","COM","2022","512","11","523","2024-12-30"
"67212","2024","COM","2022","3890","42","3932","2024-12-30"
"67213","2024","COM","2022","625","11","636","2024-12-30"
"67214","2024","COM","2022","1002","10","1012","2024-12-30"
"67215","2024","COM","2022","491","3","494","2024-12-30"
"67216","2024","COM","2022","2694","37","2731","2024-12-30"
"67217","2024","COM","2022","389","2","391","2024-12-30"
"67218","2024","COM","2022","27339","483","27822","2024-12-30"
"67220","2024","COM","2022","375","2","377","2024-12-30"
"67221","2024","COM","2022","361","5","366","2024-12-30"
"67222","2024","COM","2022","3993","39","4032","2024-12-30"
"67223","2024","COM","2022","1240","12","1252","2024-12-30"
"67225","2024","COM","2022","108","1","109","2024-12-30"
"67226","2024","COM","2022","2081","23","2104","2024-12-30"
"67227","2024","COM","2022","218","6","224","2024-12-30"
"67228","2024","COM","2022","785","19","804","2024-12-30"
"67229","2024","COM","2022","187","3","190","2024-12-30"
"67230","2024","COM","2022","2443","22","2465","2024-12-30"
"67231","2024","COM","2022","219","0","219","2024-12-30"
"67232","2024","COM","2022","204","6","210","2024-12-30"
"67233","2024","COM","2022","1222","19","1241","2024-12-30"
"67234","2024","COM","2022","1486","32","1518","2024-12-30"
"67235","2024","COM","2022","450","2","452","2024-12-30"
"67236","2024","COM","2022","540","15","555","2024-12-30"
"67237","2024","COM","2022","2548","27","2575","2024-12-30"
"67238","2024","COM","2022","648","6","654","2024-12-30"
"67239","2024","COM","2022","1691","28","1719","2024-12-30"
"67240","2024","COM","2022","697","13","710","2024-12-30"
"67241","2024","COM","2022","156","3","159","2024-12-30"
"67242","2024","COM","2022","535","8","543","2024-12-30"
"67244","2024","COM","2022","159","3","162","2024-12-30"
"67245","2024","COM","2022","187","3","190","2024-12-30"
"67246","2024","COM","2022","1206","10","1216","2024-12-30"
"67247","2024","COM","2022","997","20","1017","2024-12-30"
"67248","2024","COM","2022","1767","25","1792","2024-12-30"
"67249","2024","COM","2022","225","7","232","2024-12-30"
"67250","2024","COM","2022","776","17","793","2024-12-30"
"67252","2024","COM","2022","1087","8","1095","2024-12-30"
"67253","2024","COM","2022","651","11","662","2024-12-30"
"67254","2024","COM","2022","924","12","936","2024-12-30"
"67255","2024","COM","2022","491","9","500","2024-12-30"
"67256","2024","COM","2022","3475","54","3529","2024-12-30"
"67257","2024","COM","2022","695","15","710","2024-12-30"
"67258","2024","COM","2022","191","2","193","2024-12-30"
"67259","2024","COM","2022","910","12","922","2024-12-30"
"67260","2024","COM","2022","313","5","318","2024-12-30"
"67261","2024","COM","2022","2336","27","2363","2024-12-30"
"67263","2024","COM","2022","1510","27","1537","2024-12-30"
"67264","2024","COM","2022","832","6","838","2024-12-30"
"67265","2024","COM","2022","531","9","540","2024-12-30"
"67266","2024","COM","2022","683","10","693","2024-12-30"
"67267","2024","COM","2022","20683","135","20818","2024-12-30"
"67268","2024","COM","2022","2692","30","2722","2024-12-30"
"67269","2024","COM","2022","298","3","301","2024-12-30"
"67270","2024","COM","2022","363","4","367","2024-12-30"
"67271","2024","COM","2022","660","8","668","2024-12-30"
"67272","2024","COM","2022","388","6","394","2024-12-30"
"67273","2024","COM","2022","468","11","479","2024-12-30"
"67274","2024","COM","2022","230","4","234","2024-12-30"
"67275","2024","COM","2022","826","14","840","2024-12-30"
"67276","2024","COM","2022","1921","34","1955","2024-12-30"
"67277","2024","COM","2022","771","10","781","2024-12-30"
"67278","2024","COM","2022","525","11","536","2024-12-30"
"67279","2024","COM","2022","239","5","244","2024-12-30"
"67280","2024","COM","2022","792","13","805","2024-12-30"
"67281","2024","COM","2022","4384","45","4429","2024-12-30"
"67282","2024","COM","2022","4200","52","4252","2024-12-30"
"67283","2024","COM","2022","2703","31","2734","2024-12-30"
"67285","2024","COM","2022","1504","110","1614","2024-12-30"
"67286","2024","COM","2022","1537","19","1556","2024-12-30"
"67287","2024","COM","2022","559","10","569","2024-12-30"
"67288","2024","COM","2022","319","6","325","2024-12-30"
"67289","2024","COM","2022","610","6","616","2024-12-30"
"67290","2024","COM","2022","923","18","941","2024-12-30"
"67291","2024","COM","2022","3367","36","3403","2024-12-30"
"67292","2024","COM","2022","669","7","676","2024-12-30"
"67293","2024","COM","2022","703","11","714","2024-12-30"
"67295","2024","COM","2022","599","23","622","2024-12-30"
"67296","2024","COM","2022","2075","23","2098","2024-12-30"
"67298","2024","COM","2022","565","6","571","2024-12-30"
"67299","2024","COM","2022","881","24","905","2024-12-30"
"67300","2024","COM","2022","9328","124","9452","2024-12-30"
"67301","2024","COM","2022","2251","20","2271","2024-12-30"
"67302","2024","COM","2022","1994","34","2028","2024-12-30"
"67303","2024","COM","2022","680","11","691","2024-12-30"
"67304","2024","COM","2022","614","10","624","2024-12-30"
"67305","2024","COM","2022","1927","23","1950","2024-12-30"
"67306","2024","COM","2022","663","70","733","2024-12-30"
"67307","2024","COM","2022","440","5","445","2024-12-30"
"67308","2024","COM","2022","799","16","815","2024-12-30"
"67309","2024","COM","2022","5236","70","5306","2024-12-30"
"67310","2024","COM","2022","1124","18","1142","2024-12-30"
"67311","2024","COM","2022","2288","31","2319","2024-12-30"
"67312","2024","COM","2022","450","2","452","2024-12-30"
"67313","2024","COM","2022","6101","51","6152","2024-12-30"
"67314","2024","COM","2022","526","7","533","2024-12-30"
"67315","2024","COM","2022","653","10","663","2024-12-30"
"67317","2024","COM","2022","654","17","671","2024-12-30"
"67319","2024","COM","2022","396","3","399","2024-12-30"
"67320","2024","COM","2022","617","18","635","2024-12-30"
"67321","2024","COM","2022","331","12","343","2024-12-30"
"67322","2024","COM","2022","1099","12","1111","2024-12-30"
"67324","2024","COM","2022","4372","69","4441","2024-12-30"
"67325","2024","COM","2022","1382","17","1399","2024-12-30"
"67326","2024","COM","2022","1697","16","1713","2024-12-30"
"67327","2024","COM","2022","941","22","963","2024-12-30"
"67328","2024","COM","2022","900","6","906","2024-12-30"
"67329","2024","COM","2022","1239","17","1256","2024-12-30"
"67330","2024","COM","2022","894","14","908","2024-12-30"
"67331","2024","COM","2022","1331","18","1349","2024-12-30"
"67333","2024","COM","2022","298","3","301","2024-12-30"
"67334","2024","COM","2022","115","1","116","2024-12-30"
"67335","2024","COM","2022","947","17","964","2024-12-30"
"67336","2024","COM","2022","1729","30","1759","2024-12-30"
"67337","2024","COM","2022","424","8","432","2024-12-30"
"67338","2024","COM","2022","1381","20","1401","2024-12-30"
"67339","2024","COM","2022","4212","50","4262","2024-12-30"
"67340","2024","COM","2022","1416","19","1435","2024-12-30"
"67341","2024","COM","2022","423","2","425","2024-12-30"
"67342","2024","COM","2022","1743","32","1775","2024-12-30"
"67343","2024","COM","2022","5652","56","5708","2024-12-30"
"67344","2024","COM","2022","312","7","319","2024-12-30"
"67345","2024","COM","2022","3878","23","3901","2024-12-30"
"67346","2024","COM","2022","549","5","554","2024-12-30"
"67347","2024","COM","2022","1767","22","1789","2024-12-30"
"67348","2024","COM","2022","12303","434","12737","2024-12-30"
"67349","2024","COM","2022","509","6","515","2024-12-30"
"67350","2024","COM","2022","2578","25","2603","2024-12-30"
"67351","2024","COM","2022","1620","40","1660","2024-12-30"
"67352","2024","COM","2022","389","8","397","2024-12-30"
"67353","2024","COM","2022","234","3","237","2024-12-30"
"67354","2024","COM","2022","526","9","535","2024-12-30"
"67355","2024","COM","2022","1098","28","1126","2024-12-30"
"67356","2024","COM","2022","2481","32","2513","2024-12-30"
"67358","2024","COM","2022","807","13","820","2024-12-30"
"67359","2024","COM","2022","1381","22","1403","2024-12-30"
"67360","2024","COM","2022","1155","8","1163","2024-12-30"
"67361","2024","COM","2022","490","5","495","2024-12-30"
"67362","2024","COM","2022","627","12","639","2024-12-30"
"67363","2024","COM","2022","809","15","824","2024-12-30"
"67364","2024","COM","2022","955","16","971","2024-12-30"
"67365","2024","COM","2022","13492","148","13640","2024-12-30"
"67366","2024","COM","2022","821","20","841","2024-12-30"
"67367","2024","COM","2022","1306","27","1333","2024-12-30"
"67368","2024","COM","2022","1594","42","1636","2024-12-30"
"67369","2024","COM","2022","245","1","246","2024-12-30"
"67370","2024","COM","2022","677","11","688","2024-12-30"
"67371","2024","COM","2022","599","9","608","2024-12-30"
"67372","2024","COM","2022","5047","64","5111","2024-12-30"
"67373","2024","COM","2022","324","4","328","2024-12-30"
"67375","2024","COM","2022","1289","18","1307","2024-12-30"
"67377","2024","COM","2022","983","16","999","2024-12-30"
"67378","2024","COM","2022","4471","47","4518","2024-12-30"
"67379","2024","COM","2022","891","16","907","2024-12-30"
"67380","2024","COM","2022","205","2","207","2024-12-30"
"67381","2024","COM","2022","344","2","346","2024-12-30"
"67382","2024","COM","2022","755","16","771","2024-12-30"
"67383","2024","COM","2022","209","6","215","2024-12-30"
"67384","2024","COM","2022","308","7","315","2024-12-30"
"67385","2024","COM","2022","235","3","238","2024-12-30"
"67386","2024","COM","2022","224","1","225","2024-12-30"
"67387","2024","COM","2022","289","9","298","2024-12-30"
"67388","2024","COM","2022","5407","77","5484","2024-12-30"
"67389","2024","COM","2022","4554","34","4588","2024-12-30"
"67391","2024","COM","2022","437","9","446","2024-12-30"
"67392","2024","COM","2022","842","13","855","2024-12-30"
"67394","2024","COM","2022","275","6","281","2024-12-30"
"67395","2024","COM","2022","391","10","401","2024-12-30"
"67396","2024","COM","2022","202","1","203","2024-12-30"
"67397","2024","COM","2022","2699","20","2719","2024-12-30"
"67398","2024","COM","2022","378","3","381","2024-12-30"
"67400","2024","COM","2022","1130","19","1149","2024-12-30"
"67401","2024","COM","2022","294","5","299","2024-12-30"
"67403","2024","COM","2022","464","15","479","2024-12-30"
"67404","2024","COM","2022","914","16","930","2024-12-30"
"67405","2024","COM","2022","2273","43","2316","2024-12-30"
"67406","2024","COM","2022","366","4","370","2024-12-30"
"67407","2024","COM","2022","1609","20","1629","2024-12-30"
"67408","2024","COM","2022","1184","15","1199","2024-12-30"
"67409","2024","COM","2022","1039","8","1047","2024-12-30"
"67410","2024","COM","2022","640","14","654","2024-12-30"
"67411","2024","COM","2022","5409","85","5494","2024-12-30"
"67412","2024","COM","2022","1030","6","1036","2024-12-30"
"67413","2024","COM","2022","471","12","483","2024-12-30"
"67414","2024","COM","2022","1481","21","1502","2024-12-30"
"67415","2024","COM","2022","468","2","470","2024-12-30"
"67416","2024","COM","2022","467","10","477","2024-12-30"
"67417","2024","COM","2022","294","5","299","2024-12-30"
"67418","2024","COM","2022","2000","30","2030","2024-12-30"
"67420","2024","COM","2022","1233","10","1243","2024-12-30"
"67421","2024","COM","2022","827","13","840","2024-12-30"
"67422","2024","COM","2022","578","13","591","2024-12-30"
"67423","2024","COM","2022","602","4","606","2024-12-30"
"67424","2024","COM","2022","243","2","245","2024-12-30"
"67425","2024","COM","2022","537","12","549","2024-12-30"
"67426","2024","COM","2022","371","4","375","2024-12-30"
"67427","2024","COM","2022","331","9","340","2024-12-30"
"67428","2024","COM","2022","511","7","518","2024-12-30"
"67429","2024","COM","2022","612","10","622","2024-12-30"
"67430","2024","COM","2022","776","16","792","2024-12-30"
"67432","2024","COM","2022","589","10","599","2024-12-30"
"67433","2024","COM","2022","1413","20","1433","2024-12-30"
"67434","2024","COM","2022","2751","43","2794","2024-12-30"
"67435","2024","COM","2022","820","18","838","2024-12-30"
"67436","2024","COM","2022","505","5","510","2024-12-30"
"67437","2024","COM","2022","11323","240","11563","2024-12-30"
"67438","2024","COM","2022","841","12","853","2024-12-30"
"67440","2024","COM","2022","549","12","561","2024-12-30"
"67441","2024","COM","2022","336","6","342","2024-12-30"
"67442","2024","COM","2022","1320","48","1368","2024-12-30"
"67443","2024","COM","2022","875","19","894","2024-12-30"
"67444","2024","COM","2022","114","3","117","2024-12-30"
"67445","2024","COM","2022","3121","58","3179","2024-12-30"
"67446","2024","COM","2022","413","12","425","2024-12-30"
"67447","2024","COM","2022","34382","232","34614","2024-12-30"
"67448","2024","COM","2022","2081","34","2115","2024-12-30"
"67449","2024","COM","2022","2263","33","2296","2024-12-30"
"67450","2024","COM","2022","800","6","806","2024-12-30"
"67451","2024","COM","2022","1387","25","1412","2024-12-30"
"67452","2024","COM","2022","1829","26","1855","2024-12-30"
"67453","2024","COM","2022","607","12","619","2024-12-30"
"67454","2024","COM","2022","371","6","377","2024-12-30"
"67455","2024","COM","2022","711","12","723","2024-12-30"
"67456","2024","COM","2022","412","15","427","2024-12-30"
"67458","2024","COM","2022","5116","57","5173","2024-12-30"
"67459","2024","COM","2022","744","17","761","2024-12-30"
"67460","2024","COM","2022","1763","12","1775","2024-12-30"
"67461","2024","COM","2022","325","10","335","2024-12-30"
"67462","2024","COM","2022","19523","225","19748","2024-12-30"
"67463","2024","COM","2022","3168","27","3195","2024-12-30"
"67464","2024","COM","2022","974","13","987","2024-12-30"
"67465","2024","COM","2022","2309","25","2334","2024-12-30"
"67466","2024","COM","2022","516","10","526","2024-12-30"
"67467","2024","COM","2022","381","7","388","2024-12-30"
"67468","2024","COM","2022","615","12","627","2024-12-30"
"67470","2024","COM","2022","106","2","108","2024-12-30"
"67471","2024","COM","2022","8182","64","8246","2024-12-30"
"67472","2024","COM","2022","4775","54","4829","2024-12-30"
"67473","2024","COM","2022","946","17","963","2024-12-30"
"67474","2024","COM","2022","3125","38","3163","2024-12-30"
"67475","2024","COM","2022","242","4","246","2024-12-30"
"67476","2024","COM","2022","756","5","761","2024-12-30"
"67477","2024","COM","2022","627","10","637","2024-12-30"
"67478","2024","COM","2022","1928","31","1959","2024-12-30"
"67479","2024","COM","2022","612","11","623","2024-12-30"
"67480","2024","COM","2022","1799","19","1818","2024-12-30"
"67481","2024","COM","2022","1105","15","1120","2024-12-30"
"67482","2024","COM","2022","291709","2855","294564","2024-12-30"
"67483","2024","COM","2022","218","4","222","2024-12-30"
"67484","2024","COM","2022","510","7","517","2024-12-30"
"67485","2024","COM","2022","1628","27","1655","2024-12-30"
"67486","2024","COM","2022","1810","20","1830","2024-12-30"
"67487","2024","COM","2022","1718","26","1744","2024-12-30"
"67488","2024","COM","2022","189","3","192","2024-12-30"
"67489","2024","COM","2022","831","17","848","2024-12-30"
"67490","2024","COM","2022","621","17","638","2024-12-30"
"67491","2024","COM","2022","245","2","247","2024-12-30"
"67492","2024","COM","2022","655","18","673","2024-12-30"
"67493","2024","COM","2022","430","10","440","2024-12-30"
"67494","2024","COM","2022","582","11","593","2024-12-30"
"67495","2024","COM","2022","4328","101","4429","2024-12-30"
"67497","2024","COM","2022","674","11","685","2024-12-30"
"67498","2024","COM","2022","708","5","713","2024-12-30"
"67499","2024","COM","2022","317","14","331","2024-12-30"
"67500","2024","COM","2022","1476","26","1502","2024-12-30"
"67501","2024","COM","2022","584","9","593","2024-12-30"
"67502","2024","COM","2022","218","1","219","2024-12-30"
"67503","2024","COM","2022","157","2","159","2024-12-30"
"67504","2024","COM","2022","1354","11","1365","2024-12-30"
"67505","2024","COM","2022","403","12","415","2024-12-30"
"67506","2024","COM","2022","6005","66","6071","2024-12-30"
"67507","2024","COM","2022","1755","30","1785","2024-12-30"
"67508","2024","COM","2022","419","9","428","2024-12-30"
"67509","2024","COM","2022","352","2","354","2024-12-30"
"67510","2024","COM","2022","609","4","613","2024-12-30"
"67511","2024","COM","2022","926","217","1143","2024-12-30"
"67513","2024","COM","2022","120","1","121","2024-12-30"
"67514","2024","COM","2022","611","6","617","2024-12-30"
"67515","2024","COM","2022","551","15","566","2024-12-30"
"67516","2024","COM","2022","659","8","667","2024-12-30"
"67517","2024","COM","2022","637","10","647","2024-12-30"
"67519","2024","COM","2022","5879","106","5985","2024-12-30"
"67520","2024","COM","2022","5777","55","5832","2024-12-30"
"67521","2024","COM","2022","466","3","469","2024-12-30"
"67522","2024","COM","2022","545","7","552","2024-12-30"
"67523","2024","COM","2022","2721","37","2758","2024-12-30"
"67524","2024","COM","2022","515","7","522","2024-12-30"
"67525","2024","COM","2022","1703","29","1732","2024-12-30"
"67526","2024","COM","2022","1638","16","1654","2024-12-30"
"67527","2024","COM","2022","360","7","367","2024-12-30"
"67528","2024","COM","2022","515","13","528","2024-12-30"
"67529","2024","COM","2022","3515","35","3550","2024-12-30"
"67530","2024","COM","2022","394","5","399","2024-12-30"
"67531","2024","COM","2022","284","3","287","2024-12-30"
"67532","2024","COM","2022","1065","15","1080","2024-12-30"
"67534","2024","COM","2022","768","4","772","2024-12-30"
"67535","2024","COM","2022","1060","12","1072","2024-12-30"
"67536","2024","COM","2022","173","1","174","2024-12-30"
"67537","2024","COM","2022","453","5","458","2024-12-30"
"67538","2024","COM","2022","1572","20","1592","2024-12-30"
"67539","2024","COM","2022","2340","40","2380","2024-12-30"
"67540","2024","COM","2022","862","13","875","2024-12-30"
"67541","2024","COM","2022","525","2","527","2024-12-30"
"67542","2024","COM","2022","527","4","531","2024-12-30"
"67543","2024","COM","2022","2061","23","2084","2024-12-30"
"67544","2024","COM","2022","7541","184","7725","2024-12-30"
"67545","2024","COM","2022","509","6","515","2024-12-30"
"67546","2024","COM","2022","728","10","738","2024-12-30"
"67547","2024","COM","2022","2086","28","2114","2024-12-30"
"67548","2024","COM","2022","897","19","916","2024-12-30"
"67550","2024","COM","2022","1676","22","1698","2024-12-30"
"67551","2024","COM","2022","4191","43","4234","2024-12-30"
"67552","2024","COM","2022","338","5","343","2024-12-30"
"67553","2024","COM","2022","312","5","317","2024-12-30"
"67554","2024","COM","2022","963","10","973","2024-12-30"
"67555","2024","COM","2022","251","5","256","2024-12-30"
"67556","2024","COM","2022","226","2","228","2024-12-30"
"67557","2024","COM","2022","808","12","820","2024-12-30"
"67558","2024","COM","2022","722","13","735","2024-12-30"
"67559","2024","COM","2022","239","4","243","2024-12-30"
"68001","2024","COM","2022","1132","11","1143","2024-12-30"
"68002","2024","COM","2022","378","4","382","2024-12-30"
"68004","2024","COM","2022","5575","129","5704","2024-12-30"
"68005","2024","COM","2022","1594","30","1624","2024-12-30"
"68006","2024","COM","2022","1209","30","1239","2024-12-30"
"68007","2024","COM","2022","2196","75","2271","2024-12-30"
"68008","2024","COM","2022","585","12","597","2024-12-30"
"68009","2024","COM","2022","859","17","876","2024-12-30"
"68010","2024","COM","2022","1141","22","1163","2024-12-30"
"68011","2024","COM","2022","1273","26","1299","2024-12-30"
"68012","2024","COM","2022","1754","46","1800","2024-12-30"
"68013","2024","COM","2022","978","23","1001","2024-12-30"
"68014","2024","COM","2022","357","7","364","2024-12-30"
"68015","2024","COM","2022","2577","48","2625","2024-12-30"
"68016","2024","COM","2022","940","14","954","2024-12-30"
"68017","2024","COM","2022","815","17","832","2024-12-30"
"68018","2024","COM","2022","736","20","756","2024-12-30"
"68019","2024","COM","2022","563","8","571","2024-12-30"
"68020","2024","COM","2022","1624","25","1649","2024-12-30"
"68021","2024","COM","2022","4135","90","4225","2024-12-30"
"68022","2024","COM","2022","1552","22","1574","2024-12-30"
"68023","2024","COM","2022","931","12","943","2024-12-30"
"68024","2024","COM","2022","148","5","153","2024-12-30"
"68025","2024","COM","2022","251","3","254","2024-12-30"
"68026","2024","COM","2022","1335","22","1357","2024-12-30"
"68027","2024","COM","2022","340","10","350","2024-12-30"
"68028","2024","COM","2022","2061","49","2110","2024-12-30"
"68029","2024","COM","2022","1073","21","1094","2024-12-30"
"68030","2024","COM","2022","390","11","401","2024-12-30"
"68032","2024","COM","2022","1275","24","1299","2024-12-30"
"68033","2024","COM","2022","460","8","468","2024-12-30"
"68034","2024","COM","2022","303","7","310","2024-12-30"
"68035","2024","COM","2022","329","7","336","2024-12-30"
"68036","2024","COM","2022","2519","52","2571","2024-12-30"
"68037","2024","COM","2022","483","8","491","2024-12-30"
"68038","2024","COM","2022","1192","27","1219","2024-12-30"
"68039","2024","COM","2022","542","12","554","2024-12-30"
"68040","2024","COM","2022","1995","39","2034","2024-12-30"
"68041","2024","COM","2022","1959","26","1985","2024-12-30"
"68042","2024","COM","2022","5077","126","5203","2024-12-30"
"68043","2024","COM","2022","4104","60","4164","2024-12-30"
"68044","2024","COM","2022","753","17","770","2024-12-30"
"68045","2024","COM","2022","555","15","570","2024-12-30"
"68046","2024","COM","2022","413","9","422","2024-12-30"
"68049","2024","COM","2022","430","15","445","2024-12-30"
"68050","2024","COM","2022","406","13","419","2024-12-30"
"68051","2024","COM","2022","811","14","825","2024-12-30"
"68052","2024","COM","2022","185","3","188","2024-12-30"
"68054","2024","COM","2022","408","15","423","2024-12-30"
"68055","2024","COM","2022","1050","33","1083","2024-12-30"
"68056","2024","COM","2022","8176","135","8311","2024-12-30"
"68057","2024","COM","2022","244","8","252","2024-12-30"
"68058","2024","COM","2022","3122","47","3169","2024-12-30"
"68059","2024","COM","2022","1981","43","2024","2024-12-30"
"68060","2024","COM","2022","1753","45","1798","2024-12-30"
"68061","2024","COM","2022","1053","20","1073","2024-12-30"
"68062","2024","COM","2022","2085","85","2170","2024-12-30"
"68063","2024","COM","2022","11737","199","11936","2024-12-30"
"68064","2024","COM","2022","996","9","1005","2024-12-30"
"68065","2024","COM","2022","655","12","667","2024-12-30"
"68066","2024","COM","2022","67360","1030","68390","2024-12-30"
"68067","2024","COM","2022","341","2","343","2024-12-30"
"68068","2024","COM","2022","2258","43","2301","2024-12-30"
"68069","2024","COM","2022","1441","20","1461","2024-12-30"
"68071","2024","COM","2022","301","5","306","2024-12-30"
"68072","2024","COM","2022","1399","54","1453","2024-12-30"
"68073","2024","COM","2022","460","9","469","2024-12-30"
"68074","2024","COM","2022","516","6","522","2024-12-30"
"68075","2024","COM","2022","831","16","847","2024-12-30"
"68076","2024","COM","2022","1059","12","1071","2024-12-30"
"68077","2024","COM","2022","365","11","376","2024-12-30"
"68078","2024","COM","2022","1735","40","1775","2024-12-30"
"68079","2024","COM","2022","270","6","276","2024-12-30"
"68080","2024","COM","2022","313","2","315","2024-12-30"
"68081","2024","COM","2022","597","10","607","2024-12-30"
"68082","2024","COM","2022","7362","67","7429","2024-12-30"
"68083","2024","COM","2022","377","7","384","2024-12-30"
"68084","2024","COM","2022","1510","52","1562","2024-12-30"
"68085","2024","COM","2022","397","8","405","2024-12-30"
"68086","2024","COM","2022","211","3","214","2024-12-30"
"68087","2024","COM","2022","469","11","480","2024-12-30"
"68088","2024","COM","2022","1002","18","1020","2024-12-30"
"68089","2024","COM","2022","1585","26","1611","2024-12-30"
"68090","2024","COM","2022","848","13","861","2024-12-30"
"68091","2024","COM","2022","2335","49","2384","2024-12-30"
"68092","2024","COM","2022","387","6","393","2024-12-30"
"68093","2024","COM","2022","1368","35","1403","2024-12-30"
"68094","2024","COM","2022","902","20","922","2024-12-30"
"68095","2024","COM","2022","1177","32","1209","2024-12-30"
"68096","2024","COM","2022","365","11","376","2024-12-30"
"68097","2024","COM","2022","1297","21","1318","2024-12-30"
"68098","2024","COM","2022","667","7","674","2024-12-30"
"68099","2024","COM","2022","865","11","876","2024-12-30"
"68100","2024","COM","2022","337","13","350","2024-12-30"
"68101","2024","COM","2022","806","23","829","2024-12-30"
"68102","2024","COM","2022","429","10","439","2024-12-30"
"68103","2024","COM","2022","512","12","524","2024-12-30"
"68104","2024","COM","2022","329","8","337","2024-12-30"
"68105","2024","COM","2022","259","14","273","2024-12-30"
"68106","2024","COM","2022","268","5","273","2024-12-30"
"68107","2024","COM","2022","394","9","403","2024-12-30"
"68109","2024","COM","2022","682","11","693","2024-12-30"
"68110","2024","COM","2022","795","18","813","2024-12-30"
"68111","2024","COM","2022","825","20","845","2024-12-30"
"68112","2024","COM","2022","11090","250","11340","2024-12-30"
"68113","2024","COM","2022","1464","29","1493","2024-12-30"
"68114","2024","COM","2022","156","4","160","2024-12-30"
"68115","2024","COM","2022","1353","30","1383","2024-12-30"
"68116","2024","COM","2022","728","23","751","2024-12-30"
"68117","2024","COM","2022","864","17","881","2024-12-30"
"68118","2024","COM","2022","5061","92","5153","2024-12-30"
"68119","2024","COM","2022","766","19","785","2024-12-30"
"68120","2024","COM","2022","1371","23","1394","2024-12-30"
"68121","2024","COM","2022","745","16","761","2024-12-30"
"68122","2024","COM","2022","666","12","678","2024-12-30"
"68123","2024","COM","2022","859","13","872","2024-12-30"
"68124","2024","COM","2022","372","10","382","2024-12-30"
"68125","2024","COM","2022","529","9","538","2024-12-30"
"68126","2024","COM","2022","3403","75","3478","2024-12-30"
"68127","2024","COM","2022","656","19","675","2024-12-30"
"68128","2024","COM","2022","651","8","659","2024-12-30"
"68129","2024","COM","2022","1325","35","1360","2024-12-30"
"68130","2024","COM","2022","1068","16","1084","2024-12-30"
"68131","2024","COM","2022","180","4","184","2024-12-30"
"68132","2024","COM","2022","733","17","750","2024-12-30"
"68134","2024","COM","2022","1903","29","1932","2024-12-30"
"68135","2024","COM","2022","2902","59","2961","2024-12-30"
"68136","2024","COM","2022","346","4","350","2024-12-30"
"68137","2024","COM","2022","631","7","638","2024-12-30"
"68138","2024","COM","2022","2131","51","2182","2024-12-30"
"68139","2024","COM","2022","1438","29","1467","2024-12-30"
"68140","2024","COM","2022","1288","27","1315","2024-12-30"
"68141","2024","COM","2022","2175","54","2229","2024-12-30"
"68142","2024","COM","2022","358","9","367","2024-12-30"
"68143","2024","COM","2022","1914","64","1978","2024-12-30"
"68144","2024","COM","2022","1364","24","1388","2024-12-30"
"68145","2024","COM","2022","6247","110","6357","2024-12-30"
"68146","2024","COM","2022","2358","39","2397","2024-12-30"
"68147","2024","COM","2022","549","14","563","2024-12-30"
"68148","2024","COM","2022","357","16","373","2024-12-30"
"68149","2024","COM","2022","7410","97","7507","2024-12-30"
"68150","2024","COM","2022","497","15","512","2024-12-30"
"68151","2024","COM","2022","1032","16","1048","2024-12-30"
"68152","2024","COM","2022","2428","66","2494","2024-12-30"
"68153","2024","COM","2022","719","13","732","2024-12-30"
"68154","2024","COM","2022","15115","247","15362","2024-12-30"
"68155","2024","COM","2022","4743","58","4801","2024-12-30"
"68156","2024","COM","2022","3534","60","3594","2024-12-30"
"68157","2024","COM","2022","1353","40","1393","2024-12-30"
"68158","2024","COM","2022","508","14","522","2024-12-30"
"68159","2024","COM","2022","900","25","925","2024-12-30"
"68160","2024","COM","2022","571","24","595","2024-12-30"
"68161","2024","COM","2022","517","14","531","2024-12-30"
"68162","2024","COM","2022","4391","88","4479","2024-12-30"
"68163","2024","COM","2022","5694","107","5801","2024-12-30"
"68165","2024","COM","2022","238","10","248","2024-12-30"
"68166","2024","COM","2022","13265","170","13435","2024-12-30"
"68167","2024","COM","2022","716","14","730","2024-12-30"
"68168","2024","COM","2022","376","7","383","2024-12-30"
"68169","2024","COM","2022","499","13","512","2024-12-30"
"68170","2024","COM","2022","583","16","599","2024-12-30"
"68171","2024","COM","2022","883","16","899","2024-12-30"
"68172","2024","COM","2022","1857","33","1890","2024-12-30"
"68173","2024","COM","2022","2174","61","2235","2024-12-30"
"68174","2024","COM","2022","1638","26","1664","2024-12-30"
"68175","2024","COM","2022","1872","31","1903","2024-12-30"
"68176","2024","COM","2022","333","7","340","2024-12-30"
"68177","2024","COM","2022","1510","30","1540","2024-12-30"
"68178","2024","COM","2022","963","15","978","2024-12-30"
"68179","2024","COM","2022","896","22","918","2024-12-30"
"68180","2024","COM","2022","928","30","958","2024-12-30"
"68181","2024","COM","2022","250","9","259","2024-12-30"
"68182","2024","COM","2022","1263","16","1279","2024-12-30"
"68183","2024","COM","2022","183","2","185","2024-12-30"
"68184","2024","COM","2022","291","6","297","2024-12-30"
"68185","2024","COM","2022","1647","35","1682","2024-12-30"
"68186","2024","COM","2022","317","8","325","2024-12-30"
"68187","2024","COM","2022","336","6","342","2024-12-30"
"68188","2024","COM","2022","588","15","603","2024-12-30"
"68189","2024","COM","2022","950","27","977","2024-12-30"
"68190","2024","COM","2022","31","0","31","2024-12-30"
"68191","2024","COM","2022","747","23","770","2024-12-30"
"68192","2024","COM","2022","423","7","430","2024-12-30"
"68193","2024","COM","2022","774","10","784","2024-12-30"
"68194","2024","COM","2022","295","5","300","2024-12-30"
"68195","2024","COM","2022","6755","98","6853","2024-12-30"
"68196","2024","COM","2022","286","8","294","2024-12-30"
"68197","2024","COM","2022","516","11","527","2024-12-30"
"68198","2024","COM","2022","307","7","314","2024-12-30"
"68199","2024","COM","2022","484","4","488","2024-12-30"
"68200","2024","COM","2022","533","12","545","2024-12-30"
"68201","2024","COM","2022","3615","77","3692","2024-12-30"
"68202","2024","COM","2022","196","3","199","2024-12-30"
"68203","2024","COM","2022","1341","20","1361","2024-12-30"
"68204","2024","COM","2022","1051","20","1071","2024-12-30"
"68205","2024","COM","2022","2017","22","2039","2024-12-30"
"68207","2024","COM","2022","709","14","723","2024-12-30"
"68208","2024","COM","2022","621","11","632","2024-12-30"
"68209","2024","COM","2022","849","10","859","2024-12-30"
"68210","2024","COM","2022","340","4","344","2024-12-30"
"68211","2024","COM","2022","377","1","378","2024-12-30"
"68212","2024","COM","2022","517","13","530","2024-12-30"
"68213","2024","COM","2022","334","5","339","2024-12-30"
"68214","2024","COM","2022","368","8","376","2024-12-30"
"68215","2024","COM","2022","924","8","932","2024-12-30"
"68216","2024","COM","2022","405","14","419","2024-12-30"
"68217","2024","COM","2022","1612","27","1639","2024-12-30"
"68218","2024","COM","2022","3666","77","3743","2024-12-30"
"68219","2024","COM","2022","867","24","891","2024-12-30"
"68221","2024","COM","2022","934","19","953","2024-12-30"
"68222","2024","COM","2022","1144","25","1169","2024-12-30"
"68223","2024","COM","2022","817","16","833","2024-12-30"
"68224","2024","COM","2022","104924","1171","106095","2024-12-30"
"68225","2024","COM","2022","1538","32","1570","2024-12-30"
"68226","2024","COM","2022","4709","78","4787","2024-12-30"
"68227","2024","COM","2022","1281","25","1306","2024-12-30"
"68228","2024","COM","2022","456","12","468","2024-12-30"
"68229","2024","COM","2022","165","3","168","2024-12-30"
"68230","2024","COM","2022","578","13","591","2024-12-30"
"68231","2024","COM","2022","1944","15","1959","2024-12-30"
"68232","2024","COM","2022","520","7","527","2024-12-30"
"68234","2024","COM","2022","807","12","819","2024-12-30"
"68235","2024","COM","2022","1169","16","1185","2024-12-30"
"68237","2024","COM","2022","561","14","575","2024-12-30"
"68238","2024","COM","2022","977","32","1009","2024-12-30"
"68239","2024","COM","2022","390","12","402","2024-12-30"
"68240","2024","COM","2022","1223","19","1242","2024-12-30"
"68241","2024","COM","2022","711","10","721","2024-12-30"
"68242","2024","COM","2022","1307","26","1333","2024-12-30"
"68243","2024","COM","2022","136","1","137","2024-12-30"
"68244","2024","COM","2022","406","10","416","2024-12-30"
"68245","2024","COM","2022","408","7","415","2024-12-30"
"68246","2024","COM","2022","1039","13","1052","2024-12-30"
"68247","2024","COM","2022","1229","13","1242","2024-12-30"
"68248","2024","COM","2022","684","11","695","2024-12-30"
"68249","2024","COM","2022","3445","68","3513","2024-12-30"
"68250","2024","COM","2022","1021","15","1036","2024-12-30"
"68251","2024","COM","2022","819","20","839","2024-12-30"
"68252","2024","COM","2022","1654","23","1677","2024-12-30"
"68253","2024","COM","2022","2025","18","2043","2024-12-30"
"68254","2024","COM","2022","820","20","840","2024-12-30"
"68255","2024","COM","2022","1349","43","1392","2024-12-30"
"68256","2024","COM","2022","10275","106","10381","2024-12-30"
"68257","2024","COM","2022","967","14","981","2024-12-30"
"68258","2024","COM","2022","3075","89","3164","2024-12-30"
"68259","2024","COM","2022","481","13","494","2024-12-30"
"68260","2024","COM","2022","1154","28","1182","2024-12-30"
"68261","2024","COM","2022","224","4","228","2024-12-30"
"68262","2024","COM","2022","778","12","790","2024-12-30"
"68263","2024","COM","2022","632","13","645","2024-12-30"
"68264","2024","COM","2022","626","19","645","2024-12-30"
"68265","2024","COM","2022","801","21","822","2024-12-30"
"68266","2024","COM","2022","2036","28","2064","2024-12-30"
"68267","2024","COM","2022","1923","32","1955","2024-12-30"
"68268","2024","COM","2022","694","10","704","2024-12-30"
"68269","2024","COM","2022","4723","178","4901","2024-12-30"
"68270","2024","COM","2022","3786","61","3847","2024-12-30"
"68271","2024","COM","2022","12154","282","12436","2024-12-30"
"68273","2024","COM","2022","646","29","675","2024-12-30"
"68274","2024","COM","2022","211","2","213","2024-12-30"
"68275","2024","COM","2022","433","10","443","2024-12-30"
"68276","2024","COM","2022","190","5","195","2024-12-30"
"68277","2024","COM","2022","1004","23","1027","2024-12-30"
"68278","2024","COM","2022","14125","241","14366","2024-12-30"
"68279","2024","COM","2022","906","30","936","2024-12-30"
"68280","2024","COM","2022","396","2","398","2024-12-30"
"68281","2024","COM","2022","463","12","475","2024-12-30"
"68282","2024","COM","2022","275","4","279","2024-12-30"
"68283","2024","COM","2022","785","18","803","2024-12-30"
"68284","2024","COM","2022","665","11","676","2024-12-30"
"68285","2024","COM","2022","366","10","376","2024-12-30"
"68286","2024","COM","2022","2388","45","2433","2024-12-30"
"68287","2024","COM","2022","4186","231","4417","2024-12-30"
"68288","2024","COM","2022","392","8","400","2024-12-30"
"68289","2024","COM","2022","2486","31","2517","2024-12-30"
"68290","2024","COM","2022","964","18","982","2024-12-30"
"68291","2024","COM","2022","1052","25","1077","2024-12-30"
"68292","2024","COM","2022","2184","37","2221","2024-12-30"
"68293","2024","COM","2022","77","1","78","2024-12-30"
"68294","2024","COM","2022","1756","35","1791","2024-12-30"
"68295","2024","COM","2022","3026","66","3092","2024-12-30"
"68296","2024","COM","2022","945","16","961","2024-12-30"
"68297","2024","COM","2022","22530","247","22777","2024-12-30"
"68298","2024","COM","2022","4945","137","5082","2024-12-30"
"68299","2024","COM","2022","303","5","308","2024-12-30"
"68300","2024","COM","2022","5597","84","5681","2024-12-30"
"68301","2024","COM","2022","1290","35","1325","2024-12-30"
"68302","2024","COM","2022","745","32","777","2024-12-30"
"68303","2024","COM","2022","228","7","235","2024-12-30"
"68304","2024","COM","2022","1534","39","1573","2024-12-30"
"68305","2024","COM","2022","1426","23","1449","2024-12-30"
"68306","2024","COM","2022","504","11","515","2024-12-30"
"68307","2024","COM","2022","488","9","497","2024-12-30"
"68308","2024","COM","2022","331","4","335","2024-12-30"
"68309","2024","COM","2022","4296","67","4363","2024-12-30"
"68311","2024","COM","2022","593","10","603","2024-12-30"
"68312","2024","COM","2022","316","6","322","2024-12-30"
"68313","2024","COM","2022","780","11","791","2024-12-30"
"68315","2024","COM","2022","7019","119","7138","2024-12-30"
"68316","2024","COM","2022","727","23","750","2024-12-30"
"68317","2024","COM","2022","1152","18","1170","2024-12-30"
"68318","2024","COM","2022","2466","57","2523","2024-12-30"
"68320","2024","COM","2022","1380","49","1429","2024-12-30"
"68321","2024","COM","2022","4070","37","4107","2024-12-30"
"68322","2024","COM","2022","1357","29","1386","2024-12-30"
"68323","2024","COM","2022","850","10","860","2024-12-30"
"68324","2024","COM","2022","670","20","690","2024-12-30"
"68325","2024","COM","2022","749","13","762","2024-12-30"
"68326","2024","COM","2022","145","5","150","2024-12-30"
"68327","2024","COM","2022","336","8","344","2024-12-30"
"68328","2024","COM","2022","187","6","193","2024-12-30"
"68329","2024","COM","2022","1328","20","1348","2024-12-30"
"68330","2024","COM","2022","354","4","358","2024-12-30"
"68331","2024","COM","2022","1971","41","2012","2024-12-30"
"68332","2024","COM","2022","982","14","996","2024-12-30"
"68333","2024","COM","2022","314","2","316","2024-12-30"
"68334","2024","COM","2022","7769","137","7906","2024-12-30"
"68335","2024","COM","2022","457","5","462","2024-12-30"
"68336","2024","COM","2022","464","11","475","2024-12-30"
"68337","2024","COM","2022","636","9","645","2024-12-30"
"68338","2024","COM","2022","4033","67","4100","2024-12-30"
"68340","2024","COM","2022","345","8","353","2024-12-30"
"68341","2024","COM","2022","1091","19","1110","2024-12-30"
"68342","2024","COM","2022","1631","43","1674","2024-12-30"
"68343","2024","COM","2022","2440","32","2472","2024-12-30"
"68344","2024","COM","2022","437","11","448","2024-12-30"
"68345","2024","COM","2022","796","15","811","2024-12-30"
"68347","2024","COM","2022","643","13","656","2024-12-30"
"68348","2024","COM","2022","2874","37","2911","2024-12-30"
"68349","2024","COM","2022","4617","96","4713","2024-12-30"
"68350","2024","COM","2022","477","17","494","2024-12-30"
"68351","2024","COM","2022","630","7","637","2024-12-30"
"68352","2024","COM","2022","2714","29","2743","2024-12-30"
"68353","2024","COM","2022","495","12","507","2024-12-30"
"68354","2024","COM","2022","926","16","942","2024-12-30"
"68355","2024","COM","2022","1555","30","1585","2024-12-30"
"68356","2024","COM","2022","888","19","907","2024-12-30"
"68357","2024","COM","2022","512","16","528","2024-12-30"
"68358","2024","COM","2022","467","10","477","2024-12-30"
"68359","2024","COM","2022","1648","56","1704","2024-12-30"
"68360","2024","COM","2022","719","12","731","2024-12-30"
"68361","2024","COM","2022","317","4","321","2024-12-30"
"68362","2024","COM","2022","781","11","792","2024-12-30"
"68363","2024","COM","2022","629","12","641","2024-12-30"
"68364","2024","COM","2022","1010","23","1033","2024-12-30"
"68365","2024","COM","2022","1771","64","1835","2024-12-30"
"68366","2024","COM","2022","720","11","731","2024-12-30"
"68367","2024","COM","2022","1208","26","1234","2024-12-30"
"68368","2024","COM","2022","1208","35","1243","2024-12-30"
"68370","2024","COM","2022","157","3","160","2024-12-30"
"68371","2024","COM","2022","299","10","309","2024-12-30"
"68372","2024","COM","2022","1758","42","1800","2024-12-30"
"68373","2024","COM","2022","291","12","303","2024-12-30"
"68374","2024","COM","2022","8045","319","8364","2024-12-30"
"68375","2024","COM","2022","10364","135","10499","2024-12-30"
"68376","2024","COM","2022","15491","131","15622","2024-12-30"
"68377","2024","COM","2022","778","19","797","2024-12-30"
"68378","2024","COM","2022","356","4","360","2024-12-30"
"68379","2024","COM","2022","1156","16","1172","2024-12-30"
"68380","2024","COM","2022","433","11","444","2024-12-30"
"68381","2024","COM","2022","769","9","778","2024-12-30"
"68382","2024","COM","2022","380","8","388","2024-12-30"
"68383","2024","COM","2022","323","8","331","2024-12-30"
"68384","2024","COM","2022","2509","60","2569","2024-12-30"
"68385","2024","COM","2022","823","23","846","2024-12-30"
"68386","2024","COM","2022","1069","22","1091","2024-12-30"
"69001","2024","COM","2022","397","17","414","2024-12-30"
"69002","2024","COM","2022","239","4","243","2024-12-30"
"69003","2024","COM","2022","3013","46","3059","2024-12-30"
"69004","2024","COM","2022","772","8","780","2024-12-30"
"69005","2024","COM","2022","629","8","637","2024-12-30"
"69006","2024","COM","2022","4858","89","4947","2024-12-30"
"69007","2024","COM","2022","2760","53","2813","2024-12-30"
"69008","2024","COM","2022","674","18","692","2024-12-30"
"69009","2024","COM","2022","8139","156","8295","2024-12-30"
"69010","2024","COM","2022","6469","147","6616","2024-12-30"
"69012","2024","COM","2022","616","8","624","2024-12-30"
"69013","2024","COM","2022","4408","60","4468","2024-12-30"
"69014","2024","COM","2022","1108","19","1127","2024-12-30"
"69016","2024","COM","2022","122","4","126","2024-12-30"
"69017","2024","COM","2022","758","18","776","2024-12-30"
"69018","2024","COM","2022","2103","31","2134","2024-12-30"
"69019","2024","COM","2022","13767","268","14035","2024-12-30"
"69020","2024","COM","2022","717","10","727","2024-12-30"
"69021","2024","COM","2022","2351","81","2432","2024-12-30"
"69022","2024","COM","2022","543","15","558","2024-12-30"
"69023","2024","COM","2022","1692","30","1722","2024-12-30"
"69024","2024","COM","2022","4143","104","4247","2024-12-30"
"69026","2024","COM","2022","528","7","535","2024-12-30"
"69027","2024","COM","2022","12330","168","12498","2024-12-30"
"69028","2024","COM","2022","6718","112","6830","2024-12-30"
"69029","2024","COM","2022","42850","348","43198","2024-12-30"
"69030","2024","COM","2022","823","15","838","2024-12-30"
"69031","2024","COM","2022","1378","105","1483","2024-12-30"
"69032","2024","COM","2022","2144","36","2180","2024-12-30"
"69033","2024","COM","2022","2951","73","3024","2024-12-30"
"69034","2024","COM","2022","43479","550","44029","2024-12-30"
"69035","2024","COM","2022","393","13","406","2024-12-30"
"69036","2024","COM","2022","1135","21","1156","2024-12-30"
"69037","2024","COM","2022","819","11","830","2024-12-30"
"69038","2024","COM","2022","923","27","950","2024-12-30"
"69039","2024","COM","2022","703","11","714","2024-12-30"
"69040","2024","COM","2022","6124","58","6182","2024-12-30"
"69042","2024","COM","2022","566","14","580","2024-12-30"
"69043","2024","COM","2022","9217","145","9362","2024-12-30"
"69044","2024","COM","2022","5272","150","5422","2024-12-30"
"69045","2024","COM","2022","1269","38","1307","2024-12-30"
"69046","2024","COM","2022","4670","145","4815","2024-12-30"
"69047","2024","COM","2022","1031","23","1054","2024-12-30"
"69049","2024","COM","2022","2901","50","2951","2024-12-30"
"69050","2024","COM","2022","2184","33","2217","2024-12-30"
"69051","2024","COM","2022","1215","37","1252","2024-12-30"
"69052","2024","COM","2022","4270","120","4390","2024-12-30"
"69053","2024","COM","2022","534","13","547","2024-12-30"
"69054","2024","COM","2022","365","3","368","2024-12-30"
"69055","2024","COM","2022","1504","25","1529","2024-12-30"
"69056","2024","COM","2022","2058","97","2155","2024-12-30"
"69057","2024","COM","2022","586","13","599","2024-12-30"
"69058","2024","COM","2022","416","10","426","2024-12-30"
"69059","2024","COM","2022","1633","34","1667","2024-12-30"
"69060","2024","COM","2022","557","79","636","2024-12-30"
"69061","2024","COM","2022","1198","35","1233","2024-12-30"
"69062","2024","COM","2022","794","25","819","2024-12-30"
"69063","2024","COM","2022","4604","94","4698","2024-12-30"
"69064","2024","COM","2022","3945","85","4030","2024-12-30"
"69065","2024","COM","2022","993","15","1008","2024-12-30"
"69066","2024","COM","2022","4329","97","4426","2024-12-30"
"69067","2024","COM","2022","1178","26","1204","2024-12-30"
"69068","2024","COM","2022","2541","20","2561","2024-12-30"
"69069","2024","COM","2022","12170","206","12376","2024-12-30"
"69070","2024","COM","2022","1357","26","1383","2024-12-30"
"69071","2024","COM","2022","1186","27","1213","2024-12-30"
"69072","2024","COM","2022","8980","633","9613","2024-12-30"
"69074","2024","COM","2022","1574","39","1613","2024-12-30"
"69075","2024","COM","2022","196","9","205","2024-12-30"
"69076","2024","COM","2022","2607","73","2680","2024-12-30"
"69077","2024","COM","2022","1178","20","1198","2024-12-30"
"69078","2024","COM","2022","842","16","858","2024-12-30"
"69080","2024","COM","2022","1940","17","1957","2024-12-30"
"69081","2024","COM","2022","18019","299","18318","2024-12-30"
"69082","2024","COM","2022","278","6","284","2024-12-30"
"69083","2024","COM","2022","1169","41","1210","2024-12-30"
"69084","2024","COM","2022","1351","21","1372","2024-12-30"
"69085","2024","COM","2022","1549","26","1575","2024-12-30"
"69086","2024","COM","2022","2299","64","2363","2024-12-30"
"69087","2024","COM","2022","3070","63","3133","2024-12-30"
"69088","2024","COM","2022","7005","92","7097","2024-12-30"
"69089","2024","COM","2022","15664","209","15873","2024-12-30"
"69090","2024","COM","2022","905","23","928","2024-12-30"
"69091","2024","COM","2022","20943","105","21048","2024-12-30"
"69092","2024","COM","2022","7824","317","8141","2024-12-30"
"69093","2024","COM","2022","1212","18","1230","2024-12-30"
"69094","2024","COM","2022","6284","98","6382","2024-12-30"
"69095","2024","COM","2022","831","27","858","2024-12-30"
"69096","2024","COM","2022","9941","70","10011","2024-12-30"
"69097","2024","COM","2022","739","17","756","2024-12-30"
"69098","2024","COM","2022","481","10","491","2024-12-30"
"69099","2024","COM","2022","1425","24","1449","2024-12-30"
"69100","2024","COM","2022","8909","121","9030","2024-12-30"
"69102","2024","COM","2022","753","10","763","2024-12-30"
"69103","2024","COM","2022","883","16","899","2024-12-30"
"69104","2024","COM","2022","496","5","501","2024-12-30"
"69105","2024","COM","2022","1029","36","1065","2024-12-30"
"69106","2024","COM","2022","1334","27","1361","2024-12-30"
"69107","2024","COM","2022","1051","58","1109","2024-12-30"
"69108","2024","COM","2022","1082","22","1104","2024-12-30"
"69109","2024","COM","2022","851","26","877","2024-12-30"
"69110","2024","COM","2022","1820","35","1855","2024-12-30"
"69111","2024","COM","2022","699","18","717","2024-12-30"
"69112","2024","COM","2022","6541","162","6703","2024-12-30"
"69113","2024","COM","2022","907","22","929","2024-12-30"
"69115","2024","COM","2022","4749","98","4847","2024-12-30"
"69116","2024","COM","2022","3933","112","4045","2024-12-30"
"69117","2024","COM","2022","3193","74","3267","2024-12-30"
"69118","2024","COM","2022","2736","34","2770","2024-12-30"
"69119","2024","COM","2022","951","11","962","2024-12-30"
"69120","2024","COM","2022","592","9","601","2024-12-30"
"69121","2024","COM","2022","3182","48","3230","2024-12-30"
"69122","2024","COM","2022","2068","57","2125","2024-12-30"
"69124","2024","COM","2022","452","6","458","2024-12-30"
"69125","2024","COM","2022","1004","19","1023","2024-12-30"
"69126","2024","COM","2022","879","24","903","2024-12-30"
"69127","2024","COM","2022","3711","67","3778","2024-12-30"
"69130","2024","COM","2022","226","2","228","2024-12-30"
"69131","2024","COM","2022","3565","86","3651","2024-12-30"
"69132","2024","COM","2022","855","13","868","2024-12-30"
"69133","2024","COM","2022","4323","83","4406","2024-12-30"
"69134","2024","COM","2022","243","11","254","2024-12-30"
"69135","2024","COM","2022","1923","54","1977","2024-12-30"
"69136","2024","COM","2022","3212","56","3268","2024-12-30"
"69137","2024","COM","2022","530","13","543","2024-12-30"
"69138","2024","COM","2022","447","8","455","2024-12-30"
"69139","2024","COM","2022","1393","73","1466","2024-12-30"
"69140","2024","COM","2022","2267","59","2326","2024-12-30"
"69141","2024","COM","2022","6261","176","6437","2024-12-30"
"69142","2024","COM","2022","6554","72","6626","2024-12-30"
"69143","2024","COM","2022","7807","64","7871","2024-12-30"
"69145","2024","COM","2022","943","28","971","2024-12-30"
"69148","2024","COM","2022","2633","60","2693","2024-12-30"
"69149","2024","COM","2022","37928","333","38261","2024-12-30"
"69151","2024","COM","2022","1496","31","1527","2024-12-30"
"69153","2024","COM","2022","1394","29","1423","2024-12-30"
"69154","2024","COM","2022","2966","35","3001","2024-12-30"
"69155","2024","COM","2022","1133","31","1164","2024-12-30"
"69156","2024","COM","2022","2629","82","2711","2024-12-30"
"69157","2024","COM","2022","5283","124","5407","2024-12-30"
"69159","2024","COM","2022","4079","87","4166","2024-12-30"
"69160","2024","COM","2022","1027","20","1047","2024-12-30"
"69161","2024","COM","2022","477","11","488","2024-12-30"
"69162","2024","COM","2022","1382","26","1408","2024-12-30"
"69163","2024","COM","2022","3620","60","3680","2024-12-30"
"69164","2024","COM","2022","311","3","314","2024-12-30"
"69165","2024","COM","2022","1159","20","1179","2024-12-30"
"69166","2024","COM","2022","307","5","312","2024-12-30"
"69167","2024","COM","2022","588","10","598","2024-12-30"
"69168","2024","COM","2022","1546","41","1587","2024-12-30"
"69169","2024","COM","2022","650","16","666","2024-12-30"
"69170","2024","COM","2022","1167","26","1193","2024-12-30"
"69171","2024","COM","2022","2568","33","2601","2024-12-30"
"69172","2024","COM","2022","789","23","812","2024-12-30"
"69173","2024","COM","2022","979","24","1003","2024-12-30"
"69174","2024","COM","2022","621","13","634","2024-12-30"
"69175","2024","COM","2022","1970","51","2021","2024-12-30"
"69176","2024","COM","2022","4652","95","4747","2024-12-30"
"69177","2024","COM","2022","2098","40","2138","2024-12-30"
"69178","2024","COM","2022","767","23","790","2024-12-30"
"69179","2024","COM","2022","4198","58","4256","2024-12-30"
"69180","2024","COM","2022","274","6","280","2024-12-30"
"69181","2024","COM","2022","235","7","242","2024-12-30"
"69182","2024","COM","2022","372","3","375","2024-12-30"
"69183","2024","COM","2022","311","4","315","2024-12-30"
"69184","2024","COM","2022","981","21","1002","2024-12-30"
"69186","2024","COM","2022","205","5","210","2024-12-30"
"69187","2024","COM","2022","669","11","680","2024-12-30"
"69188","2024","COM","2022","904","9","913","2024-12-30"
"69189","2024","COM","2022","1994","34","2028","2024-12-30"
"69190","2024","COM","2022","2109","73","2182","2024-12-30"
"69191","2024","COM","2022","6113","110","6223","2024-12-30"
"69192","2024","COM","2022","156","7","163","2024-12-30"
"69193","2024","COM","2022","1273","34","1307","2024-12-30"
"69194","2024","COM","2022","7405","178","7583","2024-12-30"
"69196","2024","COM","2022","603","13","616","2024-12-30"
"69197","2024","COM","2022","2236","49","2285","2024-12-30"
"69198","2024","COM","2022","783","11","794","2024-12-30"
"69199","2024","COM","2022","19549","64","19613","2024-12-30"
"69200","2024","COM","2022","1538","18","1556","2024-12-30"
"69201","2024","COM","2022","1292","23","1315","2024-12-30"
"69202","2024","COM","2022","21893","363","22256","2024-12-30"
"69203","2024","COM","2022","986","13","999","2024-12-30"
"69204","2024","COM","2022","21329","449","21778","2024-12-30"
"69205","2024","COM","2022","5370","85","5455","2024-12-30"
"69206","2024","COM","2022","4533","101","4634","2024-12-30"
"69207","2024","COM","2022","3037","51","3088","2024-12-30"
"69208","2024","COM","2022","2252","63","2315","2024-12-30"
"69209","2024","COM","2022","581","8","589","2024-12-30"
"69212","2024","COM","2022","472","11","483","2024-12-30"
"69214","2024","COM","2022","1175","22","1197","2024-12-30"
"69215","2024","COM","2022","936","20","956","2024-12-30"
"69216","2024","COM","2022","605","10","615","2024-12-30"
"69217","2024","COM","2022","743","18","761","2024-12-30"
"69218","2024","COM","2022","1051","23","1074","2024-12-30"
"69219","2024","COM","2022","2120","64","2184","2024-12-30"
"69220","2024","COM","2022","1950","81","2031","2024-12-30"
"69225","2024","COM","2022","568","15","583","2024-12-30"
"69227","2024","COM","2022","3917","144","4061","2024-12-30"
"69228","2024","COM","2022","4274","75","4349","2024-12-30"
"69229","2024","COM","2022","776","15","791","2024-12-30"
"69230","2024","COM","2022","330","6","336","2024-12-30"
"69231","2024","COM","2022","2586","60","2646","2024-12-30"
"69233","2024","COM","2022","1241","45","1286","2024-12-30"
"69234","2024","COM","2022","1703","77","1780","2024-12-30"
"69235","2024","COM","2022","1990","103","2093","2024-12-30"
"69236","2024","COM","2022","598","7","605","2024-12-30"
"69238","2024","COM","2022","3749","99","3848","2024-12-30"
"69239","2024","COM","2022","1147","30","1177","2024-12-30"
"69240","2024","COM","2022","627","13","640","2024-12-30"
"69241","2024","COM","2022","2657","46","2703","2024-12-30"
"69242","2024","COM","2022","908","12","920","2024-12-30"
"69243","2024","COM","2022","10881","216","11097","2024-12-30"
"69244","2024","COM","2022","22819","303","23122","2024-12-30"
"69245","2024","COM","2022","747","27","774","2024-12-30"
"69246","2024","COM","2022","1293","42","1335","2024-12-30"
"69248","2024","COM","2022","5794","110","5904","2024-12-30"
"69249","2024","COM","2022","3268","55","3323","2024-12-30"
"69250","2024","COM","2022","4460","89","4549","2024-12-30"
"69252","2024","COM","2022","723","7","730","2024-12-30"
"69253","2024","COM","2022","650","17","667","2024-12-30"
"69254","2024","COM","2022","994","13","1007","2024-12-30"
"69255","2024","COM","2022","6198","100","6298","2024-12-30"
"69256","2024","COM","2022","52448","199","52647","2024-12-30"
"69257","2024","COM","2022","1153","28","1181","2024-12-30"
"69258","2024","COM","2022","315","5","320","2024-12-30"
"69259","2024","COM","2022","66701","190","66891","2024-12-30"
"69260","2024","COM","2022","5175","84","5259","2024-12-30"
"69261","2024","COM","2022","117","2","119","2024-12-30"
"69263","2024","COM","2022","908","10","918","2024-12-30"
"69264","2024","COM","2022","36224","416","36640","2024-12-30"
"69265","2024","COM","2022","820","28","848","2024-12-30"
"69266","2024","COM","2022","162207","1053","163260","2024-12-30"
"69267","2024","COM","2022","2132","114","2246","2024-12-30"
"69268","2024","COM","2022","3353","47","3400","2024-12-30"
"69269","2024","COM","2022","980","28","1008","2024-12-30"
"69270","2024","COM","2022","4519","75","4594","2024-12-30"
"69271","2024","COM","2022","11214","149","11363","2024-12-30"
"69272","2024","COM","2022","4524","82","4606","2024-12-30"
"69273","2024","COM","2022","11196","85","11281","2024-12-30"
"69275","2024","COM","2022","29905","177","30082","2024-12-30"
"69276","2024","COM","2022","9727","52","9779","2024-12-30"
"69277","2024","COM","2022","13446","252","13698","2024-12-30"
"69278","2024","COM","2022","5632","106","5738","2024-12-30"
"69279","2024","COM","2022","6109","81","6190","2024-12-30"
"69280","2024","COM","2022","1594","15","1609","2024-12-30"
"69281","2024","COM","2022","1979","29","2008","2024-12-30"
"69282","2024","COM","2022","36437","354","36791","2024-12-30"
"69283","2024","COM","2022","13716","127","13843","2024-12-30"
"69284","2024","COM","2022","3270","118","3388","2024-12-30"
"69285","2024","COM","2022","4145","40","4185","2024-12-30"
"69286","2024","COM","2022","31479","285","31764","2024-12-30"
"69287","2024","COM","2022","6988","110","7098","2024-12-30"
"69288","2024","COM","2022","5651","68","5719","2024-12-30"
"69289","2024","COM","2022","4588","86","4674","2024-12-30"
"69290","2024","COM","2022","49193","232","49425","2024-12-30"
"69291","2024","COM","2022","6076","61","6137","2024-12-30"
"69292","2024","COM","2022","7039","63","7102","2024-12-30"
"69293","2024","COM","2022","2418","45","2463","2024-12-30"
"69294","2024","COM","2022","3057","29","3086","2024-12-30"
"69295","2024","COM","2022","1886","23","1909","2024-12-30"
"69296","2024","COM","2022","3131","43","3174","2024-12-30"
"69297","2024","COM","2022","5582","76","5658","2024-12-30"
"69298","2024","COM","2022","3186","43","3229","2024-12-30"
"69299","2024","COM","2022","2859","46","2905","2024-12-30"
"69381","2024","ARM","2022","29040","831","29871","2024-12-30"
"69382","2024","ARM","2022","29880","328","30208","2024-12-30"
"69383","2024","ARM","2022","101523","893","102416","2024-12-30"
"69384","2024","ARM","2022","35232","452","35684","2024-12-30"
"69385","2024","ARM","2022","48277","899","49176","2024-12-30"
"69386","2024","ARM","2022","50718","738","51456","2024-12-30"
"69387","2024","ARM","2022","87491","559","88050","2024-12-30"
"69388","2024","ARM","2022","84956","991","85947","2024-12-30"
"69389","2024","ARM","2022","53657","447","54104","2024-12-30"
"70001","2024","COM","2022","338","7","345","2024-12-30"
"70002","2024","COM","2022","216","3","219","2024-12-30"
"70003","2024","COM","2022","70","2","72","2024-12-30"
"70004","2024","COM","2022","313","1","314","2024-12-30"
"70005","2024","COM","2022","126","2","128","2024-12-30"
"70006","2024","COM","2022","1440","100","1540","2024-12-30"
"70007","2024","COM","2022","306","5","311","2024-12-30"
"70008","2024","COM","2022","148","2","150","2024-12-30"
"70009","2024","COM","2022","99","1","100","2024-12-30"
"70010","2024","COM","2022","98","0","98","2024-12-30"
"70011","2024","COM","2022","305","3","308","2024-12-30"
"70012","2024","COM","2022","668","6","674","2024-12-30"
"70013","2024","COM","2022","73","0","73","2024-12-30"
"70014","2024","COM","2022","400","10","410","2024-12-30"
"70015","2024","COM","2022","268","1","269","2024-12-30"
"70016","2024","COM","2022","166","4","170","2024-12-30"
"70017","2024","COM","2022","229","4","233","2024-12-30"
"70018","2024","COM","2022","521","6","527","2024-12-30"
"70019","2024","COM","2022","149","6","155","2024-12-30"
"70020","2024","COM","2022","245","6","251","2024-12-30"
"70021","2024","COM","2022","179","4","183","2024-12-30"
"70022","2024","COM","2022","155","3","158","2024-12-30"
"70023","2024","COM","2022","144","2","146","2024-12-30"
"70024","2024","COM","2022","432","15","447","2024-12-30"
"70025","2024","COM","2022","236","3","239","2024-12-30"
"70026","2024","COM","2022","2410","47","2457","2024-12-30"
"70027","2024","COM","2022","72","1","73","2024-12-30"
"70028","2024","COM","2022","143","6","149","2024-12-30"
"70029","2024","COM","2022","242","8","250","2024-12-30"
"70030","2024","COM","2022","44","0","44","2024-12-30"
"70031","2024","COM","2022","630","15","645","2024-12-30"
"70032","2024","COM","2022","47","0","47","2024-12-30"
"70035","2024","COM","2022","171","4","175","2024-12-30"
"70036","2024","COM","2022","158","2","160","2024-12-30"
"70037","2024","COM","2022","257","20","277","2024-12-30"
"70038","2024","COM","2022","314","7","321","2024-12-30"
"70039","2024","COM","2022","384","4","388","2024-12-30"
"70040","2024","COM","2022","240","3","243","2024-12-30"
"70041","2024","COM","2022","386","9","395","2024-12-30"
"70042","2024","COM","2022","92","3","95","2024-12-30"
"70043","2024","COM","2022","237","3","240","2024-12-30"
"70044","2024","COM","2022","402","12","414","2024-12-30"
"70045","2024","COM","2022","425","8","433","2024-12-30"
"70046","2024","COM","2022","360","10","370","2024-12-30"
"70047","2024","COM","2022","99","2","101","2024-12-30"
"70048","2024","COM","2022","136","2","138","2024-12-30"
"70049","2024","COM","2022","78","1","79","2024-12-30"
"70050","2024","COM","2022","99","0","99","2024-12-30"
"70051","2024","COM","2022","44","0","44","2024-12-30"
"70052","2024","COM","2022","121","3","124","2024-12-30"
"70053","2024","COM","2022","76","2","78","2024-12-30"
"70054","2024","COM","2022","210","8","218","2024-12-30"
"70055","2024","COM","2022","484","8","492","2024-12-30"
"70056","2024","COM","2022","323","1","324","2024-12-30"
"70057","2024","COM","2022","162","3","165","2024-12-30"
"70058","2024","COM","2022","922","22","944","2024-12-30"
"70059","2024","COM","2022","476","8","484","2024-12-30"
"70060","2024","COM","2022","283","4","287","2024-12-30"
"70061","2024","COM","2022","84","0","84","2024-12-30"
"70062","2024","COM","2022","141","2","143","2024-12-30"
"70063","2024","COM","2022","207","3","210","2024-12-30"
"70064","2024","COM","2022","135","1","136","2024-12-30"
"70065","2024","COM","2022","75","2","77","2024-12-30"
"70066","2024","COM","2022","181","4","185","2024-12-30"
"70067","2024","COM","2022","114","0","114","2024-12-30"
"70069","2024","COM","2022","41","0","41","2024-12-30"
"70070","2024","COM","2022","25","0","25","2024-12-30"
"70071","2024","COM","2022","61","1","62","2024-12-30"
"70072","2024","COM","2022","87","2","89","2024-12-30"
"70074","2024","COM","2022","233","2","235","2024-12-30"
"70075","2024","COM","2022","198","3","201","2024-12-30"
"70076","2024","COM","2022","408","1","409","2024-12-30"
"70077","2024","COM","2022","220","4","224","2024-12-30"
"70078","2024","COM","2022","98","2","100","2024-12-30"
"70079","2024","COM","2022","501","13","514","2024-12-30"
"70080","2024","COM","2022","239","5","244","2024-12-30"
"70081","2024","COM","2022","273","6","279","2024-12-30"
"70082","2024","COM","2022","125","2","127","2024-12-30"
"70083","2024","COM","2022","404","6","410","2024-12-30"
"70084","2024","COM","2022","653","11","664","2024-12-30"
"70085","2024","COM","2022","708","14","722","2024-12-30"
"70086","2024","COM","2022","75","1","76","2024-12-30"
"70087","2024","COM","2022","136","4","140","2024-12-30"
"70088","2024","COM","2022","104","1","105","2024-12-30"
"70089","2024","COM","2022","45","0","45","2024-12-30"
"70090","2024","COM","2022","59","2","61","2024-12-30"
"70091","2024","COM","2022","45","1","46","2024-12-30"
"70092","2024","COM","2022","180","3","183","2024-12-30"
"70093","2024","COM","2022","643","8","651","2024-12-30"
"70094","2024","COM","2022","301","4","305","2024-12-30"
"70095","2024","COM","2022","597","15","612","2024-12-30"
"70096","2024","COM","2022","628","16","644","2024-12-30"
"70097","2024","COM","2022","250","4","254","2024-12-30"
"70098","2024","COM","2022","198","3","201","2024-12-30"
"70099","2024","COM","2022","66","0","66","2024-12-30"
"70100","2024","COM","2022","115","0","115","2024-12-30"
"70101","2024","COM","2022","512","6","518","2024-12-30"
"70102","2024","COM","2022","286","9","295","2024-12-30"
"70103","2024","COM","2022","169","6","175","2024-12-30"
"70104","2024","COM","2022","579","11","590","2024-12-30"
"70105","2024","COM","2022","146","1","147","2024-12-30"
"70106","2024","COM","2022","129","1","130","2024-12-30"
"70107","2024","COM","2022","432","6","438","2024-12-30"
"70109","2024","COM","2022","326","5","331","2024-12-30"
"70111","2024","COM","2022","268","4","272","2024-12-30"
"70112","2024","COM","2022","168","6","174","2024-12-30"
"70113","2024","COM","2022","133","3","136","2024-12-30"
"70114","2024","COM","2022","202","3","205","2024-12-30"
"70115","2024","COM","2022","238","3","241","2024-12-30"
"70116","2024","COM","2022","604","13","617","2024-12-30"
"70117","2024","COM","2022","1253","25","1278","2024-12-30"
"70118","2024","COM","2022","185","1","186","2024-12-30"
"70119","2024","COM","2022","380","6","386","2024-12-30"
"70120","2024","COM","2022","3674","71","3745","2024-12-30"
"70121","2024","COM","2022","798","29","827","2024-12-30"
"70122","2024","COM","2022","1601","29","1630","2024-12-30"
"70124","2024","COM","2022","80","2","82","2024-12-30"
"70125","2024","COM","2022","174","6","180","2024-12-30"
"70126","2024","COM","2022","197","6","203","2024-12-30"
"70127","2024","COM","2022","107","2","109","2024-12-30"
"70128","2024","COM","2022","382","3","385","2024-12-30"
"70129","2024","COM","2022","146","4","150","2024-12-30"
"70130","2024","COM","2022","298","7","305","2024-12-30"
"70132","2024","COM","2022","669","74","743","2024-12-30"
"70133","2024","COM","2022","236","6","242","2024-12-30"
"70134","2024","COM","2022","220","2","222","2024-12-30"
"70135","2024","COM","2022","32","0","32","2024-12-30"
"70136","2024","COM","2022","484","9","493","2024-12-30"
"70137","2024","COM","2022","230","3","233","2024-12-30"
"70138","2024","COM","2022","121","3","124","2024-12-30"
"70140","2024","COM","2022","63","1","64","2024-12-30"
"70141","2024","COM","2022","117","5","122","2024-12-30"
"70142","2024","COM","2022","192","2","194","2024-12-30"
"70143","2024","COM","2022","114","3","117","2024-12-30"
"70144","2024","COM","2022","27","2","29","2024-12-30"
"70145","2024","COM","2022","521","7","528","2024-12-30"
"70146","2024","COM","2022","161","1","162","2024-12-30"
"70147","2024","COM","2022","215","4","219","2024-12-30"
"70148","2024","COM","2022","103","3","106","2024-12-30"
"70149","2024","COM","2022","699","17","716","2024-12-30"
"70150","2024","COM","2022","317","6","323","2024-12-30"
"70151","2024","COM","2022","37","1","38","2024-12-30"
"70152","2024","COM","2022","475","30","505","2024-12-30"
"70153","2024","COM","2022","97","1","98","2024-12-30"
"70154","2024","COM","2022","371","6","377","2024-12-30"
"70155","2024","COM","2022","773","15","788","2024-12-30"
"70156","2024","COM","2022","106","5","111","2024-12-30"
"70157","2024","COM","2022","348","10","358","2024-12-30"
"70158","2024","COM","2022","106","4","110","2024-12-30"
"70159","2024","COM","2022","101","1","102","2024-12-30"
"70160","2024","COM","2022","306","18","324","2024-12-30"
"70162","2024","COM","2022","480","13","493","2024-12-30"
"70163","2024","COM","2022","438","7","445","2024-12-30"
"70164","2024","COM","2022","67","1","68","2024-12-30"
"70165","2024","COM","2022","555","44","599","2024-12-30"
"70166","2024","COM","2022","144","1","145","2024-12-30"
"70167","2024","COM","2022","357","4","361","2024-12-30"
"70168","2024","COM","2022","569","8","577","2024-12-30"
"70169","2024","COM","2022","212","11","223","2024-12-30"
"70170","2024","COM","2022","113","1","114","2024-12-30"
"70171","2024","COM","2022","1249","22","1271","2024-12-30"
"70172","2024","COM","2022","110","2","112","2024-12-30"
"70174","2024","COM","2022","147","3","150","2024-12-30"
"70175","2024","COM","2022","132","4","136","2024-12-30"
"70176","2024","COM","2022","164","0","164","2024-12-30"
"70177","2024","COM","2022","594","13","607","2024-12-30"
"70178","2024","COM","2022","526","10","536","2024-12-30"
"70179","2024","COM","2022","173","4","177","2024-12-30"
"70180","2024","COM","2022","445","8","453","2024-12-30"
"70181","2024","COM","2022","138","0","138","2024-12-30"
"70182","2024","COM","2022","120","1","121","2024-12-30"
"70183","2024","COM","2022","59","0","59","2024-12-30"
"70184","2024","COM","2022","714","20","734","2024-12-30"
"70185","2024","COM","2022","183","0","183","2024-12-30"
"70186","2024","COM","2022","72","1","73","2024-12-30"
"70187","2024","COM","2022","250","1","251","2024-12-30"
"70188","2024","COM","2022","52","1","53","2024-12-30"
"70189","2024","COM","2022","249","5","254","2024-12-30"
"70190","2024","COM","2022","186","3","189","2024-12-30"
"70192","2024","COM","2022","206","4","210","2024-12-30"
"70193","2024","COM","2022","229","1","230","2024-12-30"
"70194","2024","COM","2022","129","4","133","2024-12-30"
"70195","2024","COM","2022","273","4","277","2024-12-30"
"70196","2024","COM","2022","258","2","260","2024-12-30"
"70197","2024","COM","2022","766","14","780","2024-12-30"
"70198","2024","COM","2022","1248","28","1276","2024-12-30"
"70199","2024","COM","2022","119","4","123","2024-12-30"
"70200","2024","COM","2022","45","2","47","2024-12-30"
"70201","2024","COM","2022","190","6","196","2024-12-30"
"70202","2024","COM","2022","261","3","264","2024-12-30"
"70203","2024","COM","2022","160","2","162","2024-12-30"
"70204","2024","COM","2022","147","5","152","2024-12-30"
"70205","2024","COM","2022","200","6","206","2024-12-30"
"70206","2024","COM","2022","578","6","584","2024-12-30"
"70207","2024","COM","2022","3187","80","3267","2024-12-30"
"70208","2024","COM","2022","284","5","289","2024-12-30"
"70210","2024","COM","2022","150","4","154","2024-12-30"
"70211","2024","COM","2022","67","1","68","2024-12-30"
"70213","2024","COM","2022","221","10","231","2024-12-30"
"70214","2024","COM","2022","120","4","124","2024-12-30"
"70215","2024","COM","2022","258","9","267","2024-12-30"
"70216","2024","COM","2022","448","24","472","2024-12-30"
"70217","2024","COM","2022","97","1","98","2024-12-30"
"70218","2024","COM","2022","128","5","133","2024-12-30"
"70219","2024","COM","2022","711","14","725","2024-12-30"
"70220","2024","COM","2022","419","8","427","2024-12-30"
"70221","2024","COM","2022","277","3","280","2024-12-30"
"70222","2024","COM","2022","100","0","100","2024-12-30"
"70224","2024","COM","2022","712","10","722","2024-12-30"
"70225","2024","COM","2022","99","4","103","2024-12-30"
"70226","2024","COM","2022","308","5","313","2024-12-30"
"70227","2024","COM","2022","446","12","458","2024-12-30"
"70228","2024","COM","2022","976","16","992","2024-12-30"
"70229","2024","COM","2022","255","7","262","2024-12-30"
"70230","2024","COM","2022","94","4","98","2024-12-30"
"70231","2024","COM","2022","39","0","39","2024-12-30"
"70232","2024","COM","2022","131","3","134","2024-12-30"
"70233","2024","COM","2022","129","3","132","2024-12-30"
"70234","2024","COM","2022","219","10","229","2024-12-30"
"70235","2024","COM","2022","137","4","141","2024-12-30"
"70236","2024","COM","2022","454","8","462","2024-12-30"
"70237","2024","COM","2022","108","2","110","2024-12-30"
"70238","2024","COM","2022","128","6","134","2024-12-30"
"70239","2024","COM","2022","199","9","208","2024-12-30"
"70240","2024","COM","2022","1329","23","1352","2024-12-30"
"70242","2024","COM","2022","136","1","137","2024-12-30"
"70243","2024","COM","2022","317","9","326","2024-12-30"
"70244","2024","COM","2022","120","3","123","2024-12-30"
"70245","2024","COM","2022","3777","124","3901","2024-12-30"
"70247","2024","COM","2022","201","0","201","2024-12-30"
"70248","2024","COM","2022","1377","35","1412","2024-12-30"
"70249","2024","COM","2022","116","4","120","2024-12-30"
"70250","2024","COM","2022","486","5","491","2024-12-30"
"70251","2024","COM","2022","101","1","102","2024-12-30"
"70252","2024","COM","2022","181","3","184","2024-12-30"
"70253","2024","COM","2022","292","28","320","2024-12-30"
"70254","2024","COM","2022","273","8","281","2024-12-30"
"70255","2024","COM","2022","491","11","502","2024-12-30"
"70256","2024","COM","2022","695","13","708","2024-12-30"
"70257","2024","COM","2022","751","14","765","2024-12-30"
"70258","2024","COM","2022","1974","43","2017","2024-12-30"
"70259","2024","COM","2022","365","6","371","2024-12-30"
"70260","2024","COM","2022","692","18","710","2024-12-30"
"70261","2024","COM","2022","1367","33","1400","2024-12-30"
"70262","2024","COM","2022","151","5","156","2024-12-30"
"70263","2024","COM","2022","245","2","247","2024-12-30"
"70264","2024","COM","2022","40","0","40","2024-12-30"
"70265","2024","COM","2022","140","5","145","2024-12-30"
"70267","2024","COM","2022","517","6","523","2024-12-30"
"70268","2024","COM","2022","217","4","221","2024-12-30"
"70269","2024","COM","2022","32","1","33","2024-12-30"
"70271","2024","COM","2022","361","7","368","2024-12-30"
"70272","2024","COM","2022","178","3","181","2024-12-30"
"70273","2024","COM","2022","67","2","69","2024-12-30"
"70274","2024","COM","2022","48","0","48","2024-12-30"
"70275","2024","COM","2022","379","8","387","2024-12-30"
"70276","2024","COM","2022","184","5","189","2024-12-30"
"70277","2024","COM","2022","381","4","385","2024-12-30"
"70278","2024","COM","2022","215","4","219","2024-12-30"
"70279","2024","COM","2022","5455","406","5861","2024-12-30"
"70280","2024","COM","2022","928","20","948","2024-12-30"
"70282","2024","COM","2022","1030","17","1047","2024-12-30"
"70283","2024","COM","2022","448","5","453","2024-12-30"
"70284","2024","COM","2022","253","1","254","2024-12-30"
"70285","2024","COM","2022","10525","241","10766","2024-12-30"
"70286","2024","COM","2022","118","4","122","2024-12-30"
"70287","2024","COM","2022","47","0","47","2024-12-30"
"70288","2024","COM","2022","119","1","120","2024-12-30"
"70289","2024","COM","2022","208","1","209","2024-12-30"
"70290","2024","COM","2022","186","6","192","2024-12-30"
"70291","2024","COM","2022","101","4","105","2024-12-30"
"70292","2024","COM","2022","1550","27","1577","2024-12-30"
"70293","2024","COM","2022","67","1","68","2024-12-30"
"70294","2024","COM","2022","362","7","369","2024-12-30"
"70295","2024","COM","2022","196","5","201","2024-12-30"
"70296","2024","COM","2022","280","5","285","2024-12-30"
"70297","2024","COM","2022","63","0","63","2024-12-30"
"70298","2024","COM","2022","123","0","123","2024-12-30"
"70299","2024","COM","2022","332","5","337","2024-12-30"
"70301","2024","COM","2022","51","0","51","2024-12-30"
"70302","2024","COM","2022","73","1","74","2024-12-30"
"70303","2024","COM","2022","154","2","156","2024-12-30"
"70304","2024","COM","2022","116","5","121","2024-12-30"
"70305","2024","COM","2022","96","1","97","2024-12-30"
"70306","2024","COM","2022","479","12","491","2024-12-30"
"70307","2024","COM","2022","119","2","121","2024-12-30"
"70308","2024","COM","2022","196","3","199","2024-12-30"
"70309","2024","COM","2022","457","9","466","2024-12-30"
"70310","2024","COM","2022","7912","184","8096","2024-12-30"
"70311","2024","COM","2022","6674","258","6932","2024-12-30"
"70312","2024","COM","2022","831","23","854","2024-12-30"
"70313","2024","COM","2022","443","8","451","2024-12-30"
"70314","2024","COM","2022","164","6","170","2024-12-30"
"70315","2024","COM","2022","400","7","407","2024-12-30"
"70316","2024","COM","2022","87","4","91","2024-12-30"
"70317","2024","COM","2022","146","4","150","2024-12-30"
"70318","2024","COM","2022","454","11","465","2024-12-30"
"70319","2024","COM","2022","131","3","134","2024-12-30"
"70320","2024","COM","2022","95","3","98","2024-12-30"
"70321","2024","COM","2022","1361","27","1388","2024-12-30"
"70322","2024","COM","2022","279","7","286","2024-12-30"
"70323","2024","COM","2022","186","5","191","2024-12-30"
"70324","2024","COM","2022","613","16","629","2024-12-30"
"70325","2024","COM","2022","324","7","331","2024-12-30"
"70326","2024","COM","2022","302","10","312","2024-12-30"
"70327","2024","COM","2022","136","3","139","2024-12-30"
"70328","2024","COM","2022","333","6","339","2024-12-30"
"70329","2024","COM","2022","67","2","69","2024-12-30"
"70330","2024","COM","2022","338","9","347","2024-12-30"
"70331","2024","COM","2022","454","6","460","2024-12-30"
"70332","2024","COM","2022","49","0","49","2024-12-30"
"70334","2024","COM","2022","1527","25","1552","2024-12-30"
"70335","2024","COM","2022","56","2","58","2024-12-30"
"70336","2024","COM","2022","135","0","135","2024-12-30"
"70337","2024","COM","2022","55","1","56","2024-12-30"
"70338","2024","COM","2022","221","7","228","2024-12-30"
"70339","2024","COM","2022","1643","30","1673","2024-12-30"
"70340","2024","COM","2022","215","27","242","2024-12-30"
"70341","2024","COM","2022","299","4","303","2024-12-30"
"70342","2024","COM","2022","130","3","133","2024-12-30"
"70343","2024","COM","2022","279","3","282","2024-12-30"
"70344","2024","COM","2022","343","5","348","2024-12-30"
"70347","2024","COM","2022","366","9","375","2024-12-30"
"70348","2024","COM","2022","613","12","625","2024-12-30"
"70349","2024","COM","2022","238","6","244","2024-12-30"
"70350","2024","COM","2022","68","0","68","2024-12-30"
"70351","2024","COM","2022","236","2","238","2024-12-30"
"70352","2024","COM","2022","38","2","40","2024-12-30"
"70353","2024","COM","2022","506","10","516","2024-12-30"
"70355","2024","COM","2022","314","4","318","2024-12-30"
"70356","2024","COM","2022","299","6","305","2024-12-30"
"70357","2024","COM","2022","545","84","629","2024-12-30"
"70358","2024","COM","2022","266","4","270","2024-12-30"
"70359","2024","COM","2022","52","2","54","2024-12-30"
"70360","2024","COM","2022","70","1","71","2024-12-30"
"70361","2024","COM","2022","170","4","174","2024-12-30"
"70362","2024","COM","2022","121","4","125","2024-12-30"
"70363","2024","COM","2022","635","15","650","2024-12-30"
"70364","2024","COM","2022","121","2","123","2024-12-30"
"70366","2024","COM","2022","123","2","125","2024-12-30"
"70367","2024","COM","2022","191","4","195","2024-12-30"
"70368","2024","COM","2022","136","4","140","2024-12-30"
"70369","2024","COM","2022","48","1","49","2024-12-30"
"70371","2024","COM","2022","191","1","192","2024-12-30"
"70372","2024","COM","2022","159","1","160","2024-12-30"
"70373","2024","COM","2022","297","3","300","2024-12-30"
"70374","2024","COM","2022","92","3","95","2024-12-30"
"70376","2024","COM","2022","441","10","451","2024-12-30"
"70378","2024","COM","2022","1591","47","1638","2024-12-30"
"70380","2024","COM","2022","139","3","142","2024-12-30"
"70381","2024","COM","2022","352","12","364","2024-12-30"
"70383","2024","COM","2022","441","5","446","2024-12-30"
"70384","2024","COM","2022","221","1","222","2024-12-30"
"70385","2024","COM","2022","304","7","311","2024-12-30"
"70386","2024","COM","2022","170","2","172","2024-12-30"
"70387","2024","COM","2022","640","10","650","2024-12-30"
"70388","2024","COM","2022","1979","62","2041","2024-12-30"
"70389","2024","COM","2022","58","1","59","2024-12-30"
"70390","2024","COM","2022","505","9","514","2024-12-30"
"70392","2024","COM","2022","41","0","41","2024-12-30"
"70393","2024","COM","2022","433","4","437","2024-12-30"
"70394","2024","COM","2022","62","2","64","2024-12-30"
"70395","2024","COM","2022","60","1","61","2024-12-30"
"70396","2024","COM","2022","34","2","36","2024-12-30"
"70397","2024","COM","2022","85","0","85","2024-12-30"
"70398","2024","COM","2022","68","0","68","2024-12-30"
"70399","2024","COM","2022","205","7","212","2024-12-30"
"70400","2024","COM","2022","108","2","110","2024-12-30"
"70401","2024","COM","2022","153","1","154","2024-12-30"
"70402","2024","COM","2022","361","10","371","2024-12-30"
"70403","2024","COM","2022","245","3","248","2024-12-30"
"70404","2024","COM","2022","537","15","552","2024-12-30"
"70405","2024","COM","2022","193","2","195","2024-12-30"
"70406","2024","COM","2022","78","1","79","2024-12-30"
"70407","2024","COM","2022","279","5","284","2024-12-30"
"70408","2024","COM","2022","1082","19","1101","2024-12-30"
"70409","2024","COM","2022","107","2","109","2024-12-30"
"70410","2024","COM","2022","731","8","739","2024-12-30"
"70411","2024","COM","2022","39","0","39","2024-12-30"
"70412","2024","COM","2022","66","0","66","2024-12-30"
"70413","2024","COM","2022","1855","34","1889","2024-12-30"
"70414","2024","COM","2022","897","16","913","2024-12-30"
"70415","2024","COM","2022","600","10","610","2024-12-30"
"70416","2024","COM","2022","198","4","202","2024-12-30"
"70417","2024","COM","2022","294","4","298","2024-12-30"
"70418","2024","COM","2022","519","4","523","2024-12-30"
"70419","2024","COM","2022","115","2","117","2024-12-30"
"70420","2024","COM","2022","59","0","59","2024-12-30"
"70421","2024","COM","2022","2966","54","3020","2024-12-30"
"70422","2024","COM","2022","144","2","146","2024-12-30"
"70423","2024","COM","2022","115","3","118","2024-12-30"
"70425","2024","COM","2022","145","5","150","2024-12-30"
"70426","2024","COM","2022","238","9","247","2024-12-30"
"70427","2024","COM","2022","328","9","337","2024-12-30"
"70428","2024","COM","2022","1437","32","1469","2024-12-30"
"70429","2024","COM","2022","542","14","556","2024-12-30"
"70430","2024","COM","2022","63","0","63","2024-12-30"
"70431","2024","COM","2022","241","4","245","2024-12-30"
"70432","2024","COM","2022","330","6","336","2024-12-30"
"70433","2024","COM","2022","1359","30","1389","2024-12-30"
"70435","2024","COM","2022","852","26","878","2024-12-30"
"70436","2024","COM","2022","110","0","110","2024-12-30"
"70437","2024","COM","2022","16","0","16","2024-12-30"
"70438","2024","COM","2022","211","8","219","2024-12-30"
"70439","2024","COM","2022","379","7","386","2024-12-30"
"70440","2024","COM","2022","32","1","33","2024-12-30"
"70441","2024","COM","2022","270","5","275","2024-12-30"
"70442","2024","COM","2022","116","0","116","2024-12-30"
"70443","2024","COM","2022","89","0","89","2024-12-30"
"70444","2024","COM","2022","172","1","173","2024-12-30"
"70445","2024","COM","2022","121","1","122","2024-12-30"
"70446","2024","COM","2022","637","11","648","2024-12-30"
"70447","2024","COM","2022","2432","75","2507","2024-12-30"
"70448","2024","COM","2022","154","2","156","2024-12-30"
"70449","2024","COM","2022","68","0","68","2024-12-30"
"70450","2024","COM","2022","45","0","45","2024-12-30"
"70451","2024","COM","2022","2745","39","2784","2024-12-30"
"70452","2024","COM","2022","255","3","258","2024-12-30"
"70453","2024","COM","2022","79","0","79","2024-12-30"
"70454","2024","COM","2022","54","2","56","2024-12-30"
"70455","2024","COM","2022","1486","25","1511","2024-12-30"
"70456","2024","COM","2022","149","6","155","2024-12-30"
"70457","2024","COM","2022","106","2","108","2024-12-30"
"70459","2024","COM","2022","1091","20","1111","2024-12-30"
"70460","2024","COM","2022","420","11","431","2024-12-30"
"70461","2024","COM","2022","108","0","108","2024-12-30"
"70462","2024","COM","2022","79","2","81","2024-12-30"
"70463","2024","COM","2022","141","1","142","2024-12-30"
"70464","2024","COM","2022","1369","30","1399","2024-12-30"
"70466","2024","COM","2022","122","2","124","2024-12-30"
"70467","2024","COM","2022","2842","46","2888","2024-12-30"
"70468","2024","COM","2022","90","1","91","2024-12-30"
"70469","2024","COM","2022","209","3","212","2024-12-30"
"70470","2024","COM","2022","161","2","163","2024-12-30"
"70471","2024","COM","2022","22","1","23","2024-12-30"
"70472","2024","COM","2022","439","4","443","2024-12-30"
"70473","2024","COM","2022","1929","30","1959","2024-12-30"
"70474","2024","COM","2022","119","2","121","2024-12-30"
"70476","2024","COM","2022","76","0","76","2024-12-30"
"70477","2024","COM","2022","766","12","778","2024-12-30"
"70478","2024","COM","2022","875","15","890","2024-12-30"
"70479","2024","COM","2022","97","3","100","2024-12-30"
"70480","2024","COM","2022","158","4","162","2024-12-30"
"70481","2024","COM","2022","195","4","199","2024-12-30"
"70482","2024","COM","2022","1528","26","1554","2024-12-30"
"70483","2024","COM","2022","135","2","137","2024-12-30"
"70484","2024","COM","2022","188","3","191","2024-12-30"
"70485","2024","COM","2022","217","2","219","2024-12-30"
"70486","2024","COM","2022","108","1","109","2024-12-30"
"70487","2024","COM","2022","284","3","287","2024-12-30"
"70488","2024","COM","2022","185","0","185","2024-12-30"
"70489","2024","COM","2022","764","7","771","2024-12-30"
"70490","2024","COM","2022","127","1","128","2024-12-30"
"70491","2024","COM","2022","474","15","489","2024-12-30"
"70492","2024","COM","2022","565","11","576","2024-12-30"
"70493","2024","COM","2022","433","10","443","2024-12-30"
"70494","2024","COM","2022","354","6","360","2024-12-30"
"70496","2024","COM","2022","29","1","30","2024-12-30"
"70498","2024","COM","2022","445","17","462","2024-12-30"
"70499","2024","COM","2022","101","2","103","2024-12-30"
"70500","2024","COM","2022","165","9","174","2024-12-30"
"70501","2024","COM","2022","113","1","114","2024-12-30"
"70502","2024","COM","2022","82","0","82","2024-12-30"
"70503","2024","COM","2022","160","2","162","2024-12-30"
"70504","2024","COM","2022","349","4","353","2024-12-30"
"70505","2024","COM","2022","156","7","163","2024-12-30"
"70506","2024","COM","2022","387","11","398","2024-12-30"
"70507","2024","COM","2022","275","6","281","2024-12-30"
"70509","2024","COM","2022","123","0","123","2024-12-30"
"70510","2024","COM","2022","134","1","135","2024-12-30"
"70511","2024","COM","2022","229","4","233","2024-12-30"
"70512","2024","COM","2022","216","4","220","2024-12-30"
"70513","2024","COM","2022","2436","57","2493","2024-12-30"
"70514","2024","COM","2022","650","12","662","2024-12-30"
"70515","2024","COM","2022","66","1","67","2024-12-30"
"70516","2024","COM","2022","232","3","235","2024-12-30"
"70517","2024","COM","2022","433","15","448","2024-12-30"
"70518","2024","COM","2022","95","3","98","2024-12-30"
"70519","2024","COM","2022","109","4","113","2024-12-30"
"70520","2024","COM","2022","126","2","128","2024-12-30"
"70521","2024","COM","2022","179","5","184","2024-12-30"
"70522","2024","COM","2022","156","2","158","2024-12-30"
"70523","2024","COM","2022","184","2","186","2024-12-30"
"70524","2024","COM","2022","122","4","126","2024-12-30"
"70525","2024","COM","2022","219","4","223","2024-12-30"
"70526","2024","COM","2022","611","13","624","2024-12-30"
"70527","2024","COM","2022","78","1","79","2024-12-30"
"70528","2024","COM","2022","489","12","501","2024-12-30"
"70529","2024","COM","2022","373","12","385","2024-12-30"
"70530","2024","COM","2022","118","2","120","2024-12-30"
"70531","2024","COM","2022","101","1","102","2024-12-30"
"70532","2024","COM","2022","533","16","549","2024-12-30"
"70533","2024","COM","2022","112","1","113","2024-12-30"
"70534","2024","COM","2022","123","3","126","2024-12-30"
"70535","2024","COM","2022","156","6","162","2024-12-30"
"70536","2024","COM","2022","127","0","127","2024-12-30"
"70537","2024","COM","2022","296","2","298","2024-12-30"
"70538","2024","COM","2022","87","1","88","2024-12-30"
"70539","2024","COM","2022","476","8","484","2024-12-30"
"70540","2024","COM","2022","81","4","85","2024-12-30"
"70541","2024","COM","2022","204","1","205","2024-12-30"
"70542","2024","COM","2022","207","5","212","2024-12-30"
"70544","2024","COM","2022","110","5","115","2024-12-30"
"70545","2024","COM","2022","134","1","135","2024-12-30"
"70546","2024","COM","2022","204","23","227","2024-12-30"
"70547","2024","COM","2022","166","5","171","2024-12-30"
"70548","2024","COM","2022","131","0","131","2024-12-30"
"70549","2024","COM","2022","77","1","78","2024-12-30"
"70550","2024","COM","2022","15306","771","16077","2024-12-30"
"70552","2024","COM","2022","198","8","206","2024-12-30"
"70553","2024","COM","2022","115","1","116","2024-12-30"
"70554","2024","COM","2022","180","0","180","2024-12-30"
"70555","2024","COM","2022","167","1","168","2024-12-30"
"70557","2024","COM","2022","126","4","130","2024-12-30"
"70558","2024","COM","2022","155","2","157","2024-12-30"
"70559","2024","COM","2022","190","3","193","2024-12-30"
"70560","2024","COM","2022","178","3","181","2024-12-30"
"70561","2024","COM","2022","1425","94","1519","2024-12-30"
"70562","2024","COM","2022","155","3","158","2024-12-30"
"70563","2024","COM","2022","522","16","538","2024-12-30"
"70564","2024","COM","2022","312","17","329","2024-12-30"
"70565","2024","COM","2022","49","1","50","2024-12-30"
"70566","2024","COM","2022","199","4","203","2024-12-30"
"70567","2024","COM","2022","129","9","138","2024-12-30"
"70568","2024","COM","2022","57","1","58","2024-12-30"
"70569","2024","COM","2022","68","0","68","2024-12-30"
"70571","2024","COM","2022","37","1","38","2024-12-30"
"70572","2024","COM","2022","297","4","301","2024-12-30"
"70573","2024","COM","2022","109","1","110","2024-12-30"
"70574","2024","COM","2022","57","0","57","2024-12-30"
"70575","2024","COM","2022","867","18","885","2024-12-30"
"70576","2024","COM","2022","163","2","165","2024-12-30"
"70577","2024","COM","2022","381","11","392","2024-12-30"
"70578","2024","COM","2022","178","2","180","2024-12-30"
"70579","2024","COM","2022","417","15","432","2024-12-30"
"70580","2024","COM","2022","159","3","162","2024-12-30"
"70581","2024","COM","2022","714","13","727","2024-12-30"
"70582","2024","COM","2022","80","1","81","2024-12-30"
"70583","2024","COM","2022","139","0","139","2024-12-30"
"71001","2024","COM","2022","811","18","829","2024-12-30"
"71002","2024","COM","2022","1235","27","1262","2024-12-30"
"71003","2024","COM","2022","809","18","827","2024-12-30"
"71004","2024","COM","2022","1162","27","1189","2024-12-30"
"71005","2024","COM","2022","244","10","254","2024-12-30"
"71006","2024","COM","2022","195","5","200","2024-12-30"
"71007","2024","COM","2022","168","2","170","2024-12-30"
"71008","2024","COM","2022","146","4","150","2024-12-30"
"71009","2024","COM","2022","704","13","717","2024-12-30"
"71010","2024","COM","2022","816","18","834","2024-12-30"
"71011","2024","COM","2022","423","81","504","2024-12-30"
"71012","2024","COM","2022","343","6","349","2024-12-30"
"71013","2024","COM","2022","286","5","291","2024-12-30"
"71014","2024","COM","2022","13144","963","14107","2024-12-30"
"71015","2024","COM","2022","910","25","935","2024-12-30"
"71016","2024","COM","2022","1082","27","1109","2024-12-30"
"71017","2024","COM","2022","90","4","94","2024-12-30"
"71018","2024","COM","2022","566","5","571","2024-12-30"
"71019","2024","COM","2022","139","5","144","2024-12-30"
"71020","2024","COM","2022","99","2","101","2024-12-30"
"71021","2024","COM","2022","279","10","289","2024-12-30"
"71022","2024","COM","2022","627","9","636","2024-12-30"
"71023","2024","COM","2022","1007","18","1025","2024-12-30"
"71024","2024","COM","2022","495","13","508","2024-12-30"
"71025","2024","COM","2022","361","7","368","2024-12-30"
"71026","2024","COM","2022","333","13","346","2024-12-30"
"71027","2024","COM","2022","724","13","737","2024-12-30"
"71028","2024","COM","2022","103","0","103","2024-12-30"
"71029","2024","COM","2022","306","2","308","2024-12-30"
"71030","2024","COM","2022","196","4","200","2024-12-30"
"71031","2024","COM","2022","56","1","57","2024-12-30"
"71032","2024","COM","2022","708","14","722","2024-12-30"
"71033","2024","COM","2022","869","19","888","2024-12-30"
"71034","2024","COM","2022","333","6","339","2024-12-30"
"71035","2024","COM","2022","203","4","207","2024-12-30"
"71036","2024","COM","2022","68","0","68","2024-12-30"
"71037","2024","COM","2022","82","7","89","2024-12-30"
"71038","2024","COM","2022","473","12","485","2024-12-30"
"71039","2024","COM","2022","196","2","198","2024-12-30"
"71040","2024","COM","2022","5983","139","6122","2024-12-30"
"71041","2024","COM","2022","185","2","187","2024-12-30"
"71042","2024","COM","2022","443","8","451","2024-12-30"
"71043","2024","COM","2022","84","3","87","2024-12-30"
"71044","2024","COM","2022","311","5","316","2024-12-30"
"71045","2024","COM","2022","176","4","180","2024-12-30"
"71046","2024","COM","2022","98","2","100","2024-12-30"
"71047","2024","COM","2022","4656","71","4727","2024-12-30"
"71048","2024","COM","2022","171","2","173","2024-12-30"
"71050","2024","COM","2022","360","7","367","2024-12-30"
"71051","2024","COM","2022","134","2","136","2024-12-30"
"71052","2024","COM","2022","726","17","743","2024-12-30"
"71054","2024","COM","2022","677","15","692","2024-12-30"
"71056","2024","COM","2022","2372","37","2409","2024-12-30"
"71057","2024","COM","2022","128","3","131","2024-12-30"
"71058","2024","COM","2022","185","4","189","2024-12-30"
"71059","2024","COM","2022","3508","60","3568","2024-12-30"
"71060","2024","COM","2022","230","2","232","2024-12-30"
"71061","2024","COM","2022","479","14","493","2024-12-30"
"71062","2024","COM","2022","297","7","304","2024-12-30"
"71063","2024","COM","2022","754","13","767","2024-12-30"
"71064","2024","COM","2022","973","25","998","2024-12-30"
"71065","2024","COM","2022","277","4","281","2024-12-30"
"71066","2024","COM","2022","114","3","117","2024-12-30"
"71067","2024","COM","2022","122","2","124","2024-12-30"
"71068","2024","COM","2022","58","1","59","2024-12-30"
"71069","2024","COM","2022","588","28","616","2024-12-30"
"71070","2024","COM","2022","2155","58","2213","2024-12-30"
"71071","2024","COM","2022","264","7","271","2024-12-30"
"71072","2024","COM","2022","145","8","153","2024-12-30"
"71073","2024","COM","2022","5402","95","5497","2024-12-30"
"71074","2024","COM","2022","564","21","585","2024-12-30"
"71075","2024","COM","2022","636","14","650","2024-12-30"
"71076","2024","COM","2022","44592","1375","45967","2024-12-30"
"71077","2024","COM","2022","471","15","486","2024-12-30"
"71078","2024","COM","2022","147","2","149","2024-12-30"
"71079","2024","COM","2022","464","10","474","2024-12-30"
"71080","2024","COM","2022","84","0","84","2024-12-30"
"71081","2024","COM","2022","2616","38","2654","2024-12-30"
"71082","2024","COM","2022","208","7","215","2024-12-30"
"71084","2024","COM","2022","529","13","542","2024-12-30"
"71085","2024","COM","2022","218","2","220","2024-12-30"
"71086","2024","COM","2022","441","16","457","2024-12-30"
"71087","2024","COM","2022","166","1","167","2024-12-30"
"71088","2024","COM","2022","225","6","231","2024-12-30"
"71089","2024","COM","2022","240","2","242","2024-12-30"
"71090","2024","COM","2022","4038","88","4126","2024-12-30"
"71091","2024","COM","2022","190","2","192","2024-12-30"
"71092","2024","COM","2022","496","15","511","2024-12-30"
"71093","2024","COM","2022","641","15","656","2024-12-30"
"71094","2024","COM","2022","142","1","143","2024-12-30"
"71095","2024","COM","2022","432","7","439","2024-12-30"
"71096","2024","COM","2022","194","3","197","2024-12-30"
"71097","2024","COM","2022","497","9","506","2024-12-30"
"71098","2024","COM","2022","227","3","230","2024-12-30"
"71099","2024","COM","2022","335","7","342","2024-12-30"
"71100","2024","COM","2022","206","6","212","2024-12-30"
"71101","2024","COM","2022","434","7","441","2024-12-30"
"71102","2024","COM","2022","680","26","706","2024-12-30"
"71103","2024","COM","2022","284","6","290","2024-12-30"
"71104","2024","COM","2022","192","6","198","2024-12-30"
"71105","2024","COM","2022","8154","300","8454","2024-12-30"
"71106","2024","COM","2022","2789","290","3079","2024-12-30"
"71107","2024","COM","2022","330","13","343","2024-12-30"
"71108","2024","COM","2022","175","3","178","2024-12-30"
"71109","2024","COM","2022","365","8","373","2024-12-30"
"71110","2024","COM","2022","558","18","576","2024-12-30"
"71111","2024","COM","2022","296","6","302","2024-12-30"
"71112","2024","COM","2022","232","7","239","2024-12-30"
"71113","2024","COM","2022","89","0","89","2024-12-30"
"71115","2024","COM","2022","83","4","87","2024-12-30"
"71116","2024","COM","2022","168","1","169","2024-12-30"
"71117","2024","COM","2022","1098","31","1129","2024-12-30"
"71118","2024","COM","2022","6205","122","6327","2024-12-30"
"71119","2024","COM","2022","1124","35","1159","2024-12-30"
"71120","2024","COM","2022","3656","72","3728","2024-12-30"
"71121","2024","COM","2022","323","4","327","2024-12-30"
"71122","2024","COM","2022","538","18","556","2024-12-30"
"71123","2024","COM","2022","373","5","378","2024-12-30"
"71124","2024","COM","2022","208","6","214","2024-12-30"
"71125","2024","COM","2022","19","0","19","2024-12-30"
"71126","2024","COM","2022","604","19","623","2024-12-30"
"71127","2024","COM","2022","51","4","55","2024-12-30"
"71128","2024","COM","2022","83","6","89","2024-12-30"
"71129","2024","COM","2022","295","2","297","2024-12-30"
"71130","2024","COM","2022","230","6","236","2024-12-30"
"71131","2024","COM","2022","896","12","908","2024-12-30"
"71132","2024","COM","2022","2213","40","2253","2024-12-30"
"71133","2024","COM","2022","1596","72","1668","2024-12-30"
"71134","2024","COM","2022","658","12","670","2024-12-30"
"71135","2024","COM","2022","834","22","856","2024-12-30"
"71136","2024","COM","2022","276","8","284","2024-12-30"
"71137","2024","COM","2022","4980","251","5231","2024-12-30"
"71139","2024","COM","2022","150","6","156","2024-12-30"
"71140","2024","COM","2022","39","2","41","2024-12-30"
"71141","2024","COM","2022","314","11","325","2024-12-30"
"71142","2024","COM","2022","248","4","252","2024-12-30"
"71143","2024","COM","2022","460","10","470","2024-12-30"
"71144","2024","COM","2022","195","4","199","2024-12-30"
"71145","2024","COM","2022","569","5","574","2024-12-30"
"71146","2024","COM","2022","271","5","276","2024-12-30"
"71147","2024","COM","2022","249","3","252","2024-12-30"
"71148","2024","COM","2022","839","21","860","2024-12-30"
"71149","2024","COM","2022","1211","28","1239","2024-12-30"
"71150","2024","COM","2022","3179","86","3265","2024-12-30"
"71151","2024","COM","2022","80","4","84","2024-12-30"
"71152","2024","COM","2022","174","4","178","2024-12-30"
"71153","2024","COM","2022","20536","321","20857","2024-12-30"
"71154","2024","COM","2022","2473","62","2535","2024-12-30"
"71155","2024","COM","2022","510","13","523","2024-12-30"
"71156","2024","COM","2022","264","45","309","2024-12-30"
"71157","2024","COM","2022","1853","20","1873","2024-12-30"
"71158","2024","COM","2022","1580","39","1619","2024-12-30"
"71159","2024","COM","2022","200","7","207","2024-12-30"
"71160","2024","COM","2022","306","8","314","2024-12-30"
"71161","2024","COM","2022","337","8","345","2024-12-30"
"71162","2024","COM","2022","1100","23","1123","2024-12-30"
"71163","2024","COM","2022","93","1","94","2024-12-30"
"71164","2024","COM","2022","139","2","141","2024-12-30"
"71165","2024","COM","2022","355","9","364","2024-12-30"
"71166","2024","COM","2022","111","4","115","2024-12-30"
"71167","2024","COM","2022","548","17","565","2024-12-30"
"71168","2024","COM","2022","173","0","173","2024-12-30"
"71169","2024","COM","2022","680","104","784","2024-12-30"
"71170","2024","COM","2022","1769","39","1808","2024-12-30"
"71171","2024","COM","2022","299","9","308","2024-12-30"
"71172","2024","COM","2022","88","2","90","2024-12-30"
"71173","2024","COM","2022","328","5","333","2024-12-30"
"71174","2024","COM","2022","164","4","168","2024-12-30"
"71175","2024","COM","2022","373","7","380","2024-12-30"
"71176","2024","COM","2022","7380","242","7622","2024-12-30"
"71177","2024","COM","2022","819","9","828","2024-12-30"
"71178","2024","COM","2022","883","29","912","2024-12-30"
"71179","2024","COM","2022","77","1","78","2024-12-30"
"71181","2024","COM","2022","147","2","149","2024-12-30"
"71182","2024","COM","2022","1471","52","1523","2024-12-30"
"71183","2024","COM","2022","152","2","154","2024-12-30"
"71184","2024","COM","2022","634","7","641","2024-12-30"
"71185","2024","COM","2022","325","12","337","2024-12-30"
"71186","2024","COM","2022","255","2","257","2024-12-30"
"71187","2024","COM","2022","1624","32","1656","2024-12-30"
"71188","2024","COM","2022","64","2","66","2024-12-30"
"71189","2024","COM","2022","1642","42","1684","2024-12-30"
"71190","2024","COM","2022","2150","28","2178","2024-12-30"
"71191","2024","COM","2022","482","6","488","2024-12-30"
"71192","2024","COM","2022","1788","150","1938","2024-12-30"
"71193","2024","COM","2022","481","11","492","2024-12-30"
"71194","2024","COM","2022","819","18","837","2024-12-30"
"71195","2024","COM","2022","223","2","225","2024-12-30"
"71196","2024","COM","2022","621","9","630","2024-12-30"
"71198","2024","COM","2022","412","7","419","2024-12-30"
"71199","2024","COM","2022","173","8","181","2024-12-30"
"71200","2024","COM","2022","722","18","740","2024-12-30"
"71201","2024","COM","2022","192","3","195","2024-12-30"
"71202","2024","COM","2022","1845","363","2208","2024-12-30"
"71203","2024","COM","2022","56","1","57","2024-12-30"
"71204","2024","COM","2022","1434","36","1470","2024-12-30"
"71205","2024","COM","2022","672","12","684","2024-12-30"
"71206","2024","COM","2022","251","5","256","2024-12-30"
"71207","2024","COM","2022","282","11","293","2024-12-30"
"71208","2024","COM","2022","204","4","208","2024-12-30"
"71209","2024","COM","2022","726","16","742","2024-12-30"
"71210","2024","COM","2022","354","9","363","2024-12-30"
"71212","2024","COM","2022","1407","31","1438","2024-12-30"
"71213","2024","COM","2022","567","16","583","2024-12-30"
"71214","2024","COM","2022","418","12","430","2024-12-30"
"71215","2024","COM","2022","2569","74","2643","2024-12-30"
"71216","2024","COM","2022","195","5","200","2024-12-30"
"71217","2024","COM","2022","130","5","135","2024-12-30"
"71218","2024","COM","2022","569","19","588","2024-12-30"
"71219","2024","COM","2022","568","6","574","2024-12-30"
"71220","2024","COM","2022","475","4","479","2024-12-30"
"71221","2024","COM","2022","3623","116","3739","2024-12-30"
"71222","2024","COM","2022","891","22","913","2024-12-30"
"71223","2024","COM","2022","550","13","563","2024-12-30"
"71224","2024","COM","2022","86","7","93","2024-12-30"
"71225","2024","COM","2022","572","16","588","2024-12-30"
"71226","2024","COM","2022","26","0","26","2024-12-30"
"71227","2024","COM","2022","494","9","503","2024-12-30"
"71228","2024","COM","2022","226","3","229","2024-12-30"
"71229","2024","COM","2022","227","8","235","2024-12-30"
"71230","2024","COM","2022","6547","155","6702","2024-12-30"
"71231","2024","COM","2022","598","8","606","2024-12-30"
"71232","2024","COM","2022","202","5","207","2024-12-30"
"71233","2024","COM","2022","301","7","308","2024-12-30"
"71234","2024","COM","2022","352","6","358","2024-12-30"
"71235","2024","COM","2022","1908","106","2014","2024-12-30"
"71236","2024","COM","2022","890","17","907","2024-12-30"
"71237","2024","COM","2022","513","9","522","2024-12-30"
"71238","2024","COM","2022","1001","18","1019","2024-12-30"
"71239","2024","COM","2022","689","10","699","2024-12-30"
"71240","2024","COM","2022","398","14","412","2024-12-30"
"71241","2024","COM","2022","475","18","493","2024-12-30"
"71242","2024","COM","2022","511","11","522","2024-12-30"
"71243","2024","COM","2022","359","7","366","2024-12-30"
"71244","2024","COM","2022","454","4","458","2024-12-30"
"71245","2024","COM","2022","332","6","338","2024-12-30"
"71246","2024","COM","2022","246","4","250","2024-12-30"
"71247","2024","COM","2022","351","9","360","2024-12-30"
"71248","2024","COM","2022","695","16","711","2024-12-30"
"71249","2024","COM","2022","964","37","1001","2024-12-30"
"71250","2024","COM","2022","1135","45","1180","2024-12-30"
"71251","2024","COM","2022","595","12","607","2024-12-30"
"71252","2024","COM","2022","350","13","363","2024-12-30"
"71253","2024","COM","2022","945","23","968","2024-12-30"
"71254","2024","COM","2022","162","2","164","2024-12-30"
"71255","2024","COM","2022","173","2","175","2024-12-30"
"71256","2024","COM","2022","562","12","574","2024-12-30"
"71257","2024","COM","2022","662","13","675","2024-12-30"
"71258","2024","COM","2022","506","6","512","2024-12-30"
"71259","2024","COM","2022","379","6","385","2024-12-30"
"71261","2024","COM","2022","686","12","698","2024-12-30"
"71262","2024","COM","2022","161","3","164","2024-12-30"
"71263","2024","COM","2022","6483","232","6715","2024-12-30"
"71264","2024","COM","2022","319","8","327","2024-12-30"
"71266","2024","COM","2022","327","5","332","2024-12-30"
"71267","2024","COM","2022","848","63","911","2024-12-30"
"71268","2024","COM","2022","324","11","335","2024-12-30"
"71269","2024","COM","2022","1902","28","1930","2024-12-30"
"71270","2024","COM","2022","34759","709","35468","2024-12-30"
"71271","2024","COM","2022","147","5","152","2024-12-30"
"71272","2024","COM","2022","216","4","220","2024-12-30"
"71273","2024","COM","2022","280","4","284","2024-12-30"
"71274","2024","COM","2022","390","12","402","2024-12-30"
"71275","2024","COM","2022","1711","35","1746","2024-12-30"
"71276","2024","COM","2022","135","5","140","2024-12-30"
"71277","2024","COM","2022","683","16","699","2024-12-30"
"71278","2024","COM","2022","164","2","166","2024-12-30"
"71279","2024","COM","2022","603","17","620","2024-12-30"
"71280","2024","COM","2022","82","3","85","2024-12-30"
"71281","2024","COM","2022","297","13","310","2024-12-30"
"71282","2024","COM","2022","1276","23","1299","2024-12-30"
"71283","2024","COM","2022","534","10","544","2024-12-30"
"71284","2024","COM","2022","124","5","129","2024-12-30"
"71285","2024","COM","2022","404","8","412","2024-12-30"
"71286","2024","COM","2022","282","4","286","2024-12-30"
"71287","2024","COM","2022","308","5","313","2024-12-30"
"71289","2024","COM","2022","1159","34","1193","2024-12-30"
"71290","2024","COM","2022","401","57","458","2024-12-30"
"71291","2024","COM","2022","964","23","987","2024-12-30"
"71292","2024","COM","2022","1311","45","1356","2024-12-30"
"71293","2024","COM","2022","410","10","420","2024-12-30"
"71294","2024","COM","2022","1217","119","1336","2024-12-30"
"71295","2024","COM","2022","1488","29","1517","2024-12-30"
"71296","2024","COM","2022","742","19","761","2024-12-30"
"71297","2024","COM","2022","744","21","765","2024-12-30"
"71299","2024","COM","2022","339","5","344","2024-12-30"
"71300","2024","COM","2022","593","16","609","2024-12-30"
"71301","2024","COM","2022","168","1","169","2024-12-30"
"71302","2024","COM","2022","203","3","206","2024-12-30"
"71303","2024","COM","2022","496","6","502","2024-12-30"
"71305","2024","COM","2022","864","18","882","2024-12-30"
"71306","2024","COM","2022","16946","272","17218","2024-12-30"
"71307","2024","COM","2022","297","5","302","2024-12-30"
"71308","2024","COM","2022","31","1","32","2024-12-30"
"71309","2024","COM","2022","1864","59","1923","2024-12-30"
"71310","2024","COM","2022","4982","69","5051","2024-12-30"
"71311","2024","COM","2022","251","6","257","2024-12-30"
"71312","2024","COM","2022","241","5","246","2024-12-30"
"71313","2024","COM","2022","375","13","388","2024-12-30"
"71314","2024","COM","2022","199","0","199","2024-12-30"
"71315","2024","COM","2022","188","2","190","2024-12-30"
"71316","2024","COM","2022","356","12","368","2024-12-30"
"71317","2024","COM","2022","186","3","189","2024-12-30"
"71318","2024","COM","2022","1087","17","1104","2024-12-30"
"71319","2024","COM","2022","763","16","779","2024-12-30"
"71320","2024","COM","2022","310","3","313","2024-12-30"
"71321","2024","COM","2022","191","4","195","2024-12-30"
"71322","2024","COM","2022","59","1","60","2024-12-30"
"71323","2024","COM","2022","142","2","144","2024-12-30"
"71324","2024","COM","2022","595","21","616","2024-12-30"
"71325","2024","COM","2022","1186","33","1219","2024-12-30"
"71326","2024","COM","2022","428","1","429","2024-12-30"
"71327","2024","COM","2022","330","13","343","2024-12-30"
"71328","2024","COM","2022","654","16","670","2024-12-30"
"71329","2024","COM","2022","405","10","415","2024-12-30"
"71330","2024","COM","2022","752","11","763","2024-12-30"
"71331","2024","COM","2022","101","4","105","2024-12-30"
"71332","2024","COM","2022","493","12","505","2024-12-30"
"71333","2024","COM","2022","1221","35","1256","2024-12-30"
"71334","2024","COM","2022","384","6","390","2024-12-30"
"71335","2024","COM","2022","66","1","67","2024-12-30"
"71336","2024","COM","2022","3183","66","3249","2024-12-30"
"71337","2024","COM","2022","290","12","302","2024-12-30"
"71338","2024","COM","2022","231","5","236","2024-12-30"
"71339","2024","COM","2022","371","8","379","2024-12-30"
"71340","2024","COM","2022","1413","24","1437","2024-12-30"
"71341","2024","COM","2022","254","5","259","2024-12-30"
"71342","2024","COM","2022","9256","397","9653","2024-12-30"
"71343","2024","COM","2022","287","6","293","2024-12-30"
"71344","2024","COM","2022","70","2","72","2024-12-30"
"71345","2024","COM","2022","666","19","685","2024-12-30"
"71346","2024","COM","2022","1546","22","1568","2024-12-30"
"71347","2024","COM","2022","565","13","578","2024-12-30"
"71348","2024","COM","2022","140","3","143","2024-12-30"
"71349","2024","COM","2022","48","0","48","2024-12-30"
"71350","2024","COM","2022","851","29","880","2024-12-30"
"71351","2024","COM","2022","1945","16","1961","2024-12-30"
"71352","2024","COM","2022","87","3","90","2024-12-30"
"71353","2024","COM","2022","554","12","566","2024-12-30"
"71354","2024","COM","2022","559","22","581","2024-12-30"
"71355","2024","COM","2022","276","5","281","2024-12-30"
"71356","2024","COM","2022","955","30","985","2024-12-30"
"71357","2024","COM","2022","220","0","220","2024-12-30"
"71358","2024","COM","2022","103","1","104","2024-12-30"
"71359","2024","COM","2022","583","11","594","2024-12-30"
"71360","2024","COM","2022","1865","44","1909","2024-12-30"
"71361","2024","COM","2022","56","4","60","2024-12-30"
"71362","2024","COM","2022","330","7","337","2024-12-30"
"71363","2024","COM","2022","80","5","85","2024-12-30"
"71364","2024","COM","2022","172","0","172","2024-12-30"
"71365","2024","COM","2022","612","6","618","2024-12-30"
"71366","2024","COM","2022","369","7","376","2024-12-30"
"71367","2024","COM","2022","371","5","376","2024-12-30"
"71368","2024","COM","2022","287","15","302","2024-12-30"
"71369","2024","COM","2022","411","15","426","2024-12-30"
"71370","2024","COM","2022","616","13","629","2024-12-30"
"71371","2024","COM","2022","1571","39","1610","2024-12-30"
"71372","2024","COM","2022","2002","44","2046","2024-12-30"
"71373","2024","COM","2022","1740","23","1763","2024-12-30"
"71374","2024","COM","2022","160","2","162","2024-12-30"
"71376","2024","COM","2022","274","4","278","2024-12-30"
"71377","2024","COM","2022","138","1","139","2024-12-30"
"71378","2024","COM","2022","1581","39","1620","2024-12-30"
"71379","2024","COM","2022","1250","23","1273","2024-12-30"
"71380","2024","COM","2022","810","10","820","2024-12-30"
"71381","2024","COM","2022","70","0","70","2024-12-30"
"71382","2024","COM","2022","690","14","704","2024-12-30"
"71383","2024","COM","2022","548","7","555","2024-12-30"
"71384","2024","COM","2022","525","14","539","2024-12-30"
"71385","2024","COM","2022","590","17","607","2024-12-30"
"71386","2024","COM","2022","129","1","130","2024-12-30"
"71387","2024","COM","2022","245","8","253","2024-12-30"
"71388","2024","COM","2022","493","10","503","2024-12-30"
"71389","2024","COM","2022","267","13","280","2024-12-30"
"71390","2024","COM","2022","1106","23","1129","2024-12-30"
"71391","2024","COM","2022","542","17","559","2024-12-30"
"71392","2024","COM","2022","492","12","504","2024-12-30"
"71393","2024","COM","2022","508","19","527","2024-12-30"
"71394","2024","COM","2022","797","9","806","2024-12-30"
"71395","2024","COM","2022","217","2","219","2024-12-30"
"71396","2024","COM","2022","489","9","498","2024-12-30"
"71397","2024","COM","2022","282","8","290","2024-12-30"
"71398","2024","COM","2022","1054","31","1085","2024-12-30"
"71399","2024","COM","2022","513","13","526","2024-12-30"
"71400","2024","COM","2022","139","3","142","2024-12-30"
"71401","2024","COM","2022","657","12","669","2024-12-30"
"71402","2024","COM","2022","765","24","789","2024-12-30"
"71403","2024","COM","2022","275","11","286","2024-12-30"
"71404","2024","COM","2022","898","20","918","2024-12-30"
"71405","2024","COM","2022","183","5","188","2024-12-30"
"71406","2024","COM","2022","122","2","124","2024-12-30"
"71407","2024","COM","2022","223","3","226","2024-12-30"
"71408","2024","COM","2022","426","8","434","2024-12-30"
"71409","2024","COM","2022","307","8","315","2024-12-30"
"71410","2024","COM","2022","806","20","826","2024-12-30"
"71411","2024","COM","2022","150","3","153","2024-12-30"
"71412","2024","COM","2022","1175","28","1203","2024-12-30"
"71413","2024","COM","2022","785","9","794","2024-12-30"
"71414","2024","COM","2022","434","16","450","2024-12-30"
"71415","2024","COM","2022","143","3","146","2024-12-30"
"71416","2024","COM","2022","593","9","602","2024-12-30"
"71417","2024","COM","2022","1047","10","1057","2024-12-30"
"71419","2024","COM","2022","1947","34","1981","2024-12-30"
"71420","2024","COM","2022","2346","66","2412","2024-12-30"
"71421","2024","COM","2022","177","1","178","2024-12-30"
"71422","2024","COM","2022","263","12","275","2024-12-30"
"71423","2024","COM","2022","440","5","445","2024-12-30"
"71424","2024","COM","2022","209","3","212","2024-12-30"
"71425","2024","COM","2022","281","5","286","2024-12-30"
"71426","2024","COM","2022","510","9","519","2024-12-30"
"71427","2024","COM","2022","52","1","53","2024-12-30"
"71428","2024","COM","2022","776","24","800","2024-12-30"
"71430","2024","COM","2022","389","17","406","2024-12-30"
"71431","2024","COM","2022","377","6","383","2024-12-30"
"71433","2024","COM","2022","468","13","481","2024-12-30"
"71434","2024","COM","2022","337","11","348","2024-12-30"
"71435","2024","COM","2022","230","7","237","2024-12-30"
"71436","2024","COM","2022","966","22","988","2024-12-30"
"71437","2024","COM","2022","325","11","336","2024-12-30"
"71438","2024","COM","2022","511","19","530","2024-12-30"
"71439","2024","COM","2022","759","18","777","2024-12-30"
"71440","2024","COM","2022","371","9","380","2024-12-30"
"71441","2024","COM","2022","287","9","296","2024-12-30"
"71442","2024","COM","2022","1554","23","1577","2024-12-30"
"71443","2024","COM","2022","1643","57","1700","2024-12-30"
"71444","2024","COM","2022","1249","26","1275","2024-12-30"
"71445","2024","COM","2022","6211","159","6370","2024-12-30"
"71446","2024","COM","2022","196","6","202","2024-12-30"
"71447","2024","COM","2022","267","8","275","2024-12-30"
"71448","2024","COM","2022","1388","35","1423","2024-12-30"
"71449","2024","COM","2022","146","2","148","2024-12-30"
"71450","2024","COM","2022","100","4","104","2024-12-30"
"71451","2024","COM","2022","92","2","94","2024-12-30"
"71452","2024","COM","2022","114","1","115","2024-12-30"
"71453","2024","COM","2022","241","2","243","2024-12-30"
"71454","2024","COM","2022","175","6","181","2024-12-30"
"71455","2024","COM","2022","150","1","151","2024-12-30"
"71456","2024","COM","2022","1902","70","1972","2024-12-30"
"71457","2024","COM","2022","120","2","122","2024-12-30"
"71458","2024","COM","2022","65","1","66","2024-12-30"
"71459","2024","COM","2022","328","16","344","2024-12-30"
"71460","2024","COM","2022","484","24","508","2024-12-30"
"71461","2024","COM","2022","65","0","65","2024-12-30"
"71462","2024","COM","2022","523","12","535","2024-12-30"
"71463","2024","COM","2022","595","14","609","2024-12-30"
"71464","2024","COM","2022","177","3","180","2024-12-30"
"71465","2024","COM","2022","274","3","277","2024-12-30"
"71466","2024","COM","2022","123","3","126","2024-12-30"
"71468","2024","COM","2022","837","13","850","2024-12-30"
"71469","2024","COM","2022","378","8","386","2024-12-30"
"71470","2024","COM","2022","362","10","372","2024-12-30"
"71471","2024","COM","2022","99","4","103","2024-12-30"
"71472","2024","COM","2022","201","7","208","2024-12-30"
"71473","2024","COM","2022","150","2","152","2024-12-30"
"71474","2024","COM","2022","149","4","153","2024-12-30"
"71475","2024","COM","2022","6476","153","6629","2024-12-30"
"71477","2024","COM","2022","480","13","493","2024-12-30"
"71478","2024","COM","2022","78","1","79","2024-12-30"
"71479","2024","COM","2022","1729","35","1764","2024-12-30"
"71480","2024","COM","2022","604","14","618","2024-12-30"
"71481","2024","COM","2022","1128","20","1148","2024-12-30"
"71482","2024","COM","2022","832","11","843","2024-12-30"
"71483","2024","COM","2022","412","12","424","2024-12-30"
"71484","2024","COM","2022","1221","30","1251","2024-12-30"
"71485","2024","COM","2022","252","14","266","2024-12-30"
"71486","2024","COM","2022","8508","136","8644","2024-12-30"
"71487","2024","COM","2022","156","4","160","2024-12-30"
"71488","2024","COM","2022","98","4","102","2024-12-30"
"71489","2024","COM","2022","581","10","591","2024-12-30"
"71490","2024","COM","2022","997","27","1024","2024-12-30"
"71491","2024","COM","2022","1132","29","1161","2024-12-30"
"71493","2024","COM","2022","349","8","357","2024-12-30"
"71494","2024","COM","2022","508","13","521","2024-12-30"
"71495","2024","COM","2022","869","10","879","2024-12-30"
"71496","2024","COM","2022","134","5","139","2024-12-30"
"71497","2024","COM","2022","2158","47","2205","2024-12-30"
"71498","2024","COM","2022","148","3","151","2024-12-30"
"71499","2024","COM","2022","4265","63","4328","2024-12-30"
"71500","2024","COM","2022","95","2","97","2024-12-30"
"71501","2024","COM","2022","141","3","144","2024-12-30"
"71502","2024","COM","2022","1601","46","1647","2024-12-30"
"71503","2024","COM","2022","124","3","127","2024-12-30"
"71504","2024","COM","2022","83","0","83","2024-12-30"
"71505","2024","COM","2022","80","1","81","2024-12-30"
"71506","2024","COM","2022","1141","29","1170","2024-12-30"
"71507","2024","COM","2022","170","2","172","2024-12-30"
"71508","2024","COM","2022","385","8","393","2024-12-30"
"71509","2024","COM","2022","461","8","469","2024-12-30"
"71510","2024","COM","2022","608","18","626","2024-12-30"
"71512","2024","COM","2022","2911","67","2978","2024-12-30"
"71513","2024","COM","2022","1132","37","1169","2024-12-30"
"71514","2024","COM","2022","432","5","437","2024-12-30"
"71515","2024","COM","2022","103","2","105","2024-12-30"
"71516","2024","COM","2022","595","9","604","2024-12-30"
"71517","2024","COM","2022","246","6","252","2024-12-30"
"71518","2024","COM","2022","290","3","293","2024-12-30"
"71519","2024","COM","2022","187","4","191","2024-12-30"
"71520","2024","COM","2022","1208","23","1231","2024-12-30"
"71521","2024","COM","2022","105","4","109","2024-12-30"
"71522","2024","COM","2022","1744","42","1786","2024-12-30"
"71523","2024","COM","2022","1175","20","1195","2024-12-30"
"71524","2024","COM","2022","178","7","185","2024-12-30"
"71525","2024","COM","2022","576","9","585","2024-12-30"
"71526","2024","COM","2022","342","10","352","2024-12-30"
"71527","2024","COM","2022","187","5","192","2024-12-30"
"71528","2024","COM","2022","1958","46","2004","2024-12-30"
"71529","2024","COM","2022","274","5","279","2024-12-30"
"71530","2024","COM","2022","489","3","492","2024-12-30"
"71531","2024","COM","2022","207","1","208","2024-12-30"
"71532","2024","COM","2022","196","6","202","2024-12-30"
"71533","2024","COM","2022","556","10","566","2024-12-30"
"71534","2024","COM","2022","109","5","114","2024-12-30"
"71535","2024","COM","2022","503","13","516","2024-12-30"
"71537","2024","COM","2022","137","2","139","2024-12-30"
"71538","2024","COM","2022","422","10","432","2024-12-30"
"71539","2024","COM","2022","79","1","80","2024-12-30"
"71540","2024","COM","2022","2805","38","2843","2024-12-30"
"71541","2024","COM","2022","376","3","379","2024-12-30"
"71542","2024","COM","2022","1447","25","1472","2024-12-30"
"71543","2024","COM","2022","5702","229","5931","2024-12-30"
"71544","2024","COM","2022","173","2","175","2024-12-30"
"71545","2024","COM","2022","1067","18","1085","2024-12-30"
"71546","2024","COM","2022","398","9","407","2024-12-30"
"71547","2024","COM","2022","259","5","264","2024-12-30"
"71548","2024","COM","2022","241","2","243","2024-12-30"
"71549","2024","COM","2022","204","6","210","2024-12-30"
"71550","2024","COM","2022","812","16","828","2024-12-30"
"71551","2024","COM","2022","97","3","100","2024-12-30"
"71552","2024","COM","2022","497","17","514","2024-12-30"
"71553","2024","COM","2022","279","5","284","2024-12-30"
"71554","2024","COM","2022","111","1","112","2024-12-30"
"71555","2024","COM","2022","2287","44","2331","2024-12-30"
"71556","2024","COM","2022","581","7","588","2024-12-30"
"71557","2024","COM","2022","692","19","711","2024-12-30"
"71558","2024","COM","2022","1116","27","1143","2024-12-30"
"71559","2024","COM","2022","525","13","538","2024-12-30"
"71561","2024","COM","2022","236","4","240","2024-12-30"
"71562","2024","COM","2022","207","37","244","2024-12-30"
"71563","2024","COM","2022","77","3","80","2024-12-30"
"71564","2024","COM","2022","738","19","757","2024-12-30"
"71565","2024","COM","2022","557","12","569","2024-12-30"
"71566","2024","COM","2022","942","10","952","2024-12-30"
"71567","2024","COM","2022","233","5","238","2024-12-30"
"71568","2024","COM","2022","55","0","55","2024-12-30"
"71570","2024","COM","2022","508","11","519","2024-12-30"
"71571","2024","COM","2022","430","14","444","2024-12-30"
"71572","2024","COM","2022","234","0","234","2024-12-30"
"71573","2024","COM","2022","191","3","194","2024-12-30"
"71574","2024","COM","2022","855","15","870","2024-12-30"
"71576","2024","COM","2022","285","6","291","2024-12-30"
"71577","2024","COM","2022","218","6","224","2024-12-30"
"71578","2024","COM","2022","301","11","312","2024-12-30"
"71579","2024","COM","2022","174","2","176","2024-12-30"
"71580","2024","COM","2022","450","15","465","2024-12-30"
"71581","2024","COM","2022","246","6","252","2024-12-30"
"71582","2024","COM","2022","653","19","672","2024-12-30"
"71583","2024","COM","2022","762","25","787","2024-12-30"
"71584","2024","COM","2022","1218","32","1250","2024-12-30"
"71585","2024","COM","2022","1393","73","1466","2024-12-30"
"71586","2024","COM","2022","260","5","265","2024-12-30"
"71588","2024","COM","2022","1082","38","1120","2024-12-30"
"71589","2024","COM","2022","423","8","431","2024-12-30"
"71590","2024","COM","2022","661","24","685","2024-12-30"
"71591","2024","COM","2022","495","9","504","2024-12-30"
"72001","2024","COM","2022","1681","30","1711","2024-12-30"
"72002","2024","COM","2022","199","5","204","2024-12-30"
"72003","2024","COM","2022","10740","124","10864","2024-12-30"
"72004","2024","COM","2022","569","8","577","2024-12-30"
"72005","2024","COM","2022","917","25","942","2024-12-30"
"72006","2024","COM","2022","1897","244","2141","2024-12-30"
"72007","2024","COM","2022","499","13","512","2024-12-30"
"72008","2024","COM","2022","5463","114","5577","2024-12-30"
"72009","2024","COM","2022","351","8","359","2024-12-30"
"72010","2024","COM","2022","337","9","346","2024-12-30"
"72011","2024","COM","2022","898","19","917","2024-12-30"
"72012","2024","COM","2022","478","10","488","2024-12-30"
"72013","2024","COM","2022","2131","20","2151","2024-12-30"
"72015","2024","COM","2022","107","0","107","2024-12-30"
"72016","2024","COM","2022","1458","21","1479","2024-12-30"
"72017","2024","COM","2022","229","5","234","2024-12-30"
"72018","2024","COM","2022","88","0","88","2024-12-30"
"72019","2024","COM","2022","335","8","343","2024-12-30"
"72020","2024","COM","2022","692","18","710","2024-12-30"
"72021","2024","COM","2022","572","8","580","2024-12-30"
"72022","2024","COM","2022","1217","28","1245","2024-12-30"
"72023","2024","COM","2022","2270","28","2298","2024-12-30"
"72024","2024","COM","2022","3748","83","3831","2024-12-30"
"72025","2024","COM","2022","1946","48","1994","2024-12-30"
"72026","2024","COM","2022","1523","16","1539","2024-12-30"
"72027","2024","COM","2022","329","4","333","2024-12-30"
"72028","2024","COM","2022","476","8","484","2024-12-30"
"72029","2024","COM","2022","1974","29","2003","2024-12-30"
"72031","2024","COM","2022","543","3","546","2024-12-30"
"72032","2024","COM","2022","334","7","341","2024-12-30"
"72034","2024","COM","2022","434","10","444","2024-12-30"
"72035","2024","COM","2022","2025","50","2075","2024-12-30"
"72036","2024","COM","2022","306","4","310","2024-12-30"
"72037","2024","COM","2022","129","1","130","2024-12-30"
"72038","2024","COM","2022","534","2","536","2024-12-30"
"72039","2024","COM","2022","3721","57","3778","2024-12-30"
"72040","2024","COM","2022","153","2","155","2024-12-30"
"72041","2024","COM","2022","352","6","358","2024-12-30"
"72042","2024","COM","2022","2121","32","2153","2024-12-30"
"72043","2024","COM","2022","335","8","343","2024-12-30"
"72044","2024","COM","2022","431","5","436","2024-12-30"
"72045","2024","COM","2022","781","11","792","2024-12-30"
"72046","2024","COM","2022","1562","32","1594","2024-12-30"
"72047","2024","COM","2022","2127","142","2269","2024-12-30"
"72048","2024","COM","2022","537","9","546","2024-12-30"
"72049","2024","COM","2022","250","1","251","2024-12-30"
"72050","2024","COM","2022","1525","30","1555","2024-12-30"
"72051","2024","COM","2022","3365","48","3413","2024-12-30"
"72052","2024","COM","2022","668","10","678","2024-12-30"
"72053","2024","COM","2022","1161","23","1184","2024-12-30"
"72054","2024","COM","2022","3680","63","3743","2024-12-30"
"72056","2024","COM","2022","1303","27","1330","2024-12-30"
"72057","2024","COM","2022","68","3","71","2024-12-30"
"72058","2024","COM","2022","6803","167","6970","2024-12-30"
"72059","2024","COM","2022","816","18","834","2024-12-30"
"72060","2024","COM","2022","282","2","284","2024-12-30"
"72061","2024","COM","2022","1725","26","1751","2024-12-30"
"72062","2024","COM","2022","779","17","796","2024-12-30"
"72064","2024","COM","2022","517","12","529","2024-12-30"
"72065","2024","COM","2022","2252","67","2319","2024-12-30"
"72066","2024","COM","2022","421","9","430","2024-12-30"
"72067","2024","COM","2022","998","6","1004","2024-12-30"
"72068","2024","COM","2022","1370","20","1390","2024-12-30"
"72070","2024","COM","2022","250","7","257","2024-12-30"
"72071","2024","COM","2022","5707","199","5906","2024-12-30"
"72072","2024","COM","2022","255","5","260","2024-12-30"
"72073","2024","COM","2022","1164","24","1188","2024-12-30"
"72074","2024","COM","2022","213","9","222","2024-12-30"
"72075","2024","COM","2022","996","19","1015","2024-12-30"
"72076","2024","COM","2022","259","2","261","2024-12-30"
"72077","2024","COM","2022","436","8","444","2024-12-30"
"72078","2024","COM","2022","353","4","357","2024-12-30"
"72079","2024","COM","2022","308","3","311","2024-12-30"
"72080","2024","COM","2022","2746","64","2810","2024-12-30"
"72083","2024","COM","2022","357","11","368","2024-12-30"
"72084","2024","COM","2022","1276","33","1309","2024-12-30"
"72085","2024","COM","2022","177","4","181","2024-12-30"
"72086","2024","COM","2022","138","5","143","2024-12-30"
"72087","2024","COM","2022","460","13","473","2024-12-30"
"72088","2024","COM","2022","320","11","331","2024-12-30"
"72089","2024","COM","2022","1828","32","1860","2024-12-30"
"72090","2024","COM","2022","2838","43","2881","2024-12-30"
"72091","2024","COM","2022","135","4","139","2024-12-30"
"72093","2024","COM","2022","886","18","904","2024-12-30"
"72094","2024","COM","2022","638","11","649","2024-12-30"
"72095","2024","COM","2022","8049","119","8168","2024-12-30"
"72096","2024","COM","2022","1619","74","1693","2024-12-30"
"72098","2024","COM","2022","512","15","527","2024-12-30"
"72099","2024","COM","2022","641","5","646","2024-12-30"
"72100","2024","COM","2022","403","7","410","2024-12-30"
"72101","2024","COM","2022","670","12","682","2024-12-30"
"72102","2024","COM","2022","83","2","85","2024-12-30"
"72103","2024","COM","2022","614","9","623","2024-12-30"
"72104","2024","COM","2022","585","15","600","2024-12-30"
"72105","2024","COM","2022","460","10","470","2024-12-30"
"72106","2024","COM","2022","910","24","934","2024-12-30"
"72107","2024","COM","2022","341","7","348","2024-12-30"
"72109","2024","COM","2022","544","6","550","2024-12-30"
"72110","2024","COM","2022","993","21","1014","2024-12-30"
"72111","2024","COM","2022","490","19","509","2024-12-30"
"72112","2024","COM","2022","482","5","487","2024-12-30"
"72113","2024","COM","2022","746","13","759","2024-12-30"
"72114","2024","COM","2022","250","3","253","2024-12-30"
"72115","2024","COM","2022","942","13","955","2024-12-30"
"72118","2024","COM","2022","1433","20","1453","2024-12-30"
"72119","2024","COM","2022","1062","17","1079","2024-12-30"
"72120","2024","COM","2022","225","4","229","2024-12-30"
"72121","2024","COM","2022","318","5","323","2024-12-30"
"72122","2024","COM","2022","1076","19","1095","2024-12-30"
"72123","2024","COM","2022","61","1","62","2024-12-30"
"72124","2024","COM","2022","4818","82","4900","2024-12-30"
"72125","2024","COM","2022","304","10","314","2024-12-30"
"72126","2024","COM","2022","290","6","296","2024-12-30"
"72127","2024","COM","2022","1852","36","1888","2024-12-30"
"72128","2024","COM","2022","526","8","534","2024-12-30"
"72129","2024","COM","2022","905","9","914","2024-12-30"
"72130","2024","COM","2022","736","19","755","2024-12-30"
"72131","2024","COM","2022","577","12","589","2024-12-30"
"72132","2024","COM","2022","8769","272","9041","2024-12-30"
"72133","2024","COM","2022","1543","28","1571","2024-12-30"
"72134","2024","COM","2022","525","11","536","2024-12-30"
"72135","2024","COM","2022","600","6","606","2024-12-30"
"72136","2024","COM","2022","309","9","318","2024-12-30"
"72137","2024","COM","2022","2189","39","2228","2024-12-30"
"72138","2024","COM","2022","2909","44","2953","2024-12-30"
"72139","2024","COM","2022","995","45","1040","2024-12-30"
"72141","2024","COM","2022","889","35","924","2024-12-30"
"72142","2024","COM","2022","141","5","146","2024-12-30"
"72143","2024","COM","2022","1941","21","1962","2024-12-30"
"72144","2024","COM","2022","339","2","341","2024-12-30"
"72145","2024","COM","2022","384","5","389","2024-12-30"
"72146","2024","COM","2022","3200","40","3240","2024-12-30"
"72147","2024","COM","2022","1285","26","1311","2024-12-30"
"72148","2024","COM","2022","80","2","82","2024-12-30"
"72149","2024","COM","2022","597","10","607","2024-12-30"
"72150","2024","COM","2022","1275","23","1298","2024-12-30"
"72151","2024","COM","2022","1142","30","1172","2024-12-30"
"72152","2024","COM","2022","412","10","422","2024-12-30"
"72153","2024","COM","2022","552","15","567","2024-12-30"
"72154","2024","COM","2022","15081","1034","16115","2024-12-30"
"72155","2024","COM","2022","2269","41","2310","2024-12-30"
"72156","2024","COM","2022","920","23","943","2024-12-30"
"72157","2024","COM","2022","695","13","708","2024-12-30"
"72158","2024","COM","2022","817","12","829","2024-12-30"
"72160","2024","COM","2022","585","12","597","2024-12-30"
"72161","2024","COM","2022","938","12","950","2024-12-30"
"72163","2024","COM","2022","484","8","492","2024-12-30"
"72164","2024","COM","2022","65","3","68","2024-12-30"
"72165","2024","COM","2022","1937","24","1961","2024-12-30"
"72166","2024","COM","2022","295","3","298","2024-12-30"
"72167","2024","COM","2022","703","17","720","2024-12-30"
"72168","2024","COM","2022","2100","35","2135","2024-12-30"
"72169","2024","COM","2022","1496","33","1529","2024-12-30"
"72170","2024","COM","2022","175","5","180","2024-12-30"
"72171","2024","COM","2022","104","3","107","2024-12-30"
"72172","2024","COM","2022","1454","20","1474","2024-12-30"
"72173","2024","COM","2022","1233","26","1259","2024-12-30"
"72174","2024","COM","2022","105","2","107","2024-12-30"
"72175","2024","COM","2022","1524","28","1552","2024-12-30"
"72176","2024","COM","2022","4016","57","4073","2024-12-30"
"72177","2024","COM","2022","336","2","338","2024-12-30"
"72178","2024","COM","2022","197","3","200","2024-12-30"
"72179","2024","COM","2022","1881","35","1916","2024-12-30"
"72180","2024","COM","2022","5080","159","5239","2024-12-30"
"72181","2024","COM","2022","145182","2664","147846","2024-12-30"
"72182","2024","COM","2022","1550","22","1572","2024-12-30"
"72183","2024","COM","2022","1063","24","1087","2024-12-30"
"72184","2024","COM","2022","346","6","352","2024-12-30"
"72185","2024","COM","2022","658","4","662","2024-12-30"
"72186","2024","COM","2022","879","20","899","2024-12-30"
"72187","2024","COM","2022","1618","34","1652","2024-12-30"
"72188","2024","COM","2022","159","3","162","2024-12-30"
"72189","2024","COM","2022","2038","26","2064","2024-12-30"
"72190","2024","COM","2022","287","10","297","2024-12-30"
"72191","2024","COM","2022","3186","49","3235","2024-12-30"
"72192","2024","COM","2022","105","3","108","2024-12-30"
"72193","2024","COM","2022","446","13","459","2024-12-30"
"72194","2024","COM","2022","272","2","274","2024-12-30"
"72195","2024","COM","2022","1853","31","1884","2024-12-30"
"72196","2024","COM","2022","735","6","741","2024-12-30"
"72197","2024","COM","2022","679","11","690","2024-12-30"
"72198","2024","COM","2022","2631","35","2666","2024-12-30"
"72199","2024","COM","2022","266","4","270","2024-12-30"
"72200","2024","COM","2022","3699","63","3762","2024-12-30"
"72201","2024","COM","2022","234","4","238","2024-12-30"
"72202","2024","COM","2022","207","8","215","2024-12-30"
"72204","2024","COM","2022","517","8","525","2024-12-30"
"72205","2024","COM","2022","1833","30","1863","2024-12-30"
"72208","2024","COM","2022","369","2","371","2024-12-30"
"72209","2024","COM","2022","313","6","319","2024-12-30"
"72210","2024","COM","2022","299","5","304","2024-12-30"
"72211","2024","COM","2022","633","9","642","2024-12-30"
"72212","2024","COM","2022","697","11","708","2024-12-30"
"72213","2024","COM","2022","5299","73","5372","2024-12-30"
"72214","2024","COM","2022","12","0","12","2024-12-30"
"72215","2024","COM","2022","1023","18","1041","2024-12-30"
"72216","2024","COM","2022","593","16","609","2024-12-30"
"72217","2024","COM","2022","2463","48","2511","2024-12-30"
"72218","2024","COM","2022","302","5","307","2024-12-30"
"72219","2024","COM","2022","768","86","854","2024-12-30"
"72220","2024","COM","2022","876","25","901","2024-12-30"
"72221","2024","COM","2022","361","5","366","2024-12-30"
"72222","2024","COM","2022","255","0","255","2024-12-30"
"72223","2024","COM","2022","2585","51","2636","2024-12-30"
"72224","2024","COM","2022","529","3","532","2024-12-30"
"72225","2024","COM","2022","671","8","679","2024-12-30"
"72226","2024","COM","2022","1325","19","1344","2024-12-30"
"72227","2024","COM","2022","33","0","33","2024-12-30"
"72228","2024","COM","2022","1998","57","2055","2024-12-30"
"72229","2024","COM","2022","449","8","457","2024-12-30"
"72230","2024","COM","2022","1038","21","1059","2024-12-30"
"72231","2024","COM","2022","5367","99","5466","2024-12-30"
"72232","2024","COM","2022","707","14","721","2024-12-30"
"72233","2024","COM","2022","71","0","71","2024-12-30"
"72234","2024","COM","2022","346","5","351","2024-12-30"
"72235","2024","COM","2022","373","6","379","2024-12-30"
"72236","2024","COM","2022","191","8","199","2024-12-30"
"72237","2024","COM","2022","505","12","517","2024-12-30"
"72238","2024","COM","2022","74","1","75","2024-12-30"
"72239","2024","COM","2022","597","21","618","2024-12-30"
"72241","2024","COM","2022","2928","36","2964","2024-12-30"
"72243","2024","COM","2022","1614","23","1637","2024-12-30"
"72244","2024","COM","2022","2900","101","3001","2024-12-30"
"72245","2024","COM","2022","669","14","683","2024-12-30"
"72246","2024","COM","2022","193","7","200","2024-12-30"
"72247","2024","COM","2022","1333","30","1363","2024-12-30"
"72248","2024","COM","2022","808","12","820","2024-12-30"
"72249","2024","COM","2022","805","13","818","2024-12-30"
"72250","2024","COM","2022","160","5","165","2024-12-30"
"72251","2024","COM","2022","390","5","395","2024-12-30"
"72252","2024","COM","2022","1108","12","1120","2024-12-30"
"72253","2024","COM","2022","2546","66","2612","2024-12-30"
"72254","2024","COM","2022","263","6","269","2024-12-30"
"72255","2024","COM","2022","791","16","807","2024-12-30"
"72256","2024","COM","2022","808","15","823","2024-12-30"
"72257","2024","COM","2022","2352","289","2641","2024-12-30"
"72259","2024","COM","2022","270","3","273","2024-12-30"
"72260","2024","COM","2022","3492","65","3557","2024-12-30"
"72261","2024","COM","2022","301","8","309","2024-12-30"
"72262","2024","COM","2022","2052","75","2127","2024-12-30"
"72264","2024","COM","2022","12194","487","12681","2024-12-30"
"72265","2024","COM","2022","246","1","247","2024-12-30"
"72266","2024","COM","2022","764","23","787","2024-12-30"
"72267","2024","COM","2022","916","22","938","2024-12-30"
"72268","2024","COM","2022","709","10","719","2024-12-30"
"72269","2024","COM","2022","2969","201","3170","2024-12-30"
"72270","2024","COM","2022","185","1","186","2024-12-30"
"72271","2024","COM","2022","881","7","888","2024-12-30"
"72272","2024","COM","2022","326","9","335","2024-12-30"
"72273","2024","COM","2022","231","4","235","2024-12-30"
"72274","2024","COM","2022","214","7","221","2024-12-30"
"72275","2024","COM","2022","1517","22","1539","2024-12-30"
"72276","2024","COM","2022","1884","43","1927","2024-12-30"
"72277","2024","COM","2022","113","1","114","2024-12-30"
"72278","2024","COM","2022","750","11","761","2024-12-30"
"72279","2024","COM","2022","171","2","173","2024-12-30"
"72280","2024","COM","2022","2228","25","2253","2024-12-30"
"72281","2024","COM","2022","450","7","457","2024-12-30"
"72282","2024","COM","2022","519","8","527","2024-12-30"
"72283","2024","COM","2022","346","6","352","2024-12-30"
"72286","2024","COM","2022","392","7","399","2024-12-30"
"72287","2024","COM","2022","1991","47","2038","2024-12-30"
"72289","2024","COM","2022","1964","32","1996","2024-12-30"
"72290","2024","COM","2022","1810","35","1845","2024-12-30"
"72291","2024","COM","2022","955","17","972","2024-12-30"
"72292","2024","COM","2022","225","5","230","2024-12-30"
"72293","2024","COM","2022","612","11","623","2024-12-30"
"72294","2024","COM","2022","474","15","489","2024-12-30"
"72295","2024","COM","2022","511","6","517","2024-12-30"
"72296","2024","COM","2022","741","25","766","2024-12-30"
"72297","2024","COM","2022","536","12","548","2024-12-30"
"72298","2024","COM","2022","555","13","568","2024-12-30"
"72299","2024","COM","2022","2471","36","2507","2024-12-30"
"72300","2024","COM","2022","2712","35","2747","2024-12-30"
"72302","2024","COM","2022","172","4","176","2024-12-30"
"72303","2024","COM","2022","740","9","749","2024-12-30"
"72305","2024","COM","2022","914","26","940","2024-12-30"
"72306","2024","COM","2022","1325","26","1351","2024-12-30"
"72307","2024","COM","2022","238","6","244","2024-12-30"
"72308","2024","COM","2022","2090","249","2339","2024-12-30"
"72309","2024","COM","2022","276","7","283","2024-12-30"
"72310","2024","COM","2022","2002","49","2051","2024-12-30"
"72311","2024","COM","2022","339","7","346","2024-12-30"
"72312","2024","COM","2022","225","5","230","2024-12-30"
"72313","2024","COM","2022","212","5","217","2024-12-30"
"72314","2024","COM","2022","363","8","371","2024-12-30"
"72315","2024","COM","2022","832","14","846","2024-12-30"
"72316","2024","COM","2022","705","13","718","2024-12-30"
"72317","2024","COM","2022","498","13","511","2024-12-30"
"72319","2024","COM","2022","729","17","746","2024-12-30"
"72320","2024","COM","2022","2773","86","2859","2024-12-30"
"72321","2024","COM","2022","499","10","509","2024-12-30"
"72322","2024","COM","2022","223","2","225","2024-12-30"
"72323","2024","COM","2022","438","7","445","2024-12-30"
"72324","2024","COM","2022","503","14","517","2024-12-30"
"72325","2024","COM","2022","822","18","840","2024-12-30"
"72326","2024","COM","2022","218","3","221","2024-12-30"
"72327","2024","COM","2022","268","9","277","2024-12-30"
"72328","2024","COM","2022","3865","96","3961","2024-12-30"
"72329","2024","COM","2022","4042","78","4120","2024-12-30"
"72330","2024","COM","2022","447","9","456","2024-12-30"
"72331","2024","COM","2022","584","10","594","2024-12-30"
"72332","2024","COM","2022","599","10","609","2024-12-30"
"72333","2024","COM","2022","432","11","443","2024-12-30"
"72334","2024","COM","2022","2192","85","2277","2024-12-30"
"72335","2024","COM","2022","1080","20","1100","2024-12-30"
"72336","2024","COM","2022","1229","40","1269","2024-12-30"
"72337","2024","COM","2022","832","26","858","2024-12-30"
"72338","2024","COM","2022","822","11","833","2024-12-30"
"72339","2024","COM","2022","646","11","657","2024-12-30"
"72340","2024","COM","2022","1237","20","1257","2024-12-30"
"72341","2024","COM","2022","604","15","619","2024-12-30"
"72342","2024","COM","2022","160","6","166","2024-12-30"
"72343","2024","COM","2022","606","13","619","2024-12-30"
"72344","2024","COM","2022","2821","49","2870","2024-12-30"
"72345","2024","COM","2022","339","6","345","2024-12-30"
"72346","2024","COM","2022","4628","64","4692","2024-12-30"
"72347","2024","COM","2022","289","9","298","2024-12-30"
"72348","2024","COM","2022","132","3","135","2024-12-30"
"72349","2024","COM","2022","521","3","524","2024-12-30"
"72350","2024","COM","2022","3043","63","3106","2024-12-30"
"72351","2024","COM","2022","1017","18","1035","2024-12-30"
"72352","2024","COM","2022","143","0","143","2024-12-30"
"72353","2024","COM","2022","215","7","222","2024-12-30"
"72354","2024","COM","2022","165","1","166","2024-12-30"
"72355","2024","COM","2022","119","1","120","2024-12-30"
"72356","2024","COM","2022","398","7","405","2024-12-30"
"72357","2024","COM","2022","741","5","746","2024-12-30"
"72358","2024","COM","2022","1653","37","1690","2024-12-30"
"72359","2024","COM","2022","1412","31","1443","2024-12-30"
"72360","2024","COM","2022","1639","42","1681","2024-12-30"
"72361","2024","COM","2022","510","10","520","2024-12-30"
"72362","2024","COM","2022","169","3","172","2024-12-30"
"72363","2024","COM","2022","1669","15","1684","2024-12-30"
"72364","2024","COM","2022","1383","29","1412","2024-12-30"
"72366","2024","COM","2022","304","2","306","2024-12-30"
"72367","2024","COM","2022","778","11","789","2024-12-30"
"72368","2024","COM","2022","287","3","290","2024-12-30"
"72369","2024","COM","2022","586","54","640","2024-12-30"
"72370","2024","COM","2022","339","4","343","2024-12-30"
"72372","2024","COM","2022","77","0","77","2024-12-30"
"72373","2024","COM","2022","2508","40","2548","2024-12-30"
"72374","2024","COM","2022","137","1","138","2024-12-30"
"72375","2024","COM","2022","517","12","529","2024-12-30"
"72376","2024","COM","2022","651","27","678","2024-12-30"
"72377","2024","COM","2022","1035","15","1050","2024-12-30"
"72378","2024","COM","2022","1383","28","1411","2024-12-30"
"72379","2024","COM","2022","203","7","210","2024-12-30"
"72380","2024","COM","2022","899","12","911","2024-12-30"
"72381","2024","COM","2022","1350","20","1370","2024-12-30"
"72382","2024","COM","2022","971","19","990","2024-12-30"
"72383","2024","COM","2022","131","4","135","2024-12-30"
"72385","2024","COM","2022","1734","21","1755","2024-12-30"
"72386","2024","COM","2022","4187","97","4284","2024-12-30"
"73001","2024","COM","2022","247","5","252","2024-12-30"
"73003","2024","COM","2022","3794","106","3900","2024-12-30"
"73004","2024","COM","2022","429","9","438","2024-12-30"
"73005","2024","COM","2022","218","6","224","2024-12-30"
"73006","2024","COM","2022","4409","110","4519","2024-12-30"
"73007","2024","COM","2022","1811","25","1836","2024-12-30"
"73008","2024","COM","2022","32175","522","32697","2024-12-30"
"73010","2024","COM","2022","6465","140","6605","2024-12-30"
"73011","2024","COM","2022","19706","540","20246","2024-12-30"
"73012","2024","COM","2022","141","6","147","2024-12-30"
"73013","2024","COM","2022","366","10","376","2024-12-30"
"73014","2024","COM","2022","295","9","304","2024-12-30"
"73015","2024","COM","2022","1750","47","1797","2024-12-30"
"73017","2024","COM","2022","968","21","989","2024-12-30"
"73018","2024","COM","2022","816","9","825","2024-12-30"
"73019","2024","COM","2022","952","21","973","2024-12-30"
"73020","2024","COM","2022","439","11","450","2024-12-30"
"73021","2024","COM","2022","849","20","869","2024-12-30"
"73022","2024","COM","2022","572","10","582","2024-12-30"
"73023","2024","COM","2022","682","18","700","2024-12-30"
"73024","2024","COM","2022","739","11","750","2024-12-30"
"73025","2024","COM","2022","534","13","547","2024-12-30"
"73026","2024","COM","2022","394","16","410","2024-12-30"
"73027","2024","COM","2022","390","3","393","2024-12-30"
"73028","2024","COM","2022","356","3","359","2024-12-30"
"73029","2024","COM","2022","5246","119","5365","2024-12-30"
"73030","2024","COM","2022","3545","64","3609","2024-12-30"
"73031","2024","COM","2022","5118","128","5246","2024-12-30"
"73032","2024","COM","2022","2168","39","2207","2024-12-30"
"73033","2024","COM","2022","541","14","555","2024-12-30"
"73034","2024","COM","2022","1994","89","2083","2024-12-30"
"73036","2024","COM","2022","760","25","785","2024-12-30"
"73039","2024","COM","2022","512","12","524","2024-12-30"
"73040","2024","COM","2022","352","9","361","2024-12-30"
"73041","2024","COM","2022","304","12","316","2024-12-30"
"73042","2024","COM","2022","262","5","267","2024-12-30"
"73043","2024","COM","2022","2922","50","2972","2024-12-30"
"73047","2024","COM","2022","270","5","275","2024-12-30"
"73048","2024","COM","2022","352","14","366","2024-12-30"
"73049","2024","COM","2022","144","1","145","2024-12-30"
"73050","2024","COM","2022","579","19","598","2024-12-30"
"73051","2024","COM","2022","5077","91","5168","2024-12-30"
"73052","2024","COM","2022","143","5","148","2024-12-30"
"73053","2024","COM","2022","667","10","677","2024-12-30"
"73054","2024","COM","2022","7228","287","7515","2024-12-30"
"73055","2024","COM","2022","2024","54","2078","2024-12-30"
"73057","2024","COM","2022","457","14","471","2024-12-30"
"73058","2024","COM","2022","1206","19","1225","2024-12-30"
"73059","2024","COM","2022","2443","75","2518","2024-12-30"
"73061","2024","COM","2022","431","15","446","2024-12-30"
"73063","2024","COM","2022","707","11","718","2024-12-30"
"73064","2024","COM","2022","5626","221","5847","2024-12-30"
"73065","2024","COM","2022","60251","1557","61808","2024-12-30"
"73067","2024","COM","2022","1191","19","1210","2024-12-30"
"73068","2024","COM","2022","615","15","630","2024-12-30"
"73069","2024","COM","2022","961","21","982","2024-12-30"
"73070","2024","COM","2022","671","6","677","2024-12-30"
"73071","2024","COM","2022","545","18","563","2024-12-30"
"73072","2024","COM","2022","31","0","31","2024-12-30"
"73073","2024","COM","2022","551","7","558","2024-12-30"
"73074","2024","COM","2022","327","11","338","2024-12-30"
"73075","2024","COM","2022","591","25","616","2024-12-30"
"73076","2024","COM","2022","267","6","273","2024-12-30"
"73077","2024","COM","2022","566","18","584","2024-12-30"
"73078","2024","COM","2022","146","2","148","2024-12-30"
"73079","2024","COM","2022","922","27","949","2024-12-30"
"73081","2024","COM","2022","662","43","705","2024-12-30"
"73082","2024","COM","2022","725","27","752","2024-12-30"
"73083","2024","COM","2022","216","4","220","2024-12-30"
"73084","2024","COM","2022","910","15","925","2024-12-30"
"73085","2024","COM","2022","1488","23","1511","2024-12-30"
"73086","2024","COM","2022","374","9","383","2024-12-30"
"73087","2024","COM","2022","6729","173","6902","2024-12-30"
"73088","2024","COM","2022","140","3","143","2024-12-30"
"73089","2024","COM","2022","1306","27","1333","2024-12-30"
"73090","2024","COM","2022","266","7","273","2024-12-30"
"73091","2024","COM","2022","216","4","220","2024-12-30"
"73092","2024","COM","2022","155","3","158","2024-12-30"
"73094","2024","COM","2022","338","8","346","2024-12-30"
"73095","2024","COM","2022","382","9","391","2024-12-30"
"73096","2024","COM","2022","1042","20","1062","2024-12-30"
"73097","2024","COM","2022","693","14","707","2024-12-30"
"73098","2024","COM","2022","826","17","843","2024-12-30"
"73099","2024","COM","2022","431","14","445","2024-12-30"
"73100","2024","COM","2022","1999","46","2045","2024-12-30"
"73101","2024","COM","2022","95","2","97","2024-12-30"
"73103","2024","COM","2022","3016","69","3085","2024-12-30"
"73104","2024","COM","2022","493","11","504","2024-12-30"
"73105","2024","COM","2022","1270","19","1289","2024-12-30"
"73106","2024","COM","2022","307","5","312","2024-12-30"
"73107","2024","COM","2022","646","17","663","2024-12-30"
"73109","2024","COM","2022","762","16","778","2024-12-30"
"73110","2024","COM","2022","758","7","765","2024-12-30"
"73113","2024","COM","2022","174","8","182","2024-12-30"
"73114","2024","COM","2022","798","18","816","2024-12-30"
"73116","2024","COM","2022","482","12","494","2024-12-30"
"73117","2024","COM","2022","701","7","708","2024-12-30"
"73119","2024","COM","2022","107","4","111","2024-12-30"
"73120","2024","COM","2022","632","11","643","2024-12-30"
"73121","2024","COM","2022","1917","46","1963","2024-12-30"
"73122","2024","COM","2022","445","11","456","2024-12-30"
"73123","2024","COM","2022","379","8","387","2024-12-30"
"73124","2024","COM","2022","3109","65","3174","2024-12-30"
"73128","2024","COM","2022","4633","102","4735","2024-12-30"
"73129","2024","COM","2022","1197","42","1239","2024-12-30"
"73130","2024","COM","2022","2104","40","2144","2024-12-30"
"73131","2024","COM","2022","298","9","307","2024-12-30"
"73132","2024","COM","2022","741","23","764","2024-12-30"
"73133","2024","COM","2022","350","14","364","2024-12-30"
"73135","2024","COM","2022","1091","19","1110","2024-12-30"
"73137","2024","COM","2022","4340","62","4402","2024-12-30"
"73138","2024","COM","2022","502","12","514","2024-12-30"
"73139","2024","COM","2022","255","4","259","2024-12-30"
"73140","2024","COM","2022","284","10","294","2024-12-30"
"73141","2024","COM","2022","752","12","764","2024-12-30"
"73142","2024","COM","2022","810","17","827","2024-12-30"
"73145","2024","COM","2022","466","13","479","2024-12-30"
"73146","2024","COM","2022","798","17","815","2024-12-30"
"73147","2024","COM","2022","224","2","226","2024-12-30"
"73149","2024","COM","2022","290","5","295","2024-12-30"
"73150","2024","COM","2022","3825","131","3956","2024-12-30"
"73151","2024","COM","2022","3944","71","4015","2024-12-30"
"73152","2024","COM","2022","237","8","245","2024-12-30"
"73153","2024","COM","2022","1342","36","1378","2024-12-30"
"73154","2024","COM","2022","3471","89","3560","2024-12-30"
"73155","2024","COM","2022","2143","29","2172","2024-12-30"
"73156","2024","COM","2022","337","6","343","2024-12-30"
"73157","2024","COM","2022","2879","140","3019","2024-12-30"
"73159","2024","COM","2022","870","9","879","2024-12-30"
"73160","2024","COM","2022","1000","28","1028","2024-12-30"
"73161","2024","COM","2022","659","14","673","2024-12-30"
"73162","2024","COM","2022","664","24","688","2024-12-30"
"73164","2024","COM","2022","1090","39","1129","2024-12-30"
"73166","2024","COM","2022","50","2","52","2024-12-30"
"73168","2024","COM","2022","115","2","117","2024-12-30"
"73170","2024","COM","2022","520","10","530","2024-12-30"
"73171","2024","COM","2022","4041","72","4113","2024-12-30"
"73173","2024","COM","2022","477","10","487","2024-12-30"
"73175","2024","COM","2022","83","2","85","2024-12-30"
"73176","2024","COM","2022","729","9","738","2024-12-30"
"73177","2024","COM","2022","237","6","243","2024-12-30"
"73178","2024","COM","2022","514","12","526","2024-12-30"
"73179","2024","COM","2022","12167","668","12835","2024-12-30"
"73180","2024","COM","2022","467","12","479","2024-12-30"
"73181","2024","COM","2022","3482","402","3884","2024-12-30"
"73182","2024","COM","2022","2291","56","2347","2024-12-30"
"73183","2024","COM","2022","1294","35","1329","2024-12-30"
"73184","2024","COM","2022","534","12","546","2024-12-30"
"73186","2024","COM","2022","468","13","481","2024-12-30"
"73187","2024","COM","2022","2536","47","2583","2024-12-30"
"73188","2024","COM","2022","1000","28","1028","2024-12-30"
"73189","2024","COM","2022","221","7","228","2024-12-30"
"73190","2024","COM","2022","256","5","261","2024-12-30"
"73191","2024","COM","2022","2243","68","2311","2024-12-30"
"73192","2024","COM","2022","220","3","223","2024-12-30"
"73193","2024","COM","2022","92","2","94","2024-12-30"
"73194","2024","COM","2022","321","9","330","2024-12-30"
"73196","2024","COM","2022","792","16","808","2024-12-30"
"73197","2024","COM","2022","633","7","640","2024-12-30"
"73200","2024","COM","2022","558","8","566","2024-12-30"
"73201","2024","COM","2022","441","8","449","2024-12-30"
"73202","2024","COM","2022","462","11","473","2024-12-30"
"73204","2024","COM","2022","2106","31","2137","2024-12-30"
"73205","2024","COM","2022","133","1","134","2024-12-30"
"73206","2024","COM","2022","700","23","723","2024-12-30"
"73207","2024","COM","2022","434","12","446","2024-12-30"
"73208","2024","COM","2022","1060","28","1088","2024-12-30"
"73210","2024","COM","2022","375","6","381","2024-12-30"
"73211","2024","COM","2022","901","25","926","2024-12-30"
"73212","2024","COM","2022","2009","24","2033","2024-12-30"
"73213","2024","COM","2022","9154","554","9708","2024-12-30"
"73214","2024","COM","2022","250","8","258","2024-12-30"
"73215","2024","COM","2022","4185","65","4250","2024-12-30"
"73216","2024","COM","2022","487","6","493","2024-12-30"
"73217","2024","COM","2022","375","11","386","2024-12-30"
"73218","2024","COM","2022","808","16","824","2024-12-30"
"73219","2024","COM","2022","685","11","696","2024-12-30"
"73220","2024","COM","2022","387","4","391","2024-12-30"
"73221","2024","COM","2022","88","3","91","2024-12-30"
"73222","2024","COM","2022","6589","228","6817","2024-12-30"
"73223","2024","COM","2022","447","10","457","2024-12-30"
"73224","2024","COM","2022","895","21","916","2024-12-30"
"73225","2024","COM","2022","2827","51","2878","2024-12-30"
"73226","2024","COM","2022","1720","24","1744","2024-12-30"
"73227","2024","COM","2022","2295","76","2371","2024-12-30"
"73228","2024","COM","2022","1009","14","1023","2024-12-30"
"73229","2024","COM","2022","538","11","549","2024-12-30"
"73230","2024","COM","2022","138","2","140","2024-12-30"
"73231","2024","COM","2022","1193","24","1217","2024-12-30"
"73232","2024","COM","2022","690","22","712","2024-12-30"
"73233","2024","COM","2022","155","3","158","2024-12-30"
"73234","2024","COM","2022","176","4","180","2024-12-30"
"73235","2024","COM","2022","487","10","497","2024-12-30"
"73236","2024","COM","2022","3028","56","3084","2024-12-30"
"73237","2024","COM","2022","409","4","413","2024-12-30"
"73240","2024","COM","2022","835","15","850","2024-12-30"
"73241","2024","COM","2022","1227","24","1251","2024-12-30"
"73242","2024","COM","2022","271","10","281","2024-12-30"
"73243","2024","COM","2022","1704","59","1763","2024-12-30"
"73245","2024","COM","2022","837","16","853","2024-12-30"
"73246","2024","COM","2022","303","5","308","2024-12-30"
"73247","2024","COM","2022","977","58","1035","2024-12-30"
"73248","2024","COM","2022","7524","332","7856","2024-12-30"
"73249","2024","COM","2022","1965","47","2012","2024-12-30"
"73250","2024","COM","2022","1510","36","1546","2024-12-30"
"73252","2024","COM","2022","256","3","259","2024-12-30"
"73253","2024","COM","2022","615","5","620","2024-12-30"
"73254","2024","COM","2022","128","4","132","2024-12-30"
"73255","2024","COM","2022","840","17","857","2024-12-30"
"73256","2024","COM","2022","302","8","310","2024-12-30"
"73257","2024","COM","2022","3488","77","3565","2024-12-30"
"73258","2024","COM","2022","692","19","711","2024-12-30"
"73259","2024","COM","2022","530","13","543","2024-12-30"
"73261","2024","COM","2022","2432","243","2675","2024-12-30"
"73262","2024","COM","2022","490","34","524","2024-12-30"
"73263","2024","COM","2022","1163","33","1196","2024-12-30"
"73265","2024","COM","2022","760","21","781","2024-12-30"
"73267","2024","COM","2022","305","10","315","2024-12-30"
"73268","2024","COM","2022","533","59","592","2024-12-30"
"73269","2024","COM","2022","750","16","766","2024-12-30"
"73270","2024","COM","2022","4175","108","4283","2024-12-30"
"73271","2024","COM","2022","309","10","319","2024-12-30"
"73272","2024","COM","2022","176","4","180","2024-12-30"
"73273","2024","COM","2022","488","4","492","2024-12-30"
"73274","2024","COM","2022","404","13","417","2024-12-30"
"73275","2024","COM","2022","327","10","337","2024-12-30"
"73276","2024","COM","2022","423","19","442","2024-12-30"
"73277","2024","COM","2022","170","7","177","2024-12-30"
"73278","2024","COM","2022","1263","29","1292","2024-12-30"
"73280","2024","COM","2022","347","8","355","2024-12-30"
"73281","2024","COM","2022","820","21","841","2024-12-30"
"73282","2024","COM","2022","1097","19","1116","2024-12-30"
"73283","2024","COM","2022","761","20","781","2024-12-30"
"73284","2024","COM","2022","959","23","982","2024-12-30"
"73285","2024","COM","2022","2460","50","2510","2024-12-30"
"73286","2024","COM","2022","1161","20","1181","2024-12-30"
"73288","2024","COM","2022","2106","48","2154","2024-12-30"
"73289","2024","COM","2022","432","9","441","2024-12-30"
"73290","2024","COM","2022","2092","36","2128","2024-12-30"
"73292","2024","COM","2022","318","8","326","2024-12-30"
"73293","2024","COM","2022","454","7","461","2024-12-30"
"73294","2024","COM","2022","348","3","351","2024-12-30"
"73296","2024","COM","2022","1953","137","2090","2024-12-30"
"73297","2024","COM","2022","577","23","600","2024-12-30"
"73298","2024","COM","2022","905","10","915","2024-12-30"
"73299","2024","COM","2022","336","6","342","2024-12-30"
"73300","2024","COM","2022","2927","102","3029","2024-12-30"
"73301","2024","COM","2022","861","17","878","2024-12-30"
"73302","2024","COM","2022","380","6","386","2024-12-30"
"73303","2024","COM","2022","7162","211","7373","2024-12-30"
"73304","2024","COM","2022","1572","47","1619","2024-12-30"
"73306","2024","COM","2022","1074","27","1101","2024-12-30"
"73307","2024","COM","2022","578","3","581","2024-12-30"
"73308","2024","COM","2022","607","19","626","2024-12-30"
"73309","2024","COM","2022","339","7","346","2024-12-30"
"73310","2024","COM","2022","586","6","592","2024-12-30"
"73311","2024","COM","2022","89","5","94","2024-12-30"
"73312","2024","COM","2022","958","36","994","2024-12-30"
"73313","2024","COM","2022","240","9","249","2024-12-30"
"73314","2024","COM","2022","264","5","269","2024-12-30"
"73315","2024","COM","2022","436","13","449","2024-12-30"
"73316","2024","COM","2022","297","5","302","2024-12-30"
"73317","2024","COM","2022","683","26","709","2024-12-30"
"73318","2024","COM","2022","245","9","254","2024-12-30"
"73320","2024","COM","2022","804","21","825","2024-12-30"
"73322","2024","COM","2022","511","15","526","2024-12-30"
"73323","2024","COM","2022","359","5","364","2024-12-30"
"73324","2024","COM","2022","191","9","200","2024-12-30"
"73326","2024","COM","2022","2304","47","2351","2024-12-30"
"73327","2024","COM","2022","426","3","429","2024-12-30"
"73328","2024","COM","2022","2282","57","2339","2024-12-30"
"73329","2024","COM","2022","1998","31","2029","2024-12-30"
"73330","2024","COM","2022","3045","29","3074","2024-12-30"
"74001","2024","COM","2022","1536","152","1688","2024-12-30"
"74002","2024","COM","2022","2643","58","2701","2024-12-30"
"74003","2024","COM","2022","1125","40","1165","2024-12-30"
"74004","2024","COM","2022","404","7","411","2024-12-30"
"74005","2024","COM","2022","4938","115","5053","2024-12-30"
"74006","2024","COM","2022","2170","37","2207","2024-12-30"
"74007","2024","COM","2022","2786","65","2851","2024-12-30"
"74008","2024","COM","2022","6269","68","6337","2024-12-30"
"74009","2024","COM","2022","1011","19","1030","2024-12-30"
"74010","2024","COM","2022","131272","2859","134131","2024-12-30"
"74012","2024","COM","2022","37595","391","37986","2024-12-30"
"74013","2024","COM","2022","2370","97","2467","2024-12-30"
"74014","2024","COM","2022","1777","54","1831","2024-12-30"
"74015","2024","COM","2022","1136","25","1161","2024-12-30"
"74016","2024","COM","2022","2458","40","2498","2024-12-30"
"74018","2024","COM","2022","1998","35","2033","2024-12-30"
"74019","2024","COM","2022","3713","234","3947","2024-12-30"
"74020","2024","COM","2022","1501","45","1546","2024-12-30"
"74021","2024","COM","2022","1670","31","1701","2024-12-30"
"74024","2024","COM","2022","2325","47","2372","2024-12-30"
"74025","2024","COM","2022","1475","27","1502","2024-12-30"
"74026","2024","COM","2022","5215","154","5369","2024-12-30"
"74027","2024","COM","2022","457","11","468","2024-12-30"
"74029","2024","COM","2022","398","16","414","2024-12-30"
"74030","2024","COM","2022","322","6","328","2024-12-30"
"74031","2024","COM","2022","3081","58","3139","2024-12-30"
"74032","2024","COM","2022","1392","32","1424","2024-12-30"
"74033","2024","COM","2022","1450","23","1473","2024-12-30"
"74034","2024","COM","2022","636","6","642","2024-12-30"
"74035","2024","COM","2022","565","23","588","2024-12-30"
"74036","2024","COM","2022","398","13","411","2024-12-30"
"74037","2024","COM","2022","1938","45","1983","2024-12-30"
"74038","2024","COM","2022","1160","30","1190","2024-12-30"
"74040","2024","COM","2022","3268","124","3392","2024-12-30"
"74041","2024","COM","2022","282","3","285","2024-12-30"
"74042","2024","COM","2022","13320","416","13736","2024-12-30"
"74043","2024","COM","2022","6120","97","6217","2024-12-30"
"74044","2024","COM","2022","947","9","956","2024-12-30"
"74045","2024","COM","2022","249","6","255","2024-12-30"
"74046","2024","COM","2022","511","17","528","2024-12-30"
"74048","2024","COM","2022","1116","19","1135","2024-12-30"
"74049","2024","COM","2022","465","8","473","2024-12-30"
"74050","2024","COM","2022","688","16","704","2024-12-30"
"74051","2024","COM","2022","729","14","743","2024-12-30"
"74052","2024","COM","2022","1163","21","1184","2024-12-30"
"74053","2024","COM","2022","1259","31","1290","2024-12-30"
"74054","2024","COM","2022","708","22","730","2024-12-30"
"74055","2024","COM","2022","589","13","602","2024-12-30"
"74056","2024","COM","2022","8673","325","8998","2024-12-30"
"74057","2024","COM","2022","1181","23","1204","2024-12-30"
"74058","2024","COM","2022","873","15","888","2024-12-30"
"74059","2024","COM","2022","251","10","261","2024-12-30"
"74060","2024","COM","2022","118","2","120","2024-12-30"
"74061","2024","COM","2022","982","18","1000","2024-12-30"
"74062","2024","COM","2022","1545","30","1575","2024-12-30"
"74063","2024","COM","2022","1168","28","1196","2024-12-30"
"74064","2024","COM","2022","1215","39","1254","2024-12-30"
"74065","2024","COM","2022","541","12","553","2024-12-30"
"74066","2024","COM","2022","240","1","241","2024-12-30"
"74067","2024","COM","2022","3024","87","3111","2024-12-30"
"74068","2024","COM","2022","526","14","540","2024-12-30"
"74069","2024","COM","2022","790","14","804","2024-12-30"
"74070","2024","COM","2022","3005","40","3045","2024-12-30"
"74071","2024","COM","2022","241","6","247","2024-12-30"
"74072","2024","COM","2022","182","4","186","2024-12-30"
"74073","2024","COM","2022","701","12","713","2024-12-30"
"74074","2024","COM","2022","717","8","725","2024-12-30"
"74075","2024","COM","2022","1646","28","1674","2024-12-30"
"74076","2024","COM","2022","1704","44","1748","2024-12-30"
"74077","2024","COM","2022","1053","24","1077","2024-12-30"
"74078","2024","COM","2022","449","9","458","2024-12-30"
"74079","2024","COM","2022","704","14","718","2024-12-30"
"74080","2024","COM","2022","1663","34","1697","2024-12-30"
"74081","2024","COM","2022","17366","347","17713","2024-12-30"
"74082","2024","COM","2022","3876","116","3992","2024-12-30"
"74083","2024","COM","2022","2094","106","2200","2024-12-30"
"74085","2024","COM","2022","1083","48","1131","2024-12-30"
"74086","2024","COM","2022","737","14","751","2024-12-30"
"74087","2024","COM","2022","2374","124","2498","2024-12-30"
"74088","2024","COM","2022","1287","24","1311","2024-12-30"
"74089","2024","COM","2022","984","29","1013","2024-12-30"
"74090","2024","COM","2022","1468","20","1488","2024-12-30"
"74091","2024","COM","2022","355","2","357","2024-12-30"
"74094","2024","COM","2022","7476","142","7618","2024-12-30"
"74095","2024","COM","2022","325","11","336","2024-12-30"
"74096","2024","COM","2022","5058","290","5348","2024-12-30"
"74097","2024","COM","2022","1855","52","1907","2024-12-30"
"74098","2024","COM","2022","1638","35","1673","2024-12-30"
"74099","2024","COM","2022","803","39","842","2024-12-30"
"74100","2024","COM","2022","759","26","785","2024-12-30"
"74101","2024","COM","2022","787","14","801","2024-12-30"
"74102","2024","COM","2022","1459","47","1506","2024-12-30"
"74103","2024","COM","2022","2203","54","2257","2024-12-30"
"74104","2024","COM","2022","3688","93","3781","2024-12-30"
"74105","2024","COM","2022","6788","93","6881","2024-12-30"
"74106","2024","COM","2022","875","34","909","2024-12-30"
"74107","2024","COM","2022","153","4","157","2024-12-30"
"74108","2024","COM","2022","1069","26","1095","2024-12-30"
"74109","2024","COM","2022","935","20","955","2024-12-30"
"74111","2024","COM","2022","197","5","202","2024-12-30"
"74112","2024","COM","2022","8642","213","8855","2024-12-30"
"74114","2024","COM","2022","520","6","526","2024-12-30"
"74116","2024","COM","2022","2109","49","2158","2024-12-30"
"74117","2024","COM","2022","976","20","996","2024-12-30"
"74118","2024","COM","2022","2624","30","2654","2024-12-30"
"74119","2024","COM","2022","9224","257","9481","2024-12-30"
"74121","2024","COM","2022","1326","18","1344","2024-12-30"
"74122","2024","COM","2022","655","21","676","2024-12-30"
"74123","2024","COM","2022","7540","219","7759","2024-12-30"
"74124","2024","COM","2022","1842","44","1886","2024-12-30"
"74126","2024","COM","2022","1071","33","1104","2024-12-30"
"74127","2024","COM","2022","1520","36","1556","2024-12-30"
"74128","2024","COM","2022","3550","76","3626","2024-12-30"
"74129","2024","COM","2022","225","3","228","2024-12-30"
"74130","2024","COM","2022","549","31","580","2024-12-30"
"74131","2024","COM","2022","2136","41","2177","2024-12-30"
"74133","2024","COM","2022","11054","107","11161","2024-12-30"
"74134","2024","COM","2022","1227","28","1255","2024-12-30"
"74135","2024","COM","2022","569","12","581","2024-12-30"
"74136","2024","COM","2022","2054","53","2107","2024-12-30"
"74137","2024","COM","2022","4044","181","4225","2024-12-30"
"74138","2024","COM","2022","1497","63","1560","2024-12-30"
"74139","2024","COM","2022","1091","31","1122","2024-12-30"
"74140","2024","COM","2022","1484","40","1524","2024-12-30"
"74141","2024","COM","2022","1074","26","1100","2024-12-30"
"74142","2024","COM","2022","973","33","1006","2024-12-30"
"74143","2024","COM","2022","3529","88","3617","2024-12-30"
"74144","2024","COM","2022","889","17","906","2024-12-30"
"74145","2024","COM","2022","634","15","649","2024-12-30"
"74146","2024","COM","2022","1589","39","1628","2024-12-30"
"74147","2024","COM","2022","1076","27","1103","2024-12-30"
"74148","2024","COM","2022","309","2","311","2024-12-30"
"74150","2024","COM","2022","1728","29","1757","2024-12-30"
"74151","2024","COM","2022","585","9","594","2024-12-30"
"74152","2024","COM","2022","1297","43","1340","2024-12-30"
"74153","2024","COM","2022","1709","43","1752","2024-12-30"
"74154","2024","COM","2022","2536","53","2589","2024-12-30"
"74155","2024","COM","2022","799","26","825","2024-12-30"
"74156","2024","COM","2022","736","13","749","2024-12-30"
"74157","2024","COM","2022","1766","64","1830","2024-12-30"
"74158","2024","COM","2022","1139","17","1156","2024-12-30"
"74159","2024","COM","2022","3242","68","3310","2024-12-30"
"74160","2024","COM","2022","1006","28","1034","2024-12-30"
"74161","2024","COM","2022","1985","60","2045","2024-12-30"
"74162","2024","COM","2022","1072","23","1095","2024-12-30"
"74163","2024","COM","2022","2261","74","2335","2024-12-30"
"74164","2024","COM","2022","6432","180","6612","2024-12-30"
"74165","2024","COM","2022","701","15","716","2024-12-30"
"74166","2024","COM","2022","1921","41","1962","2024-12-30"
"74167","2024","COM","2022","1401","24","1425","2024-12-30"
"74168","2024","COM","2022","1052","13","1065","2024-12-30"
"74169","2024","COM","2022","5920","102","6022","2024-12-30"
"74170","2024","COM","2022","858","23","881","2024-12-30"
"74171","2024","COM","2022","1693","34","1727","2024-12-30"
"74172","2024","COM","2022","1519","39","1558","2024-12-30"
"74173","2024","COM","2022","2927","110","3037","2024-12-30"
"74174","2024","COM","2022","606","20","626","2024-12-30"
"74175","2024","COM","2022","301","5","306","2024-12-30"
"74176","2024","COM","2022","1889","74","1963","2024-12-30"
"74177","2024","COM","2022","1109","24","1133","2024-12-30"
"74178","2024","COM","2022","785","16","801","2024-12-30"
"74179","2024","COM","2022","802","25","827","2024-12-30"
"74180","2024","COM","2022","2373","59","2432","2024-12-30"
"74183","2024","COM","2022","2521","66","2587","2024-12-30"
"74184","2024","COM","2022","1058","12","1070","2024-12-30"
"74185","2024","COM","2022","2333","47","2380","2024-12-30"
"74186","2024","COM","2022","812","20","832","2024-12-30"
"74188","2024","COM","2022","956","24","980","2024-12-30"
"74189","2024","COM","2022","1637","47","1684","2024-12-30"
"74190","2024","COM","2022","694","14","708","2024-12-30"
"74191","2024","COM","2022","2661","50","2711","2024-12-30"
"74192","2024","COM","2022","963","34","997","2024-12-30"
"74193","2024","COM","2022","1055","23","1078","2024-12-30"
"74194","2024","COM","2022","882","22","904","2024-12-30"
"74195","2024","COM","2022","421","6","427","2024-12-30"
"74196","2024","COM","2022","466","11","477","2024-12-30"
"74197","2024","COM","2022","1708","23","1731","2024-12-30"
"74198","2024","COM","2022","1001","23","1024","2024-12-30"
"74199","2024","COM","2022","424","12","436","2024-12-30"
"74200","2024","COM","2022","3224","79","3303","2024-12-30"
"74201","2024","COM","2022","2227","23","2250","2024-12-30"
"74202","2024","COM","2022","735","11","746","2024-12-30"
"74203","2024","COM","2022","53","2","55","2024-12-30"
"74205","2024","COM","2022","1281","42","1323","2024-12-30"
"74206","2024","COM","2022","1073","16","1089","2024-12-30"
"74208","2024","COM","2022","10852","410","11262","2024-12-30"
"74209","2024","COM","2022","1363","39","1402","2024-12-30"
"74210","2024","COM","2022","1882","41","1923","2024-12-30"
"74211","2024","COM","2022","3207","88","3295","2024-12-30"
"74212","2024","COM","2022","1825","38","1863","2024-12-30"
"74213","2024","COM","2022","9032","366","9398","2024-12-30"
"74215","2024","COM","2022","1289","27","1316","2024-12-30"
"74216","2024","COM","2022","1082","15","1097","2024-12-30"
"74218","2024","COM","2022","7793","182","7975","2024-12-30"
"74219","2024","COM","2022","1252","36","1288","2024-12-30"
"74220","2024","COM","2022","8112","201","8313","2024-12-30"
"74221","2024","COM","2022","559","16","575","2024-12-30"
"74222","2024","COM","2022","498","9","507","2024-12-30"
"74223","2024","COM","2022","490","8","498","2024-12-30"
"74224","2024","COM","2022","11239","392","11631","2024-12-30"
"74225","2024","COM","2022","16082","468","16550","2024-12-30"
"74226","2024","COM","2022","594","11","605","2024-12-30"
"74228","2024","COM","2022","378","13","391","2024-12-30"
"74229","2024","COM","2022","3779","66","3845","2024-12-30"
"74231","2024","COM","2022","643","15","658","2024-12-30"
"74232","2024","COM","2022","486","21","507","2024-12-30"
"74233","2024","COM","2022","2438","44","2482","2024-12-30"
"74234","2024","COM","2022","882","14","896","2024-12-30"
"74235","2024","COM","2022","644","10","654","2024-12-30"
"74236","2024","COM","2022","5678","130","5808","2024-12-30"
"74237","2024","COM","2022","907","4","911","2024-12-30"
"74238","2024","COM","2022","1543","18","1561","2024-12-30"
"74239","2024","COM","2022","1500","38","1538","2024-12-30"
"74240","2024","COM","2022","1157","25","1182","2024-12-30"
"74241","2024","COM","2022","3423","103","3526","2024-12-30"
"74242","2024","COM","2022","6344","213","6557","2024-12-30"
"74243","2024","COM","2022","15925","194","16119","2024-12-30"
"74244","2024","COM","2022","836","34","870","2024-12-30"
"74249","2024","COM","2022","2598","63","2661","2024-12-30"
"74250","2024","COM","2022","7848","137","7985","2024-12-30"
"74252","2024","COM","2022","649","22","671","2024-12-30"
"74253","2024","COM","2022","994","39","1033","2024-12-30"
"74254","2024","COM","2022","598","10","608","2024-12-30"
"74255","2024","COM","2022","2267","40","2307","2024-12-30"
"74256","2024","COM","2022","17041","474","17515","2024-12-30"
"74257","2024","COM","2022","847","19","866","2024-12-30"
"74258","2024","COM","2022","2193","50","2243","2024-12-30"
"74259","2024","COM","2022","463","8","471","2024-12-30"
"74260","2024","COM","2022","1029","22","1051","2024-12-30"
"74261","2024","COM","2022","509","13","522","2024-12-30"
"74262","2024","COM","2022","1216","16","1232","2024-12-30"
"74263","2024","COM","2022","6317","142","6459","2024-12-30"
"74264","2024","COM","2022","9074","136","9210","2024-12-30"
"74265","2024","COM","2022","745","66","811","2024-12-30"
"74266","2024","COM","2022","1125","29","1154","2024-12-30"
"74267","2024","COM","2022","4324","188","4512","2024-12-30"
"74269","2024","COM","2022","2327","97","2424","2024-12-30"
"74271","2024","COM","2022","535","13","548","2024-12-30"
"74272","2024","COM","2022","5652","128","5780","2024-12-30"
"74273","2024","COM","2022","728","15","743","2024-12-30"
"74275","2024","COM","2022","1913","66","1979","2024-12-30"
"74276","2024","COM","2022","3501","96","3597","2024-12-30"
"74278","2024","COM","2022","6344","114","6458","2024-12-30"
"74279","2024","COM","2022","808","24","832","2024-12-30"
"74280","2024","COM","2022","6654","274","6928","2024-12-30"
"74281","2024","COM","2022","37689","1003","38692","2024-12-30"
"74282","2024","COM","2022","9812","241","10053","2024-12-30"
"74283","2024","COM","2022","1166","19","1185","2024-12-30"
"74284","2024","COM","2022","1353","26","1379","2024-12-30"
"74285","2024","COM","2022","424","9","433","2024-12-30"
"74286","2024","COM","2022","912","19","931","2024-12-30"
"74287","2024","COM","2022","907","18","925","2024-12-30"
"74288","2024","COM","2022","5090","64","5154","2024-12-30"
"74289","2024","COM","2022","2739","50","2789","2024-12-30"
"74290","2024","COM","2022","432","8","440","2024-12-30"
"74291","2024","COM","2022","350","6","356","2024-12-30"
"74292","2024","COM","2022","1080","31","1111","2024-12-30"
"74293","2024","COM","2022","4035","45","4080","2024-12-30"
"74294","2024","COM","2022","794","22","816","2024-12-30"
"74295","2024","COM","2022","288","7","295","2024-12-30"
"74296","2024","COM","2022","962","18","980","2024-12-30"
"74297","2024","COM","2022","678","21","699","2024-12-30"
"74298","2024","COM","2022","10412","206","10618","2024-12-30"
"74299","2024","COM","2022","2308","73","2381","2024-12-30"
"74301","2024","COM","2022","960","23","983","2024-12-30"
"74302","2024","COM","2022","1121","22","1143","2024-12-30"
"74303","2024","COM","2022","3473","136","3609","2024-12-30"
"74304","2024","COM","2022","918","18","936","2024-12-30"
"74305","2024","COM","2022","9196","125","9321","2024-12-30"
"74306","2024","COM","2022","637","18","655","2024-12-30"
"74307","2024","COM","2022","1009","16","1025","2024-12-30"
"74308","2024","COM","2022","883","22","905","2024-12-30"
"74309","2024","COM","2022","5625","81","5706","2024-12-30"
"74310","2024","COM","2022","1302","32","1334","2024-12-30"
"74311","2024","COM","2022","4668","109","4777","2024-12-30"
"74312","2024","COM","2022","1622","28","1650","2024-12-30"
"74313","2024","COM","2022","556","7","563","2024-12-30"
"74314","2024","COM","2022","1698","55","1753","2024-12-30"
"74315","2024","COM","2022","1052","23","1075","2024-12-30"
"75101","2024","ARM","2022","15475","93","15568","2024-12-30"
"75102","2024","ARM","2022","20433","133","20566","2024-12-30"
"75103","2024","ARM","2022","32772","220","32992","2024-12-30"
"75104","2024","ARM","2022","28039","254","28293","2024-12-30"
"75105","2024","ARM","2022","55925","653","56578","2024-12-30"
"75106","2024","ARM","2022","40432","777","41209","2024-12-30"
"75107","2024","ARM","2022","48196","702","48898","2024-12-30"
"75108","2024","ARM","2022","35418","518","35936","2024-12-30"
"75109","2024","ARM","2022","58419","604","59023","2024-12-30"
"75110","2024","ARM","2022","81926","422","82348","2024-12-30"
"75111","2024","ARM","2022","139983","776","140759","2024-12-30"
"75112","2024","ARM","2022","139788","913","140701","2024-12-30"
"75113","2024","ARM","2022","177735","1074","178809","2024-12-30"
"75114","2024","ARM","2022","137581","937","138518","2024-12-30"
"75115","2024","ARM","2022","228754","1636","230390","2024-12-30"
"75116","2024","ARM","2022","159733","2091","161824","2024-12-30"
"75117","2024","ARM","2022","161206","1276","162482","2024-12-30"
"75118","2024","ARM","2022","185825","716","186541","2024-12-30"
"75119","2024","ARM","2022","178371","876","179247","2024-12-30"
"75120","2024","ARM","2022","187694","881","188575","2024-12-30"
"76001","2024","COM","2022","1147","19","1166","2024-12-30"
"76002","2024","COM","2022","595","11","606","2024-12-30"
"76004","2024","COM","2022","504","10","514","2024-12-30"
"76005","2024","COM","2022","3280","48","3328","2024-12-30"
"76006","2024","COM","2022","190","4","194","2024-12-30"
"76007","2024","COM","2022","693","10","703","2024-12-30"
"76008","2024","COM","2022","627","11","638","2024-12-30"
"76009","2024","COM","2022","353","3","356","2024-12-30"
"76010","2024","COM","2022","374","4","378","2024-12-30"
"76011","2024","COM","2022","149","4","153","2024-12-30"
"76012","2024","COM","2022","184","3","187","2024-12-30"
"76013","2024","COM","2022","1081","28","1109","2024-12-30"
"76014","2024","COM","2022","1398","14","1412","2024-12-30"
"76015","2024","COM","2022","518","9","527","2024-12-30"
"76016","2024","COM","2022","126","2","128","2024-12-30"
"76017","2024","COM","2022","674","6","680","2024-12-30"
"76018","2024","COM","2022","1468","34","1502","2024-12-30"
"76019","2024","COM","2022","411","12","423","2024-12-30"
"76020","2024","COM","2022","1161","14","1175","2024-12-30"
"76021","2024","COM","2022","449","3","452","2024-12-30"
"76022","2024","COM","2022","329","7","336","2024-12-30"
"76023","2024","COM","2022","298","6","304","2024-12-30"
"76024","2024","COM","2022","154","4","158","2024-12-30"
"76025","2024","COM","2022","348","1","349","2024-12-30"
"76026","2024","COM","2022","2433","44","2477","2024-12-30"
"76028","2024","COM","2022","177","1","178","2024-12-30"
"76029","2024","COM","2022","201","3","204","2024-12-30"
"76030","2024","COM","2022","524","3","527","2024-12-30"
"76032","2024","COM","2022","138","2","140","2024-12-30"
"76033","2024","COM","2022","451","9","460","2024-12-30"
"76034","2024","COM","2022","2533","25","2558","2024-12-30"
"76035","2024","COM","2022","1985","46","2031","2024-12-30"
"76036","2024","COM","2022","688","19","707","2024-12-30"
"76038","2024","COM","2022","405","6","411","2024-12-30"
"76039","2024","COM","2022","1210","23","1233","2024-12-30"
"76040","2024","COM","2022","320","5","325","2024-12-30"
"76041","2024","COM","2022","1342","18","1360","2024-12-30"
"76042","2024","COM","2022","103","3","106","2024-12-30"
"76043","2024","COM","2022","1120","391","1511","2024-12-30"
"76045","2024","COM","2022","360","5","365","2024-12-30"
"76046","2024","COM","2022","681","13","694","2024-12-30"
"76047","2024","COM","2022","146","0","146","2024-12-30"
"76048","2024","COM","2022","284","6","290","2024-12-30"
"76049","2024","COM","2022","264","8","272","2024-12-30"
"76050","2024","COM","2022","1000","27","1027","2024-12-30"
"76051","2024","COM","2022","1897","34","1931","2024-12-30"
"76052","2024","COM","2022","221","1","222","2024-12-30"
"76053","2024","COM","2022","116","2","118","2024-12-30"
"76054","2024","COM","2022","514","10","524","2024-12-30"
"76055","2024","COM","2022","336","9","345","2024-12-30"
"76056","2024","COM","2022","602","10","612","2024-12-30"
"76057","2024","COM","2022","12227","238","12465","2024-12-30"
"76058","2024","COM","2022","212","5","217","2024-12-30"
"76059","2024","COM","2022","410","7","417","2024-12-30"
"76060","2024","COM","2022","462","10","472","2024-12-30"
"76062","2024","COM","2022","259","3","262","2024-12-30"
"76063","2024","COM","2022","464","10","474","2024-12-30"
"76064","2024","COM","2022","492","13","505","2024-12-30"
"76065","2024","COM","2022","411","9","420","2024-12-30"
"76066","2024","COM","2022","155","2","157","2024-12-30"
"76067","2024","COM","2022","630","8","638","2024-12-30"
"76068","2024","COM","2022","676","13","689","2024-12-30"
"76069","2024","COM","2022","2257","49","2306","2024-12-30"
"76070","2024","COM","2022","577","12","589","2024-12-30"
"76071","2024","COM","2022","471","14","485","2024-12-30"
"76072","2024","COM","2022","746","14","760","2024-12-30"
"76074","2024","COM","2022","50","0","50","2024-12-30"
"76075","2024","COM","2022","446","13","459","2024-12-30"
"76076","2024","COM","2022","262","3","265","2024-12-30"
"76077","2024","COM","2022","162","5","167","2024-12-30"
"76079","2024","COM","2022","168","2","170","2024-12-30"
"76082","2024","COM","2022","638","11","649","2024-12-30"
"76083","2024","COM","2022","101","1","102","2024-12-30"
"76084","2024","COM","2022","121","2","123","2024-12-30"
"76085","2024","COM","2022","339","9","348","2024-12-30"
"76086","2024","COM","2022","218","1","219","2024-12-30"
"76087","2024","COM","2022","709","10","719","2024-12-30"
"76088","2024","COM","2022","542","11","553","2024-12-30"
"76090","2024","COM","2022","1216","20","1236","2024-12-30"
"76091","2024","COM","2022","236","7","243","2024-12-30"
"76092","2024","COM","2022","612","5","617","2024-12-30"
"76093","2024","COM","2022","362","13","375","2024-12-30"
"76094","2024","COM","2022","320","5","325","2024-12-30"
"76095","2024","COM","2022","8299","160","8459","2024-12-30"
"76096","2024","COM","2022","658","10","668","2024-12-30"
"76097","2024","COM","2022","104","2","106","2024-12-30"
"76099","2024","COM","2022","683","9","692","2024-12-30"
"76100","2024","COM","2022","1227","19","1246","2024-12-30"
"76101","2024","COM","2022","2844","28","2872","2024-12-30"
"76103","2024","COM","2022","6444","90","6534","2024-12-30"
"76104","2024","COM","2022","257","4","261","2024-12-30"
"76105","2024","COM","2022","655","7","662","2024-12-30"
"76106","2024","COM","2022","576","7","583","2024-12-30"
"76107","2024","COM","2022","290","4","294","2024-12-30"
"76108","2024","COM","2022","14497","324","14821","2024-12-30"
"76109","2024","COM","2022","168","4","172","2024-12-30"
"76110","2024","COM","2022","447","7","454","2024-12-30"
"76111","2024","COM","2022","616","10","626","2024-12-30"
"76112","2024","COM","2022","385","11","396","2024-12-30"
"76113","2024","COM","2022","426","8","434","2024-12-30"
"76114","2024","COM","2022","11618","169","11787","2024-12-30"
"76115","2024","COM","2022","590","10","600","2024-12-30"
"76116","2024","COM","2022","3975","46","4021","2024-12-30"
"76117","2024","COM","2022","650","20","670","2024-12-30"
"76118","2024","COM","2022","243","8","251","2024-12-30"
"76119","2024","COM","2022","198","2","200","2024-12-30"
"76120","2024","COM","2022","453","9","462","2024-12-30"
"76121","2024","COM","2022","371","3","374","2024-12-30"
"76122","2024","COM","2022","501","8","509","2024-12-30"
"76123","2024","COM","2022","1085","17","1102","2024-12-30"
"76124","2024","COM","2022","420","6","426","2024-12-30"
"76125","2024","COM","2022","1589","18","1607","2024-12-30"
"76126","2024","COM","2022","329","5","334","2024-12-30"
"76128","2024","COM","2022","585","7","592","2024-12-30"
"76129","2024","COM","2022","220","4","224","2024-12-30"
"76130","2024","COM","2022","264","4","268","2024-12-30"
"76131","2024","COM","2022","710","11","721","2024-12-30"
"76132","2024","COM","2022","476","3","479","2024-12-30"
"76133","2024","COM","2022","426","7","433","2024-12-30"
"76134","2024","COM","2022","278","4","282","2024-12-30"
"76135","2024","COM","2022","1029","13","1042","2024-12-30"
"76136","2024","COM","2022","676","12","688","2024-12-30"
"76138","2024","COM","2022","333","8","341","2024-12-30"
"76139","2024","COM","2022","222","3","225","2024-12-30"
"76140","2024","COM","2022","198","2","200","2024-12-30"
"76141","2024","COM","2022","1363","13","1376","2024-12-30"
"76142","2024","COM","2022","430","147","577","2024-12-30"
"76143","2024","COM","2022","1373","24","1397","2024-12-30"
"76144","2024","COM","2022","164","2","166","2024-12-30"
"76146","2024","COM","2022","2789","105","2894","2024-12-30"
"76147","2024","COM","2022","868","22","890","2024-12-30"
"76148","2024","COM","2022","315","5","320","2024-12-30"
"76149","2024","COM","2022","281","5","286","2024-12-30"
"76151","2024","COM","2022","247","7","254","2024-12-30"
"76152","2024","COM","2022","736","4","740","2024-12-30"
"76153","2024","COM","2022","329","4","333","2024-12-30"
"76154","2024","COM","2022","443","7","450","2024-12-30"
"76155","2024","COM","2022","380","13","393","2024-12-30"
"76156","2024","COM","2022","344","8","352","2024-12-30"
"76157","2024","COM","2022","14420","362","14782","2024-12-30"
"76158","2024","COM","2022","307","1","308","2024-12-30"
"76159","2024","COM","2022","2898","46","2944","2024-12-30"
"76160","2024","COM","2022","419","10","429","2024-12-30"
"76161","2024","COM","2022","103","4","107","2024-12-30"
"76162","2024","COM","2022","268","4","272","2024-12-30"
"76163","2024","COM","2022","697","14","711","2024-12-30"
"76164","2024","COM","2022","4044","65","4109","2024-12-30"
"76165","2024","COM","2022","10414","65","10479","2024-12-30"
"76166","2024","COM","2022","479","4","483","2024-12-30"
"76167","2024","COM","2022","1679","30","1709","2024-12-30"
"76168","2024","COM","2022","66","1","67","2024-12-30"
"76169","2024","COM","2022","1297","113","1410","2024-12-30"
"76170","2024","COM","2022","109","1","110","2024-12-30"
"76171","2024","COM","2022","143","1","144","2024-12-30"
"76172","2024","COM","2022","162","3","165","2024-12-30"
"76173","2024","COM","2022","553","15","568","2024-12-30"
"76174","2024","COM","2022","423","1","424","2024-12-30"
"76175","2024","COM","2022","263","7","270","2024-12-30"
"76176","2024","COM","2022","348","6","354","2024-12-30"
"76177","2024","COM","2022","259","6","265","2024-12-30"
"76178","2024","COM","2022","4863","36","4899","2024-12-30"
"76179","2024","COM","2022","1380","17","1397","2024-12-30"
"76180","2024","COM","2022","188","2","190","2024-12-30"
"76181","2024","COM","2022","139","3","142","2024-12-30"
"76182","2024","COM","2022","247","2","249","2024-12-30"
"76183","2024","COM","2022","766","20","786","2024-12-30"
"76184","2024","COM","2022","107","3","110","2024-12-30"
"76185","2024","COM","2022","166","4","170","2024-12-30"
"76186","2024","COM","2022","504","3","507","2024-12-30"
"76187","2024","COM","2022","167","3","170","2024-12-30"
"76188","2024","COM","2022","474","4","478","2024-12-30"
"76189","2024","COM","2022","189","4","193","2024-12-30"
"76190","2024","COM","2022","207","3","210","2024-12-30"
"76192","2024","COM","2022","2592","54","2646","2024-12-30"
"76193","2024","COM","2022","367","3","370","2024-12-30"
"76194","2024","COM","2022","404","6","410","2024-12-30"
"76195","2024","COM","2022","195","4","199","2024-12-30"
"76196","2024","COM","2022","2578","84","2662","2024-12-30"
"76197","2024","COM","2022","219","2","221","2024-12-30"
"76198","2024","COM","2022","803","19","822","2024-12-30"
"76199","2024","COM","2022","714","10","724","2024-12-30"
"76200","2024","COM","2022","528","11","539","2024-12-30"
"76201","2024","COM","2022","517","4","521","2024-12-30"
"76202","2024","COM","2022","337","3","340","2024-12-30"
"76203","2024","COM","2022","713","8","721","2024-12-30"
"76204","2024","COM","2022","251","2","253","2024-12-30"
"76205","2024","COM","2022","233","3","236","2024-12-30"
"76206","2024","COM","2022","341","8","349","2024-12-30"
"76207","2024","COM","2022","193","6","199","2024-12-30"
"76208","2024","COM","2022","631","9","640","2024-12-30"
"76209","2024","COM","2022","448","9","457","2024-12-30"
"76210","2024","COM","2022","447","10","457","2024-12-30"
"76211","2024","COM","2022","234","2","236","2024-12-30"
"76212","2024","COM","2022","9652","75","9727","2024-12-30"
"76213","2024","COM","2022","396","8","404","2024-12-30"
"76214","2024","COM","2022","283","2","285","2024-12-30"
"76216","2024","COM","2022","10690","81","10771","2024-12-30"
"76217","2024","COM","2022","28599","468","29067","2024-12-30"
"76218","2024","COM","2022","110","2","112","2024-12-30"
"76219","2024","COM","2022","2440","53","2493","2024-12-30"
"76220","2024","COM","2022","511","10","521","2024-12-30"
"76221","2024","COM","2022","192","5","197","2024-12-30"
"76222","2024","COM","2022","4017","52","4069","2024-12-30"
"76223","2024","COM","2022","547","7","554","2024-12-30"
"76224","2024","COM","2022","985","20","1005","2024-12-30"
"76225","2024","COM","2022","352","5","357","2024-12-30"
"76226","2024","COM","2022","147","2","149","2024-12-30"
"76227","2024","COM","2022","706","10","716","2024-12-30"
"76228","2024","COM","2022","398","4","402","2024-12-30"
"76229","2024","COM","2022","393","9","402","2024-12-30"
"76230","2024","COM","2022","446","11","457","2024-12-30"
"76231","2024","COM","2022","15774","135","15909","2024-12-30"
"76232","2024","COM","2022","630","8","638","2024-12-30"
"76233","2024","COM","2022","156","4","160","2024-12-30"
"76234","2024","COM","2022","768","12","780","2024-12-30"
"76235","2024","COM","2022","1973","136","2109","2024-12-30"
"76236","2024","COM","2022","361","8","369","2024-12-30"
"76237","2024","COM","2022","516","8","524","2024-12-30"
"76238","2024","COM","2022","2624","38","2662","2024-12-30"
"76239","2024","COM","2022","783","14","797","2024-12-30"
"76240","2024","COM","2022","1068","30","1098","2024-12-30"
"76241","2024","COM","2022","128","7","135","2024-12-30"
"76242","2024","COM","2022","210","4","214","2024-12-30"
"76243","2024","COM","2022","293","2","295","2024-12-30"
"76244","2024","COM","2022","397","8","405","2024-12-30"
"76245","2024","COM","2022","1630","19","1649","2024-12-30"
"76247","2024","COM","2022","538","3","541","2024-12-30"
"76249","2024","COM","2022","861","8","869","2024-12-30"
"76250","2024","COM","2022","1209","14","1223","2024-12-30"
"76251","2024","COM","2022","428","4","432","2024-12-30"
"76252","2024","COM","2022","1071","30","1101","2024-12-30"
"76253","2024","COM","2022","837","16","853","2024-12-30"
"76254","2024","COM","2022","1167","12","1179","2024-12-30"
"76255","2024","COM","2022","6541","205","6746","2024-12-30"
"76257","2024","COM","2022","180","8","188","2024-12-30"
"76258","2024","COM","2022","4247","114","4361","2024-12-30"
"76259","2024","COM","2022","17961","299","18260","2024-12-30"
"76260","2024","COM","2022","1675","15","1690","2024-12-30"
"76261","2024","COM","2022","446","9","455","2024-12-30"
"76262","2024","COM","2022","145","2","147","2024-12-30"
"76263","2024","COM","2022","1245","27","1272","2024-12-30"
"76264","2024","COM","2022","466","8","474","2024-12-30"
"76265","2024","COM","2022","160","4","164","2024-12-30"
"76266","2024","COM","2022","720","16","736","2024-12-30"
"76268","2024","COM","2022","176","5","181","2024-12-30"
"76269","2024","COM","2022","167","3","170","2024-12-30"
"76270","2024","COM","2022","2713","55","2768","2024-12-30"
"76271","2024","COM","2022","1883","17","1900","2024-12-30"
"76272","2024","COM","2022","876","11","887","2024-12-30"
"76273","2024","COM","2022","562","15","577","2024-12-30"
"76274","2024","COM","2022","24","0","24","2024-12-30"
"76275","2024","COM","2022","1783","27","1810","2024-12-30"
"76276","2024","COM","2022","3653","146","3799","2024-12-30"
"76278","2024","COM","2022","804","8","812","2024-12-30"
"76279","2024","COM","2022","339","0","339","2024-12-30"
"76280","2024","COM","2022","144","1","145","2024-12-30"
"76281","2024","COM","2022","2079","45","2124","2024-12-30"
"76282","2024","COM","2022","993","7","1000","2024-12-30"
"76283","2024","COM","2022","229","5","234","2024-12-30"
"76284","2024","COM","2022","333","5","338","2024-12-30"
"76285","2024","COM","2022","547","7","554","2024-12-30"
"76286","2024","COM","2022","689","9","698","2024-12-30"
"76287","2024","COM","2022","1079","14","1093","2024-12-30"
"76288","2024","COM","2022","378","6","384","2024-12-30"
"76289","2024","COM","2022","1734","27","1761","2024-12-30"
"76290","2024","COM","2022","392","10","402","2024-12-30"
"76291","2024","COM","2022","1157","25","1182","2024-12-30"
"76292","2024","COM","2022","140","1","141","2024-12-30"
"76293","2024","COM","2022","246","3","249","2024-12-30"
"76294","2024","COM","2022","377","8","385","2024-12-30"
"76295","2024","COM","2022","1161","13","1174","2024-12-30"
"76296","2024","COM","2022","2529","40","2569","2024-12-30"
"76297","2024","COM","2022","226","4","230","2024-12-30"
"76298","2024","COM","2022","459","14","473","2024-12-30"
"76299","2024","COM","2022","381","4","385","2024-12-30"
"76300","2024","COM","2022","421","10","431","2024-12-30"
"76302","2024","COM","2022","2829","38","2867","2024-12-30"
"76303","2024","COM","2022","740","6","746","2024-12-30"
"76304","2024","COM","2022","397","6","403","2024-12-30"
"76305","2024","COM","2022","8939","43","8982","2024-12-30"
"76306","2024","COM","2022","170","3","173","2024-12-30"
"76307","2024","COM","2022","1351","13","1364","2024-12-30"
"76308","2024","COM","2022","548","8","556","2024-12-30"
"76309","2024","COM","2022","121","3","124","2024-12-30"
"76311","2024","COM","2022","434","3","437","2024-12-30"
"76312","2024","COM","2022","5834","81","5915","2024-12-30"
"76313","2024","COM","2022","893","15","908","2024-12-30"
"76314","2024","COM","2022","608","13","621","2024-12-30"
"76315","2024","COM","2022","1060","18","1078","2024-12-30"
"76316","2024","COM","2022","437","9","446","2024-12-30"
"76317","2024","COM","2022","423","12","435","2024-12-30"
"76318","2024","COM","2022","763","28","791","2024-12-30"
"76319","2024","COM","2022","9722","173","9895","2024-12-30"
"76320","2024","COM","2022","295","6","301","2024-12-30"
"76321","2024","COM","2022","1733","27","1760","2024-12-30"
"76322","2024","COM","2022","25954","214","26168","2024-12-30"
"76323","2024","COM","2022","156","3","159","2024-12-30"
"76324","2024","COM","2022","840","13","853","2024-12-30"
"76325","2024","COM","2022","447","5","452","2024-12-30"
"76327","2024","COM","2022","374","5","379","2024-12-30"
"76328","2024","COM","2022","373","4","377","2024-12-30"
"76329","2024","COM","2022","3026","37","3063","2024-12-30"
"76330","2024","COM","2022","687","20","707","2024-12-30"
"76331","2024","COM","2022","1009","3","1012","2024-12-30"
"76332","2024","COM","2022","480","7","487","2024-12-30"
"76333","2024","COM","2022","470","4","474","2024-12-30"
"76334","2024","COM","2022","524","9","533","2024-12-30"
"76335","2024","COM","2022","80","3","83","2024-12-30"
"76336","2024","COM","2022","364","4","368","2024-12-30"
"76338","2024","COM","2022","204","5","209","2024-12-30"
"76339","2024","COM","2022","267","4","271","2024-12-30"
"76340","2024","COM","2022","525","9","534","2024-12-30"
"76341","2024","COM","2022","8296","53","8349","2024-12-30"
"76342","2024","COM","2022","707","7","714","2024-12-30"
"76343","2024","COM","2022","192","5","197","2024-12-30"
"76344","2024","COM","2022","456","9","465","2024-12-30"
"76345","2024","COM","2022","277","4","281","2024-12-30"
"76346","2024","COM","2022","308","6","314","2024-12-30"
"76347","2024","COM","2022","334","6","340","2024-12-30"
"76348","2024","COM","2022","691","7","698","2024-12-30"
"76349","2024","COM","2022","1879","47","1926","2024-12-30"
"76350","2024","COM","2022","395","7","402","2024-12-30"
"76351","2024","COM","2022","166462","1867","168329","2024-12-30"
"76352","2024","COM","2022","368","4","372","2024-12-30"
"76353","2024","COM","2022","101","6","107","2024-12-30"
"76354","2024","COM","2022","1393","24","1417","2024-12-30"
"76355","2024","COM","2022","950","6","956","2024-12-30"
"76356","2024","COM","2022","116","2","118","2024-12-30"
"76357","2024","COM","2022","348","16","364","2024-12-30"
"76358","2024","COM","2022","250","0","250","2024-12-30"
"76359","2024","COM","2022","145","2","147","2024-12-30"
"76360","2024","COM","2022","654","9","663","2024-12-30"
"76361","2024","COM","2022","715","9","724","2024-12-30"
"76362","2024","COM","2022","287","7","294","2024-12-30"
"76363","2024","COM","2022","565","9","574","2024-12-30"
"76364","2024","COM","2022","281","12","293","2024-12-30"
"76365","2024","COM","2022","194","3","197","2024-12-30"
"76366","2024","COM","2022","4127","37","4164","2024-12-30"
"76367","2024","COM","2022","2849","51","2900","2024-12-30"
"76368","2024","COM","2022","341","6","347","2024-12-30"
"76369","2024","COM","2022","539","9","548","2024-12-30"
"76370","2024","COM","2022","420","6","426","2024-12-30"
"76371","2024","COM","2022","72","0","72","2024-12-30"
"76372","2024","COM","2022","391","5","396","2024-12-30"
"76373","2024","COM","2022","315","4","319","2024-12-30"
"76374","2024","COM","2022","1138","16","1154","2024-12-30"
"76375","2024","COM","2022","277","14","291","2024-12-30"
"76377","2024","COM","2022","3713","66","3779","2024-12-30"
"76378","2024","COM","2022","1743","28","1771","2024-12-30"
"76379","2024","COM","2022","188","1","189","2024-12-30"
"76380","2024","COM","2022","307","8","315","2024-12-30"
"76381","2024","COM","2022","125","1","126","2024-12-30"
"76382","2024","COM","2022","1147","19","1166","2024-12-30"
"76383","2024","COM","2022","93","1","94","2024-12-30"
"76384","2024","COM","2022","8708","140","8848","2024-12-30"
"76385","2024","COM","2022","1521","55","1576","2024-12-30"
"76386","2024","COM","2022","399","9","408","2024-12-30"
"76387","2024","COM","2022","383","13","396","2024-12-30"
"76388","2024","COM","2022","479","4","483","2024-12-30"
"76389","2024","COM","2022","197","7","204","2024-12-30"
"76390","2024","COM","2022","1115","24","1139","2024-12-30"
"76391","2024","COM","2022","2367","50","2417","2024-12-30"
"76392","2024","COM","2022","1233","20","1253","2024-12-30"
"76393","2024","COM","2022","46","3","49","2024-12-30"
"76394","2024","COM","2022","629","8","637","2024-12-30"
"76395","2024","COM","2022","508","9","517","2024-12-30"
"76396","2024","COM","2022","342","2","344","2024-12-30"
"76397","2024","COM","2022","908","15","923","2024-12-30"
"76398","2024","COM","2022","775","12","787","2024-12-30"
"76399","2024","COM","2022","181","3","184","2024-12-30"
"76400","2024","COM","2022","2166","37","2203","2024-12-30"
"76401","2024","COM","2022","2500","44","2544","2024-12-30"
"76402","2024","COM","2022","6125","45","6170","2024-12-30"
"76403","2024","COM","2022","205","3","208","2024-12-30"
"76404","2024","COM","2022","1267","21","1288","2024-12-30"
"76405","2024","COM","2022","216","1","217","2024-12-30"
"76406","2024","COM","2022","420","10","430","2024-12-30"
"76407","2024","COM","2022","313","8","321","2024-12-30"
"76408","2024","COM","2022","1045","14","1059","2024-12-30"
"76409","2024","COM","2022","926","16","942","2024-12-30"
"76410","2024","COM","2022","11005","105","11110","2024-12-30"
"76411","2024","COM","2022","236","1","237","2024-12-30"
"76412","2024","COM","2022","730","14","744","2024-12-30"
"76413","2024","COM","2022","409","7","416","2024-12-30"
"76414","2024","COM","2022","1595","68","1663","2024-12-30"
"76415","2024","COM","2022","318","7","325","2024-12-30"
"76416","2024","COM","2022","339","6","345","2024-12-30"
"76417","2024","COM","2022","389","11","400","2024-12-30"
"76418","2024","COM","2022","1052","17","1069","2024-12-30"
"76419","2024","COM","2022","151","6","157","2024-12-30"
"76420","2024","COM","2022","364","5","369","2024-12-30"
"76421","2024","COM","2022","932","14","946","2024-12-30"
"76422","2024","COM","2022","261","6","267","2024-12-30"
"76423","2024","COM","2022","173","5","178","2024-12-30"
"76424","2024","COM","2022","236","2","238","2024-12-30"
"76425","2024","COM","2022","301","5","306","2024-12-30"
"76426","2024","COM","2022","155","0","155","2024-12-30"
"76427","2024","COM","2022","941","269","1210","2024-12-30"
"76428","2024","COM","2022","17","2","19","2024-12-30"
"76429","2024","COM","2022","7998","352","8350","2024-12-30"
"76430","2024","COM","2022","118","3","121","2024-12-30"
"76431","2024","COM","2022","94","2","96","2024-12-30"
"76432","2024","COM","2022","244","3","247","2024-12-30"
"76433","2024","COM","2022","764","6","770","2024-12-30"
"76434","2024","COM","2022","1210","14","1224","2024-12-30"
"76435","2024","COM","2022","802","16","818","2024-12-30"
"76436","2024","COM","2022","612","4","616","2024-12-30"
"76437","2024","COM","2022","579","15","594","2024-12-30"
"76438","2024","COM","2022","238","6","244","2024-12-30"
"76439","2024","COM","2022","354","10","364","2024-12-30"
"76440","2024","COM","2022","209","4","213","2024-12-30"
"76441","2024","COM","2022","613","9","622","2024-12-30"
"76442","2024","COM","2022","554","12","566","2024-12-30"
"76443","2024","COM","2022","883","17","900","2024-12-30"
"76445","2024","COM","2022","603","7","610","2024-12-30"
"76446","2024","COM","2022","1281","14","1295","2024-12-30"
"76447","2024","COM","2022","15671","207","15878","2024-12-30"
"76448","2024","COM","2022","1499","35","1534","2024-12-30"
"76449","2024","COM","2022","490","6","496","2024-12-30"
"76450","2024","COM","2022","255","20","275","2024-12-30"
"76451","2024","COM","2022","20188","393","20581","2024-12-30"
"76452","2024","COM","2022","4618","47","4665","2024-12-30"
"76453","2024","COM","2022","1068","13","1081","2024-12-30"
"76454","2024","COM","2022","90","0","90","2024-12-30"
"76455","2024","COM","2022","293","5","298","2024-12-30"
"76456","2024","COM","2022","768","9","777","2024-12-30"
"76457","2024","COM","2022","943","12","955","2024-12-30"
"76458","2024","COM","2022","126","3","129","2024-12-30"
"76459","2024","COM","2022","331","5","336","2024-12-30"
"76460","2024","COM","2022","498","9","507","2024-12-30"
"76461","2024","COM","2022","403","5","408","2024-12-30"
"76462","2024","COM","2022","4671","210","4881","2024-12-30"
"76463","2024","COM","2022","647","14","661","2024-12-30"
"76464","2024","COM","2022","2376","38","2414","2024-12-30"
"76465","2024","COM","2022","534","9","543","2024-12-30"
"76467","2024","COM","2022","1339","18","1357","2024-12-30"
"76468","2024","COM","2022","1369","33","1402","2024-12-30"
"76469","2024","COM","2022","417","5","422","2024-12-30"
"76470","2024","COM","2022","653","16","669","2024-12-30"
"76471","2024","COM","2022","996","20","1016","2024-12-30"
"76472","2024","COM","2022","712","5","717","2024-12-30"
"76473","2024","COM","2022","824","11","835","2024-12-30"
"76474","2024","COM","2022","7004","82","7086","2024-12-30"
"76475","2024","COM","2022","6081","200","6281","2024-12-30"
"76476","2024","COM","2022","10392","190","10582","2024-12-30"
"76477","2024","COM","2022","477","7","484","2024-12-30"
"76478","2024","COM","2022","185","2","187","2024-12-30"
"76479","2024","COM","2022","150","2","152","2024-12-30"
"76480","2024","COM","2022","445","10","455","2024-12-30"
"76481","2024","COM","2022","6147","121","6268","2024-12-30"
"76482","2024","COM","2022","3218","215","3433","2024-12-30"
"76483","2024","COM","2022","233","2","235","2024-12-30"
"76484","2024","COM","2022","12287","82","12369","2024-12-30"
"76485","2024","COM","2022","283","42","325","2024-12-30"
"76486","2024","COM","2022","839","5","844","2024-12-30"
"76487","2024","COM","2022","313","4","317","2024-12-30"
"76488","2024","COM","2022","537","12","549","2024-12-30"
"76489","2024","COM","2022","499","13","512","2024-12-30"
"76490","2024","COM","2022","1092","15","1107","2024-12-30"
"76491","2024","COM","2022","654","11","665","2024-12-30"
"76492","2024","COM","2022","461","16","477","2024-12-30"
"76493","2024","COM","2022","385","13","398","2024-12-30"
"76494","2024","COM","2022","579","7","586","2024-12-30"
"76495","2024","COM","2022","6095","51","6146","2024-12-30"
"76497","2024","COM","2022","8738","177","8915","2024-12-30"
"76498","2024","COM","2022","21935","277","22212","2024-12-30"
"76499","2024","COM","2022","1179","10","1189","2024-12-30"
"76500","2024","COM","2022","475","4","479","2024-12-30"
"76501","2024","COM","2022","130","1","131","2024-12-30"
"76502","2024","COM","2022","522","8","530","2024-12-30"
"76503","2024","COM","2022","1279","20","1299","2024-12-30"
"76504","2024","COM","2022","129","3","132","2024-12-30"
"76505","2024","COM","2022","94","3","97","2024-12-30"
"76506","2024","COM","2022","513","4","517","2024-12-30"
"76507","2024","COM","2022","801","16","817","2024-12-30"
"76508","2024","COM","2022","456","14","470","2024-12-30"
"76509","2024","COM","2022","1856","27","1883","2024-12-30"
"76510","2024","COM","2022","229","2","231","2024-12-30"
"76511","2024","COM","2022","167","1","168","2024-12-30"
"76512","2024","COM","2022","31","2","33","2024-12-30"
"76513","2024","COM","2022","591","16","607","2024-12-30"
"76514","2024","COM","2022","1036","15","1051","2024-12-30"
"76515","2024","COM","2022","544","14","558","2024-12-30"
"76516","2024","COM","2022","401","18","419","2024-12-30"
"76517","2024","COM","2022","3118","64","3182","2024-12-30"
"76518","2024","COM","2022","502","9","511","2024-12-30"
"76519","2024","COM","2022","74","4","78","2024-12-30"
"76520","2024","COM","2022","594","9","603","2024-12-30"
"76521","2024","COM","2022","147","1","148","2024-12-30"
"76522","2024","COM","2022","1280","23","1303","2024-12-30"
"76523","2024","COM","2022","174","2","176","2024-12-30"
"76524","2024","COM","2022","149","2","151","2024-12-30"
"76526","2024","COM","2022","193","6","199","2024-12-30"
"76527","2024","COM","2022","443","8","451","2024-12-30"
"76528","2024","COM","2022","593","10","603","2024-12-30"
"76529","2024","COM","2022","314","6","320","2024-12-30"
"76530","2024","COM","2022","217","2","219","2024-12-30"
"76531","2024","COM","2022","322","7","329","2024-12-30"
"76532","2024","COM","2022","762","19","781","2024-12-30"
"76533","2024","COM","2022","1720","15","1735","2024-12-30"
"76534","2024","COM","2022","1217","12","1229","2024-12-30"
"76535","2024","COM","2022","457","8","465","2024-12-30"
"76536","2024","COM","2022","1255","24","1279","2024-12-30"
"76537","2024","COM","2022","182","6","188","2024-12-30"
"76538","2024","COM","2022","272","5","277","2024-12-30"
"76540","2024","COM","2022","116331","1522","117853","2024-12-30"
"76541","2024","COM","2022","1561","26","1587","2024-12-30"
"76542","2024","COM","2022","286","4","290","2024-12-30"
"76543","2024","COM","2022","612","6","618","2024-12-30"
"76544","2024","COM","2022","226","6","232","2024-12-30"
"76545","2024","COM","2022","1806","33","1839","2024-12-30"
"76546","2024","COM","2022","315","7","322","2024-12-30"
"76547","2024","COM","2022","784","10","794","2024-12-30"
"76548","2024","COM","2022","786","16","802","2024-12-30"
"76549","2024","COM","2022","137","6","143","2024-12-30"
"76550","2024","COM","2022","1226","17","1243","2024-12-30"
"76551","2024","COM","2022","866","11","877","2024-12-30"
"76552","2024","COM","2022","7015","183","7198","2024-12-30"
"76553","2024","COM","2022","298","2","300","2024-12-30"
"76554","2024","COM","2022","341","3","344","2024-12-30"
"76555","2024","COM","2022","805","21","826","2024-12-30"
"76556","2024","COM","2022","1101","14","1115","2024-12-30"
"76557","2024","COM","2022","1459","24","1483","2024-12-30"
"76558","2024","COM","2022","1182","8","1190","2024-12-30"
"76559","2024","COM","2022","518","9","527","2024-12-30"
"76560","2024","COM","2022","1016","18","1034","2024-12-30"
"76561","2024","COM","2022","8429","75","8504","2024-12-30"
"76562","2024","COM","2022","832","22","854","2024-12-30"
"76563","2024","COM","2022","1972","20","1992","2024-12-30"
"76564","2024","COM","2022","175","2","177","2024-12-30"
"76565","2024","COM","2022","1215","102","1317","2024-12-30"
"76566","2024","COM","2022","664","6","670","2024-12-30"
"76567","2024","COM","2022","175","1","176","2024-12-30"
"76568","2024","COM","2022","646","14","660","2024-12-30"
"76569","2024","COM","2022","222","1","223","2024-12-30"
"76570","2024","COM","2022","316","3","319","2024-12-30"
"76571","2024","COM","2022","672","10","682","2024-12-30"
"76572","2024","COM","2022","128","2","130","2024-12-30"
"76573","2024","COM","2022","501","19","520","2024-12-30"
"76574","2024","COM","2022","663","8","671","2024-12-30"
"76575","2024","COM","2022","28653","240","28893","2024-12-30"
"76576","2024","COM","2022","1213","14","1227","2024-12-30"
"76577","2024","COM","2022","629","13","642","2024-12-30"
"76578","2024","COM","2022","260","5","265","2024-12-30"
"76580","2024","COM","2022","927","17","944","2024-12-30"
"76581","2024","COM","2022","377","9","386","2024-12-30"
"76582","2024","COM","2022","235","5","240","2024-12-30"
"76583","2024","COM","2022","310","5","315","2024-12-30"
"76584","2024","COM","2022","226","4","230","2024-12-30"
"76585","2024","COM","2022","387","15","402","2024-12-30"
"76586","2024","COM","2022","659","8","667","2024-12-30"
"76587","2024","COM","2022","698","18","716","2024-12-30"
"76588","2024","COM","2022","517","11","528","2024-12-30"
"76589","2024","COM","2022","199","5","204","2024-12-30"
"76590","2024","COM","2022","362","2","364","2024-12-30"
"76591","2024","COM","2022","3134","45","3179","2024-12-30"
"76592","2024","COM","2022","798","26","824","2024-12-30"
"76593","2024","COM","2022","664","15","679","2024-12-30"
"76594","2024","COM","2022","1348","27","1375","2024-12-30"
"76595","2024","COM","2022","1822","35","1857","2024-12-30"
"76596","2024","COM","2022","1492","27","1519","2024-12-30"
"76597","2024","COM","2022","728","12","740","2024-12-30"
"76598","2024","COM","2022","479","10","489","2024-12-30"
"76599","2024","COM","2022","3665","44","3709","2024-12-30"
"76600","2024","COM","2022","1699","34","1733","2024-12-30"
"76601","2024","COM","2022","233","2","235","2024-12-30"
"76602","2024","COM","2022","609","12","621","2024-12-30"
"76603","2024","COM","2022","470","6","476","2024-12-30"
"76604","2024","COM","2022","171","6","177","2024-12-30"
"76605","2024","COM","2022","475","13","488","2024-12-30"
"76606","2024","COM","2022","186","25","211","2024-12-30"
"76608","2024","COM","2022","2032","32","2064","2024-12-30"
"76609","2024","COM","2022","359","11","370","2024-12-30"
"76610","2024","COM","2022","1583","13","1596","2024-12-30"
"76611","2024","COM","2022","305","7","312","2024-12-30"
"76612","2024","COM","2022","274","6","280","2024-12-30"
"76613","2024","COM","2022","636","13","649","2024-12-30"
"76614","2024","COM","2022","1528","36","1564","2024-12-30"
"76615","2024","COM","2022","650","26","676","2024-12-30"
"76616","2024","COM","2022","1496","35","1531","2024-12-30"
"76617","2024","COM","2022","1678","66","1744","2024-12-30"
"76618","2024","COM","2022","9626","210","9836","2024-12-30"
"76619","2024","COM","2022","293","6","299","2024-12-30"
"76620","2024","COM","2022","272","6","278","2024-12-30"
"76621","2024","COM","2022","1171","22","1193","2024-12-30"
"76622","2024","COM","2022","288","10","298","2024-12-30"
"76623","2024","COM","2022","119","3","122","2024-12-30"
"76624","2024","COM","2022","3707","46","3753","2024-12-30"
"76626","2024","COM","2022","408","14","422","2024-12-30"
"76627","2024","COM","2022","1634","36","1670","2024-12-30"
"76628","2024","COM","2022","906","12","918","2024-12-30"
"76629","2024","COM","2022","277","5","282","2024-12-30"
"76630","2024","COM","2022","225","4","229","2024-12-30"
"76631","2024","COM","2022","1318","15","1333","2024-12-30"
"76632","2024","COM","2022","354","3","357","2024-12-30"
"76634","2024","COM","2022","884","15","899","2024-12-30"
"76635","2024","COM","2022","76","0","76","2024-12-30"
"76636","2024","COM","2022","2301","34","2335","2024-12-30"
"76637","2024","COM","2022","833","14","847","2024-12-30"
"76638","2024","COM","2022","1091","16","1107","2024-12-30"
"76640","2024","COM","2022","8295","87","8382","2024-12-30"
"76641","2024","COM","2022","188","5","193","2024-12-30"
"76642","2024","COM","2022","261","4","265","2024-12-30"
"76644","2024","COM","2022","801","17","818","2024-12-30"
"76645","2024","COM","2022","154","1","155","2024-12-30"
"76646","2024","COM","2022","628","15","643","2024-12-30"
"76647","2024","COM","2022","4608","51","4659","2024-12-30"
"76648","2024","COM","2022","2307","21","2328","2024-12-30"
"76649","2024","COM","2022","579","10","589","2024-12-30"
"76650","2024","COM","2022","1203","19","1222","2024-12-30"
"76651","2024","COM","2022","135","4","139","2024-12-30"
"76652","2024","COM","2022","753","10","763","2024-12-30"
"76653","2024","COM","2022","377","9","386","2024-12-30"
"76654","2024","COM","2022","463","11","474","2024-12-30"
"76655","2024","COM","2022","3884","160","4044","2024-12-30"
"76656","2024","COM","2022","751","5","756","2024-12-30"
"76657","2024","COM","2022","1165","24","1189","2024-12-30"
"76658","2024","COM","2022","695","16","711","2024-12-30"
"76660","2024","COM","2022","801","12","813","2024-12-30"
"76662","2024","COM","2022","105","1","106","2024-12-30"
"76663","2024","COM","2022","1003","19","1022","2024-12-30"
"76664","2024","COM","2022","260","6","266","2024-12-30"
"76665","2024","COM","2022","448","5","453","2024-12-30"
"76666","2024","COM","2022","413","16","429","2024-12-30"
"76667","2024","COM","2022","350","10","360","2024-12-30"
"76668","2024","COM","2022","379","7","386","2024-12-30"
"76669","2024","COM","2022","430","8","438","2024-12-30"
"76670","2024","COM","2022","875","18","893","2024-12-30"
"76671","2024","COM","2022","173","1","174","2024-12-30"
"76672","2024","COM","2022","948","15","963","2024-12-30"
"76673","2024","COM","2022","1118","14","1132","2024-12-30"
"76675","2024","COM","2022","1105","16","1121","2024-12-30"
"76676","2024","COM","2022","487","8","495","2024-12-30"
"76677","2024","COM","2022","364","8","372","2024-12-30"
"76678","2024","COM","2022","829","10","839","2024-12-30"
"76679","2024","COM","2022","112","0","112","2024-12-30"
"76680","2024","COM","2022","174","1","175","2024-12-30"
"76681","2024","COM","2022","29039","447","29486","2024-12-30"
"76682","2024","COM","2022","746","4","750","2024-12-30"
"76683","2024","COM","2022","394","15","409","2024-12-30"
"76684","2024","COM","2022","1226","21","1247","2024-12-30"
"76685","2024","COM","2022","672","8","680","2024-12-30"
"76686","2024","COM","2022","525","8","533","2024-12-30"
"76688","2024","COM","2022","398","11","409","2024-12-30"
"76689","2024","COM","2022","375","33","408","2024-12-30"
"76690","2024","COM","2022","659","19","678","2024-12-30"
"76691","2024","COM","2022","239","1","240","2024-12-30"
"76692","2024","COM","2022","279","5","284","2024-12-30"
"76693","2024","COM","2022","666","11","677","2024-12-30"
"76694","2024","COM","2022","141","4","145","2024-12-30"
"76695","2024","COM","2022","274","6","280","2024-12-30"
"76697","2024","COM","2022","793","25","818","2024-12-30"
"76698","2024","COM","2022","516","8","524","2024-12-30"
"76699","2024","COM","2022","454","6","460","2024-12-30"
"76700","2024","COM","2022","1555","58","1613","2024-12-30"
"76702","2024","COM","2022","839","6","845","2024-12-30"
"76703","2024","COM","2022","230","8","238","2024-12-30"
"76705","2024","COM","2022","2574","21","2595","2024-12-30"
"76706","2024","COM","2022","736","16","752","2024-12-30"
"76707","2024","COM","2022","1190","42","1232","2024-12-30"
"76708","2024","COM","2022","695","11","706","2024-12-30"
"76709","2024","COM","2022","4742","31","4773","2024-12-30"
"76710","2024","COM","2022","100","2","102","2024-12-30"
"76711","2024","COM","2022","4417","93","4510","2024-12-30"
"76712","2024","COM","2022","917","18","935","2024-12-30"
"76714","2024","COM","2022","815","7","822","2024-12-30"
"76715","2024","COM","2022","617","11","628","2024-12-30"
"76716","2024","COM","2022","1595","20","1615","2024-12-30"
"76717","2024","COM","2022","699","6","705","2024-12-30"
"76718","2024","COM","2022","1464","38","1502","2024-12-30"
"76719","2024","COM","2022","869","15","884","2024-12-30"
"76720","2024","COM","2022","962","16","978","2024-12-30"
"76721","2024","COM","2022","326","7","333","2024-12-30"
"76723","2024","COM","2022","417","8","425","2024-12-30"
"76724","2024","COM","2022","130","2","132","2024-12-30"
"76725","2024","COM","2022","583","6","589","2024-12-30"
"76726","2024","COM","2022","326","4","330","2024-12-30"
"76727","2024","COM","2022","1118","21","1139","2024-12-30"
"76728","2024","COM","2022","1214","12","1226","2024-12-30"
"76730","2024","COM","2022","125","5","130","2024-12-30"
"76731","2024","COM","2022","184","2","186","2024-12-30"
"76732","2024","COM","2022","237","4","241","2024-12-30"
"76733","2024","COM","2022","216","3","219","2024-12-30"
"76734","2024","COM","2022","440","11","451","2024-12-30"
"76735","2024","COM","2022","515","15","530","2024-12-30"
"76736","2024","COM","2022","280","5","285","2024-12-30"
"76737","2024","COM","2022","621","10","631","2024-12-30"
"76738","2024","COM","2022","770","10","780","2024-12-30"
"76739","2024","COM","2022","583","6","589","2024-12-30"
"76740","2024","COM","2022","576","12","588","2024-12-30"
"76741","2024","COM","2022","303","5","308","2024-12-30"
"76743","2024","COM","2022","1716","12","1728","2024-12-30"
"76744","2024","COM","2022","185","4","189","2024-12-30"
"76745","2024","COM","2022","217","3","220","2024-12-30"
"76746","2024","COM","2022","224","8","232","2024-12-30"
"76747","2024","COM","2022","343","3","346","2024-12-30"
"76748","2024","COM","2022","661","8","669","2024-12-30"
"76749","2024","COM","2022","330","8","338","2024-12-30"
"76750","2024","COM","2022","1033","15","1048","2024-12-30"
"76751","2024","COM","2022","1283","15","1298","2024-12-30"
"76752","2024","COM","2022","2658","29","2687","2024-12-30"
"76753","2024","COM","2022","1228","16","1244","2024-12-30"
"76754","2024","COM","2022","701","12","713","2024-12-30"
"76755","2024","COM","2022","544","8","552","2024-12-30"
"76756","2024","COM","2022","239","0","239","2024-12-30"
"76757","2024","COM","2022","629","14","643","2024-12-30"
"76758","2024","COM","2022","11548","206","11754","2024-12-30"
"76759","2024","COM","2022","424","8","432","2024-12-30"
"77001","2024","COM","2022","1183","32","1215","2024-12-30"
"77002","2024","COM","2022","821","5","826","2024-12-30"
"77003","2024","COM","2022","351","8","359","2024-12-30"
"77004","2024","COM","2022","324","2","326","2024-12-30"
"77005","2024","COM","2022","3329","51","3380","2024-12-30"
"77006","2024","COM","2022","1007","15","1022","2024-12-30"
"77007","2024","COM","2022","352","10","362","2024-12-30"
"77008","2024","COM","2022","1196","23","1219","2024-12-30"
"77009","2024","COM","2022","140","2","142","2024-12-30"
"77010","2024","COM","2022","965","11","976","2024-12-30"
"77011","2024","COM","2022","482","8","490","2024-12-30"
"77012","2024","COM","2022","275","4","279","2024-12-30"
"77013","2024","COM","2022","363","9","372","2024-12-30"
"77014","2024","COM","2022","13526","224","13750","2024-12-30"
"77015","2024","COM","2022","112","1","113","2024-12-30"
"77016","2024","COM","2022","1582","15","1597","2024-12-30"
"77018","2024","COM","2022","7049","81","7130","2024-12-30"
"77019","2024","COM","2022","351","6","357","2024-12-30"
"77020","2024","COM","2022","658","9","667","2024-12-30"
"77021","2024","COM","2022","151","2","153","2024-12-30"
"77022","2024","COM","2022","1265","40","1305","2024-12-30"
"77023","2024","COM","2022","375","2","377","2024-12-30"
"77024","2024","COM","2022","385","3","388","2024-12-30"
"77025","2024","COM","2022","889","11","900","2024-12-30"
"77026","2024","COM","2022","374","8","382","2024-12-30"
"77027","2024","COM","2022","1136","16","1152","2024-12-30"
"77029","2024","COM","2022","185","3","188","2024-12-30"
"77030","2024","COM","2022","776","14","790","2024-12-30"
"77031","2024","COM","2022","991","11","1002","2024-12-30"
"77032","2024","COM","2022","912","22","934","2024-12-30"
"77033","2024","COM","2022","224","4","228","2024-12-30"
"77034","2024","COM","2022","769","14","783","2024-12-30"
"77035","2024","COM","2022","546","9","555","2024-12-30"
"77036","2024","COM","2022","135","4","139","2024-12-30"
"77037","2024","COM","2022","6026","139","6165","2024-12-30"
"77038","2024","COM","2022","432","8","440","2024-12-30"
"77039","2024","COM","2022","1194","16","1210","2024-12-30"
"77040","2024","COM","2022","3828","38","3866","2024-12-30"
"77041","2024","COM","2022","274","8","282","2024-12-30"
"77042","2024","COM","2022","3313","46","3359","2024-12-30"
"77043","2024","COM","2022","326","7","333","2024-12-30"
"77044","2024","COM","2022","936","9","945","2024-12-30"
"77045","2024","COM","2022","730","12","742","2024-12-30"
"77046","2024","COM","2022","341","5","346","2024-12-30"
"77047","2024","COM","2022","1731","13","1744","2024-12-30"
"77048","2024","COM","2022","2782","87","2869","2024-12-30"
"77049","2024","COM","2022","850","15","865","2024-12-30"
"77050","2024","COM","2022","529","11","540","2024-12-30"
"77051","2024","COM","2022","2378","16","2394","2024-12-30"
"77052","2024","COM","2022","371","5","376","2024-12-30"
"77053","2024","COM","2022","18999","259","19258","2024-12-30"
"77054","2024","COM","2022","736","14","750","2024-12-30"
"77055","2024","COM","2022","5094","33","5127","2024-12-30"
"77056","2024","COM","2022","148","4","152","2024-12-30"
"77057","2024","COM","2022","573","3","576","2024-12-30"
"77058","2024","COM","2022","26334","313","26647","2024-12-30"
"77059","2024","COM","2022","728","15","743","2024-12-30"
"77060","2024","COM","2022","771","13","784","2024-12-30"
"77061","2024","COM","2022","2742","28","2770","2024-12-30"
"77062","2024","COM","2022","457","11","468","2024-12-30"
"77063","2024","COM","2022","1246","13","1259","2024-12-30"
"77065","2024","COM","2022","1256","24","1280","2024-12-30"
"77066","2024","COM","2022","277","3","280","2024-12-30"
"77067","2024","COM","2022","11141","97","11238","2024-12-30"
"77068","2024","COM","2022","213","4","217","2024-12-30"
"77069","2024","COM","2022","2172","36","2208","2024-12-30"
"77070","2024","COM","2022","1557","132","1689","2024-12-30"
"77071","2024","COM","2022","831","14","845","2024-12-30"
"77072","2024","COM","2022","657","10","667","2024-12-30"
"77073","2024","COM","2022","545","11","556","2024-12-30"
"77075","2024","COM","2022","1581","14","1595","2024-12-30"
"77076","2024","COM","2022","758","54","812","2024-12-30"
"77077","2024","COM","2022","1051","5","1056","2024-12-30"
"77078","2024","COM","2022","1431","58","1489","2024-12-30"
"77079","2024","COM","2022","6491","152","6643","2024-12-30"
"77080","2024","COM","2022","197","1","198","2024-12-30"
"77081","2024","COM","2022","735","6","741","2024-12-30"
"77082","2024","COM","2022","814","12","826","2024-12-30"
"77083","2024","COM","2022","26661","142","26803","2024-12-30"
"77084","2024","COM","2022","1352","17","1369","2024-12-30"
"77085","2024","COM","2022","4166","52","4218","2024-12-30"
"77086","2024","COM","2022","1398","5","1403","2024-12-30"
"77087","2024","COM","2022","191","2","193","2024-12-30"
"77088","2024","COM","2022","2236","30","2266","2024-12-30"
"77089","2024","COM","2022","907","10","917","2024-12-30"
"77090","2024","COM","2022","239","2","241","2024-12-30"
"77091","2024","COM","2022","464","6","470","2024-12-30"
"77093","2024","COM","2022","405","4","409","2024-12-30"
"77094","2024","COM","2022","294","3","297","2024-12-30"
"77095","2024","COM","2022","1584","13","1597","2024-12-30"
"77096","2024","COM","2022","2593","39","2632","2024-12-30"
"77097","2024","COM","2022","302","3","305","2024-12-30"
"77098","2024","COM","2022","363","5","368","2024-12-30"
"77099","2024","COM","2022","3150","48","3198","2024-12-30"
"77100","2024","COM","2022","4231","64","4295","2024-12-30"
"77101","2024","COM","2022","1049","16","1065","2024-12-30"
"77102","2024","COM","2022","157","5","162","2024-12-30"
"77103","2024","COM","2022","224","3","227","2024-12-30"
"77104","2024","COM","2022","712","8","720","2024-12-30"
"77106","2024","COM","2022","1004","18","1022","2024-12-30"
"77107","2024","COM","2022","3452","36","3488","2024-12-30"
"77108","2024","COM","2022","54372","293","54665","2024-12-30"
"77109","2024","COM","2022","1629","13","1642","2024-12-30"
"77110","2024","COM","2022","295","7","302","2024-12-30"
"77111","2024","COM","2022","7242","57","7299","2024-12-30"
"77112","2024","COM","2022","255","3","258","2024-12-30"
"77113","2024","COM","2022","1026","12","1038","2024-12-30"
"77114","2024","COM","2022","4019","42","4061","2024-12-30"
"77115","2024","COM","2022","504","16","520","2024-12-30"
"77116","2024","COM","2022","1331","23","1354","2024-12-30"
"77117","2024","COM","2022","924","12","936","2024-12-30"
"77118","2024","COM","2022","12381","86","12467","2024-12-30"
"77119","2024","COM","2022","235","3","238","2024-12-30"
"77120","2024","COM","2022","619","5","624","2024-12-30"
"77121","2024","COM","2022","3332","43","3375","2024-12-30"
"77122","2024","COM","2022","22712","162","22874","2024-12-30"
"77123","2024","COM","2022","821","2","823","2024-12-30"
"77124","2024","COM","2022","1751","27","1778","2024-12-30"
"77125","2024","COM","2022","1470","12","1482","2024-12-30"
"77126","2024","COM","2022","1776","154","1930","2024-12-30"
"77127","2024","COM","2022","1942","13","1955","2024-12-30"
"77128","2024","COM","2022","2131","30","2161","2024-12-30"
"77129","2024","COM","2022","579","8","587","2024-12-30"
"77130","2024","COM","2022","534","4","538","2024-12-30"
"77131","2024","COM","2022","15696","179","15875","2024-12-30"
"77132","2024","COM","2022","3008","32","3040","2024-12-30"
"77133","2024","COM","2022","214","6","220","2024-12-30"
"77134","2024","COM","2022","151","0","151","2024-12-30"
"77135","2024","COM","2022","1497","15","1512","2024-12-30"
"77136","2024","COM","2022","187","2","189","2024-12-30"
"77137","2024","COM","2022","244","3","247","2024-12-30"
"77138","2024","COM","2022","568","7","575","2024-12-30"
"77139","2024","COM","2022","7107","47","7154","2024-12-30"
"77140","2024","COM","2022","265","3","268","2024-12-30"
"77141","2024","COM","2022","1191","9","1200","2024-12-30"
"77142","2024","COM","2022","4881","58","4939","2024-12-30"
"77143","2024","COM","2022","5419","38","5457","2024-12-30"
"77144","2024","COM","2022","450","1","451","2024-12-30"
"77145","2024","COM","2022","595","14","609","2024-12-30"
"77146","2024","COM","2022","1969","20","1989","2024-12-30"
"77147","2024","COM","2022","672","9","681","2024-12-30"
"77148","2024","COM","2022","1806","26","1832","2024-12-30"
"77150","2024","COM","2022","471","4","475","2024-12-30"
"77151","2024","COM","2022","293","3","296","2024-12-30"
"77152","2024","COM","2022","23252","119","23371","2024-12-30"
"77153","2024","COM","2022","11508","77","11585","2024-12-30"
"77154","2024","COM","2022","1268","14","1282","2024-12-30"
"77155","2024","COM","2022","3655","37","3692","2024-12-30"
"77156","2024","COM","2022","946","9","955","2024-12-30"
"77157","2024","COM","2022","330","5","335","2024-12-30"
"77158","2024","COM","2022","196","2","198","2024-12-30"
"77159","2024","COM","2022","2726","42","2768","2024-12-30"
"77161","2024","COM","2022","803","14","817","2024-12-30"
"77162","2024","COM","2022","1119","9","1128","2024-12-30"
"77163","2024","COM","2022","388","2","390","2024-12-30"
"77164","2024","COM","2022","557","5","562","2024-12-30"
"77165","2024","COM","2022","619","5","624","2024-12-30"
"77167","2024","COM","2022","313","5","318","2024-12-30"
"77168","2024","COM","2022","2164","40","2204","2024-12-30"
"77169","2024","COM","2022","7536","33","7569","2024-12-30"
"77171","2024","COM","2022","6237","56","6293","2024-12-30"
"77172","2024","COM","2022","904","10","914","2024-12-30"
"77173","2024","COM","2022","813","8","821","2024-12-30"
"77174","2024","COM","2022","570","10","580","2024-12-30"
"77175","2024","COM","2022","3236","26","3262","2024-12-30"
"77176","2024","COM","2022","3035","28","3063","2024-12-30"
"77177","2024","COM","2022","1293","7","1300","2024-12-30"
"77178","2024","COM","2022","498","10","508","2024-12-30"
"77179","2024","COM","2022","613","16","629","2024-12-30"
"77180","2024","COM","2022","1251","9","1260","2024-12-30"
"77181","2024","COM","2022","3887","40","3927","2024-12-30"
"77182","2024","COM","2022","4762","34","4796","2024-12-30"
"77183","2024","COM","2022","10004","85","10089","2024-12-30"
"77184","2024","COM","2022","594","13","607","2024-12-30"
"77185","2024","COM","2022","683","16","699","2024-12-30"
"77186","2024","COM","2022","15787","521","16308","2024-12-30"
"77187","2024","COM","2022","578","5","583","2024-12-30"
"77188","2024","COM","2022","1014","12","1026","2024-12-30"
"77190","2024","COM","2022","261","3","264","2024-12-30"
"77191","2024","COM","2022","1090","14","1104","2024-12-30"
"77192","2024","COM","2022","5887","47","5934","2024-12-30"
"77193","2024","COM","2022","240","1","241","2024-12-30"
"77194","2024","COM","2022","432","27","459","2024-12-30"
"77195","2024","COM","2022","631","6","637","2024-12-30"
"77196","2024","COM","2022","947","6","953","2024-12-30"
"77197","2024","COM","2022","173","3","176","2024-12-30"
"77198","2024","COM","2022","230","8","238","2024-12-30"
"77199","2024","COM","2022","1381","17","1398","2024-12-30"
"77200","2024","COM","2022","123","5","128","2024-12-30"
"77201","2024","COM","2022","722","8","730","2024-12-30"
"77202","2024","COM","2022","827","6","833","2024-12-30"
"77203","2024","COM","2022","1350","21","1371","2024-12-30"
"77204","2024","COM","2022","203","3","206","2024-12-30"
"77205","2024","COM","2022","146","2","148","2024-12-30"
"77206","2024","COM","2022","186","2","188","2024-12-30"
"77207","2024","COM","2022","161","0","161","2024-12-30"
"77208","2024","COM","2022","1320","29","1349","2024-12-30"
"77209","2024","COM","2022","1175","24","1199","2024-12-30"
"77210","2024","COM","2022","2899","39","2938","2024-12-30"
"77211","2024","COM","2022","1014","4","1018","2024-12-30"
"77212","2024","COM","2022","158","0","158","2024-12-30"
"77214","2024","COM","2022","803","8","811","2024-12-30"
"77215","2024","COM","2022","8682","68","8750","2024-12-30"
"77216","2024","COM","2022","1457","36","1493","2024-12-30"
"77217","2024","COM","2022","2848","25","2873","2024-12-30"
"77218","2024","COM","2022","115","2","117","2024-12-30"
"77219","2024","COM","2022","2669","31","2700","2024-12-30"
"77220","2024","COM","2022","272","4","276","2024-12-30"
"77221","2024","COM","2022","1151","12","1163","2024-12-30"
"77222","2024","COM","2022","4434","28","4462","2024-12-30"
"77223","2024","COM","2022","563","8","571","2024-12-30"
"77224","2024","COM","2022","254","5","259","2024-12-30"
"77225","2024","COM","2022","342","5","347","2024-12-30"
"77226","2024","COM","2022","2511","96","2607","2024-12-30"
"77227","2024","COM","2022","634","8","642","2024-12-30"
"77228","2024","COM","2022","260","2","262","2024-12-30"
"77229","2024","COM","2022","1703","24","1727","2024-12-30"
"77230","2024","COM","2022","158","1","159","2024-12-30"
"77231","2024","COM","2022","780","7","787","2024-12-30"
"77232","2024","COM","2022","1136","17","1153","2024-12-30"
"77233","2024","COM","2022","610","6","616","2024-12-30"
"77234","2024","COM","2022","665","13","678","2024-12-30"
"77235","2024","COM","2022","320","1","321","2024-12-30"
"77236","2024","COM","2022","346","4","350","2024-12-30"
"77237","2024","COM","2022","639","10","649","2024-12-30"
"77238","2024","COM","2022","4262","44","4306","2024-12-30"
"77239","2024","COM","2022","1581","18","1599","2024-12-30"
"77240","2024","COM","2022","2221","24","2245","2024-12-30"
"77241","2024","COM","2022","2031","17","2048","2024-12-30"
"77242","2024","COM","2022","542","7","549","2024-12-30"
"77243","2024","COM","2022","21433","195","21628","2024-12-30"
"77244","2024","COM","2022","729","14","743","2024-12-30"
"77245","2024","COM","2022","394","4","398","2024-12-30"
"77246","2024","COM","2022","577","16","593","2024-12-30"
"77247","2024","COM","2022","450","5","455","2024-12-30"
"77248","2024","COM","2022","767","9","776","2024-12-30"
"77249","2024","COM","2022","7015","118","7133","2024-12-30"
"77250","2024","COM","2022","167","2","169","2024-12-30"
"77251","2024","COM","2022","14096","85","14181","2024-12-30"
"77252","2024","COM","2022","599","3","602","2024-12-30"
"77253","2024","COM","2022","343","1","344","2024-12-30"
"77254","2024","COM","2022","1366","25","1391","2024-12-30"
"77255","2024","COM","2022","2224","28","2252","2024-12-30"
"77256","2024","COM","2022","178","2","180","2024-12-30"
"77257","2024","COM","2022","3575","18","3593","2024-12-30"
"77258","2024","COM","2022","14678","54","14732","2024-12-30"
"77259","2024","COM","2022","2911","9","2920","2024-12-30"
"77260","2024","COM","2022","1802","26","1828","2024-12-30"
"77261","2024","COM","2022","1244","18","1262","2024-12-30"
"77262","2024","COM","2022","492","18","510","2024-12-30"
"77263","2024","COM","2022","231","7","238","2024-12-30"
"77264","2024","COM","2022","1482","20","1502","2024-12-30"
"77265","2024","COM","2022","1048","51","1099","2024-12-30"
"77266","2024","COM","2022","790","12","802","2024-12-30"
"77267","2024","COM","2022","351","6","357","2024-12-30"
"77268","2024","COM","2022","9058","145","9203","2024-12-30"
"77269","2024","COM","2022","1833","54","1887","2024-12-30"
"77270","2024","COM","2022","967","12","979","2024-12-30"
"77271","2024","COM","2022","139","0","139","2024-12-30"
"77272","2024","COM","2022","853","10","863","2024-12-30"
"77273","2024","COM","2022","614","3","617","2024-12-30"
"77274","2024","COM","2022","463","2","465","2024-12-30"
"77275","2024","COM","2022","154","3","157","2024-12-30"
"77276","2024","COM","2022","3313","42","3355","2024-12-30"
"77277","2024","COM","2022","1889","21","1910","2024-12-30"
"77278","2024","COM","2022","413","5","418","2024-12-30"
"77279","2024","COM","2022","1793","24","1817","2024-12-30"
"77280","2024","COM","2022","1135","6","1141","2024-12-30"
"77281","2024","COM","2022","487","10","497","2024-12-30"
"77282","2024","COM","2022","351","4","355","2024-12-30"
"77283","2024","COM","2022","884","11","895","2024-12-30"
"77284","2024","COM","2022","56659","462","57121","2024-12-30"
"77285","2024","COM","2022","19527","149","19676","2024-12-30"
"77286","2024","COM","2022","234","7","241","2024-12-30"
"77287","2024","COM","2022","505","1","506","2024-12-30"
"77288","2024","COM","2022","43685","234","43919","2024-12-30"
"77289","2024","COM","2022","346","5","351","2024-12-30"
"77290","2024","COM","2022","683","41","724","2024-12-30"
"77291","2024","COM","2022","992","5","997","2024-12-30"
"77292","2024","COM","2022","1204","5","1209","2024-12-30"
"77293","2024","COM","2022","857","15","872","2024-12-30"
"77294","2024","COM","2022","20393","81","20474","2024-12-30"
"77295","2024","COM","2022","1363","14","1377","2024-12-30"
"77296","2024","COM","2022","18498","133","18631","2024-12-30"
"77297","2024","COM","2022","330","5","335","2024-12-30"
"77298","2024","COM","2022","445","10","455","2024-12-30"
"77300","2024","COM","2022","646","4","650","2024-12-30"
"77301","2024","COM","2022","321","6","327","2024-12-30"
"77302","2024","COM","2022","1908","32","1940","2024-12-30"
"77303","2024","COM","2022","237","2","239","2024-12-30"
"77304","2024","COM","2022","30","2","32","2024-12-30"
"77305","2024","COM","2022","21840","200","22040","2024-12-30"
"77306","2024","COM","2022","498","6","504","2024-12-30"
"77307","2024","COM","2022","14847","80","14927","2024-12-30"
"77308","2024","COM","2022","724","6","730","2024-12-30"
"77309","2024","COM","2022","1747","10","1757","2024-12-30"
"77310","2024","COM","2022","302","6","308","2024-12-30"
"77311","2024","COM","2022","1362","20","1382","2024-12-30"
"77312","2024","COM","2022","2634","71","2705","2024-12-30"
"77313","2024","COM","2022","228","2","230","2024-12-30"
"77314","2024","COM","2022","251","5","256","2024-12-30"
"77315","2024","COM","2022","3872","20","3892","2024-12-30"
"77316","2024","COM","2022","12576","281","12857","2024-12-30"
"77317","2024","COM","2022","5280","39","5319","2024-12-30"
"77318","2024","COM","2022","1405","17","1422","2024-12-30"
"77319","2024","COM","2022","139","7","146","2024-12-30"
"77320","2024","COM","2022","5869","63","5932","2024-12-30"
"77321","2024","COM","2022","672","6","678","2024-12-30"
"77322","2024","COM","2022","3255","28","3283","2024-12-30"
"77323","2024","COM","2022","1475","10","1485","2024-12-30"
"77325","2024","COM","2022","357","6","363","2024-12-30"
"77326","2024","COM","2022","6322","46","6368","2024-12-30"
"77327","2024","COM","2022","8883","94","8977","2024-12-30"
"77328","2024","COM","2022","410","8","418","2024-12-30"
"77329","2024","COM","2022","697","2","699","2024-12-30"
"77330","2024","COM","2022","7054","66","7120","2024-12-30"
"77331","2024","COM","2022","413","6","419","2024-12-30"
"77332","2024","COM","2022","303","1","304","2024-12-30"
"77333","2024","COM","2022","13118","148","13266","2024-12-30"
"77335","2024","COM","2022","3726","29","3755","2024-12-30"
"77336","2024","COM","2022","1277","6","1283","2024-12-30"
"77337","2024","COM","2022","15927","95","16022","2024-12-30"
"77338","2024","COM","2022","592","8","600","2024-12-30"
"77339","2024","COM","2022","1822","59","1881","2024-12-30"
"77340","2024","COM","2022","596","9","605","2024-12-30"
"77341","2024","COM","2022","376","5","381","2024-12-30"
"77342","2024","COM","2022","120","1","121","2024-12-30"
"77343","2024","COM","2022","376","19","395","2024-12-30"
"77344","2024","COM","2022","2488","24","2512","2024-12-30"
"77345","2024","COM","2022","660","9","669","2024-12-30"
"77347","2024","COM","2022","862","9","871","2024-12-30"
"77348","2024","COM","2022","244","3","247","2024-12-30"
"77349","2024","COM","2022","6741","69","6810","2024-12-30"
"77350","2024","COM","2022","20969","212","21181","2024-12-30"
"77352","2024","COM","2022","2002","22","2024","2024-12-30"
"77353","2024","COM","2022","481","6","487","2024-12-30"
"77354","2024","COM","2022","966","16","982","2024-12-30"
"77355","2024","COM","2022","184","0","184","2024-12-30"
"77356","2024","COM","2022","46","0","46","2024-12-30"
"77357","2024","COM","2022","844","13","857","2024-12-30"
"77358","2024","COM","2022","1357","13","1370","2024-12-30"
"77359","2024","COM","2022","2074","34","2108","2024-12-30"
"77360","2024","COM","2022","404","4","408","2024-12-30"
"77361","2024","COM","2022","474","8","482","2024-12-30"
"77363","2024","COM","2022","1528","11","1539","2024-12-30"
"77364","2024","COM","2022","255","2","257","2024-12-30"
"77365","2024","COM","2022","606","8","614","2024-12-30"
"77366","2024","COM","2022","291","1","292","2024-12-30"
"77367","2024","COM","2022","296","0","296","2024-12-30"
"77368","2024","COM","2022","505","13","518","2024-12-30"
"77369","2024","COM","2022","776","11","787","2024-12-30"
"77370","2024","COM","2022","802","8","810","2024-12-30"
"77371","2024","COM","2022","3039","30","3069","2024-12-30"
"77372","2024","COM","2022","4149","37","4186","2024-12-30"
"77373","2024","COM","2022","38941","222","39163","2024-12-30"
"77374","2024","COM","2022","2149","21","2170","2024-12-30"
"77376","2024","COM","2022","760","2","762","2024-12-30"
"77377","2024","COM","2022","2342","28","2370","2024-12-30"
"77378","2024","COM","2022","3861","33","3894","2024-12-30"
"77379","2024","COM","2022","11824","300","12124","2024-12-30"
"77380","2024","COM","2022","319","4","323","2024-12-30"
"77381","2024","COM","2022","652","5","657","2024-12-30"
"77382","2024","COM","2022","5506","70","5576","2024-12-30"
"77383","2024","COM","2022","833","12","845","2024-12-30"
"77384","2024","COM","2022","2045","7","2052","2024-12-30"
"77385","2024","COM","2022","2291","23","2314","2024-12-30"
"77386","2024","COM","2022","624","18","642","2024-12-30"
"77387","2024","COM","2022","471","8","479","2024-12-30"
"77388","2024","COM","2022","808","10","818","2024-12-30"
"77389","2024","COM","2022","3919","92","4011","2024-12-30"
"77390","2024","COM","2022","23521","138","23659","2024-12-30"
"77391","2024","COM","2022","495","12","507","2024-12-30"
"77392","2024","COM","2022","1021","14","1035","2024-12-30"
"77393","2024","COM","2022","2840","20","2860","2024-12-30"
"77394","2024","COM","2022","3450","34","3484","2024-12-30"
"77395","2024","COM","2022","126","4","130","2024-12-30"
"77396","2024","COM","2022","102","1","103","2024-12-30"
"77397","2024","COM","2022","1869","18","1887","2024-12-30"
"77398","2024","COM","2022","768","8","776","2024-12-30"
"77400","2024","COM","2022","1865","29","1894","2024-12-30"
"77401","2024","COM","2022","692","7","699","2024-12-30"
"77402","2024","COM","2022","340","5","345","2024-12-30"
"77403","2024","COM","2022","812","13","825","2024-12-30"
"77404","2024","COM","2022","1778","37","1815","2024-12-30"
"77405","2024","COM","2022","1943","42","1985","2024-12-30"
"77406","2024","COM","2022","989","14","1003","2024-12-30"
"77407","2024","COM","2022","15117","106","15223","2024-12-30"
"77408","2024","COM","2022","490","3","493","2024-12-30"
"77409","2024","COM","2022","2887","82","2969","2024-12-30"
"77410","2024","COM","2022","737","33","770","2024-12-30"
"77411","2024","COM","2022","553","11","564","2024-12-30"
"77412","2024","COM","2022","371","2","373","2024-12-30"
"77413","2024","COM","2022","3892","41","3933","2024-12-30"
"77414","2024","COM","2022","479","7","486","2024-12-30"
"77415","2024","COM","2022","1294","18","1312","2024-12-30"
"77416","2024","COM","2022","264","6","270","2024-12-30"
"77417","2024","COM","2022","244","1","245","2024-12-30"
"77418","2024","COM","2022","859","9","868","2024-12-30"
"77419","2024","COM","2022","3232","102","3334","2024-12-30"
"77420","2024","COM","2022","3853","26","3879","2024-12-30"
"77421","2024","COM","2022","248","7","255","2024-12-30"
"77423","2024","COM","2022","660","8","668","2024-12-30"
"77424","2024","COM","2022","264","6","270","2024-12-30"
"77425","2024","COM","2022","746","19","765","2024-12-30"
"77426","2024","COM","2022","333","2","335","2024-12-30"
"77427","2024","COM","2022","596","6","602","2024-12-30"
"77428","2024","COM","2022","833","8","841","2024-12-30"
"77429","2024","COM","2022","526","7","533","2024-12-30"
"77430","2024","COM","2022","6478","56","6534","2024-12-30"
"77431","2024","COM","2022","5424","94","5518","2024-12-30"
"77432","2024","COM","2022","976","11","987","2024-12-30"
"77433","2024","COM","2022","2064","30","2094","2024-12-30"
"77434","2024","COM","2022","355","4","359","2024-12-30"
"77435","2024","COM","2022","1120","32","1152","2024-12-30"
"77436","2024","COM","2022","895","13","908","2024-12-30"
"77437","2024","COM","2022","3586","33","3619","2024-12-30"
"77438","2024","COM","2022","6793","80","6873","2024-12-30"
"77439","2024","COM","2022","1171","13","1184","2024-12-30"
"77440","2024","COM","2022","1160","12","1172","2024-12-30"
"77441","2024","COM","2022","2066","52","2118","2024-12-30"
"77442","2024","COM","2022","2409","64","2473","2024-12-30"
"77443","2024","COM","2022","390","9","399","2024-12-30"
"77444","2024","COM","2022","338","6","344","2024-12-30"
"77445","2024","COM","2022","30630","244","30874","2024-12-30"
"77446","2024","COM","2022","604","6","610","2024-12-30"
"77447","2024","COM","2022","1824","49","1873","2024-12-30"
"77448","2024","COM","2022","597","10","607","2024-12-30"
"77449","2024","COM","2022","9988","135","10123","2024-12-30"
"77450","2024","COM","2022","3430","53","3483","2024-12-30"
"77451","2024","COM","2022","620","4","624","2024-12-30"
"77452","2024","COM","2022","70","0","70","2024-12-30"
"77453","2024","COM","2022","1108","13","1121","2024-12-30"
"77454","2024","COM","2022","365","11","376","2024-12-30"
"77455","2024","COM","2022","2024","32","2056","2024-12-30"
"77456","2024","COM","2022","844","17","861","2024-12-30"
"77457","2024","COM","2022","1284","17","1301","2024-12-30"
"77458","2024","COM","2022","4974","95","5069","2024-12-30"
"77459","2024","COM","2022","1515","394","1909","2024-12-30"
"77460","2024","COM","2022","330","4","334","2024-12-30"
"77461","2024","COM","2022","305","6","311","2024-12-30"
"77462","2024","COM","2022","905","2","907","2024-12-30"
"77463","2024","COM","2022","3417","110","3527","2024-12-30"
"77464","2024","COM","2022","10405","93","10498","2024-12-30"
"77465","2024","COM","2022","653","9","662","2024-12-30"
"77466","2024","COM","2022","399","4","403","2024-12-30"
"77467","2024","COM","2022","201","0","201","2024-12-30"
"77468","2024","COM","2022","22939","139","23078","2024-12-30"
"77469","2024","COM","2022","1228","12","1240","2024-12-30"
"77470","2024","COM","2022","8324","103","8427","2024-12-30"
"77471","2024","COM","2022","338","8","346","2024-12-30"
"77472","2024","COM","2022","467","7","474","2024-12-30"
"77473","2024","COM","2022","440","11","451","2024-12-30"
"77474","2024","COM","2022","692","5","697","2024-12-30"
"77475","2024","COM","2022","5107","46","5153","2024-12-30"
"77476","2024","COM","2022","230","2","232","2024-12-30"
"77477","2024","COM","2022","883","31","914","2024-12-30"
"77478","2024","COM","2022","1063","6","1069","2024-12-30"
"77479","2024","COM","2022","13791","104","13895","2024-12-30"
"77480","2024","COM","2022","1023","10","1033","2024-12-30"
"77481","2024","COM","2022","186","2","188","2024-12-30"
"77482","2024","COM","2022","3724","70","3794","2024-12-30"
"77483","2024","COM","2022","2166","16","2182","2024-12-30"
"77484","2024","COM","2022","281","1","282","2024-12-30"
"77485","2024","COM","2022","731","17","748","2024-12-30"
"77486","2024","COM","2022","881","16","897","2024-12-30"
"77487","2024","COM","2022","11378","161","11539","2024-12-30"
"77489","2024","COM","2022","232","4","236","2024-12-30"
"77490","2024","COM","2022","673","9","682","2024-12-30"
"77492","2024","COM","2022","626","5","631","2024-12-30"
"77493","2024","COM","2022","3211","30","3241","2024-12-30"
"77494","2024","COM","2022","2621","27","2648","2024-12-30"
"77495","2024","COM","2022","9057","75","9132","2024-12-30"
"77496","2024","COM","2022","190","4","194","2024-12-30"
"77498","2024","COM","2022","323","5","328","2024-12-30"
"77500","2024","COM","2022","464","10","474","2024-12-30"
"77501","2024","COM","2022","723","13","736","2024-12-30"
"77504","2024","COM","2022","1067","23","1090","2024-12-30"
"77505","2024","COM","2022","383","6","389","2024-12-30"
"77506","2024","COM","2022","766","10","776","2024-12-30"
"77507","2024","COM","2022","453","8","461","2024-12-30"
"77508","2024","COM","2022","1869","34","1903","2024-12-30"
"77509","2024","COM","2022","614","8","622","2024-12-30"
"77510","2024","COM","2022","1383","6","1389","2024-12-30"
"77511","2024","COM","2022","612","4","616","2024-12-30"
"77512","2024","COM","2022","1143","23","1166","2024-12-30"
"77513","2024","COM","2022","5073","27","5100","2024-12-30"
"77514","2024","COM","2022","26794","112","26906","2024-12-30"
"77515","2024","COM","2022","692","5","697","2024-12-30"
"77516","2024","COM","2022","811","11","822","2024-12-30"
"77517","2024","COM","2022","2114","12","2126","2024-12-30"
"77518","2024","COM","2022","242","6","248","2024-12-30"
"77519","2024","COM","2022","1159","25","1184","2024-12-30"
"77520","2024","COM","2022","684","11","695","2024-12-30"
"77521","2024","COM","2022","2067","46","2113","2024-12-30"
"77522","2024","COM","2022","285","5","290","2024-12-30"
"77523","2024","COM","2022","263","0","263","2024-12-30"
"77524","2024","COM","2022","521","6","527","2024-12-30"
"77525","2024","COM","2022","380","1","381","2024-12-30"
"77526","2024","COM","2022","274","4","278","2024-12-30"
"77527","2024","COM","2022","573","18","591","2024-12-30"
"77528","2024","COM","2022","1169","22","1191","2024-12-30"
"77529","2024","COM","2022","1504","33","1537","2024-12-30"
"77530","2024","COM","2022","298","5","303","2024-12-30"
"77531","2024","COM","2022","1622","22","1644","2024-12-30"
"77532","2024","COM","2022","75","2","77","2024-12-30"
"77533","2024","COM","2022","2720","61","2781","2024-12-30"
"77534","2024","COM","2022","970","1","971","2024-12-30"
"78003","2024","COM","2022","3814","46","3860","2024-12-30"
"78005","2024","COM","2022","21663","142","21805","2024-12-30"
"78006","2024","COM","2022","647","16","663","2024-12-30"
"78007","2024","COM","2022","1082","37","1119","2024-12-30"
"78009","2024","COM","2022","281","6","287","2024-12-30"
"78010","2024","COM","2022","1332","28","1360","2024-12-30"
"78013","2024","COM","2022","527","14","541","2024-12-30"
"78015","2024","COM","2022","13663","164","13827","2024-12-30"
"78020","2024","COM","2022","940","13","953","2024-12-30"
"78029","2024","COM","2022","12540","71","12611","2024-12-30"
"78030","2024","COM","2022","1967","49","2016","2024-12-30"
"78031","2024","COM","2022","669","10","679","2024-12-30"
"78033","2024","COM","2022","1159","24","1183","2024-12-30"
"78034","2024","COM","2022","1005","10","1015","2024-12-30"
"78036","2024","COM","2022","655","8","663","2024-12-30"
"78043","2024","COM","2022","3690","122","3812","2024-12-30"
"78048","2024","COM","2022","1456","40","1496","2024-12-30"
"78049","2024","COM","2022","1712","46","1758","2024-12-30"
"78050","2024","COM","2022","697","7","704","2024-12-30"
"78053","2024","COM","2022","523","14","537","2024-12-30"
"78057","2024","COM","2022","1792","26","1818","2024-12-30"
"78062","2024","COM","2022","7635","118","7753","2024-12-30"
"78068","2024","COM","2022","886","25","911","2024-12-30"
"78070","2024","COM","2022","287","5","292","2024-12-30"
"78071","2024","COM","2022","601","16","617","2024-12-30"
"78072","2024","COM","2022","246","2","248","2024-12-30"
"78073","2024","COM","2022","16225","155","16380","2024-12-30"
"78076","2024","COM","2022","291","2","293","2024-12-30"
"78077","2024","COM","2022","748","58","806","2024-12-30"
"78082","2024","COM","2022","638","10","648","2024-12-30"
"78084","2024","COM","2022","614","13","627","2024-12-30"
"78087","2024","COM","2022","2211","51","2262","2024-12-30"
"78089","2024","COM","2022","5077","37","5114","2024-12-30"
"78090","2024","COM","2022","2222","24","2246","2024-12-30"
"78092","2024","COM","2022","9083","131","9214","2024-12-30"
"78096","2024","COM","2022","506","14","520","2024-12-30"
"78104","2024","COM","2022","764","16","780","2024-12-30"
"78107","2024","COM","2022","2031","30","2061","2024-12-30"
"78108","2024","COM","2022","1326","29","1355","2024-12-30"
"78113","2024","COM","2022","667","13","680","2024-12-30"
"78117","2024","COM","2022","5868","120","5988","2024-12-30"
"78118","2024","COM","2022","3364","17","3381","2024-12-30"
"78120","2024","COM","2022","1915","41","1956","2024-12-30"
"78123","2024","COM","2022","19951","119","20070","2024-12-30"
"78124","2024","COM","2022","15002","233","15235","2024-12-30"
"78125","2024","COM","2022","832","17","849","2024-12-30"
"78126","2024","COM","2022","20440","421","20861","2024-12-30"
"78128","2024","COM","2022","1526","43","1569","2024-12-30"
"78133","2024","COM","2022","5826","157","5983","2024-12-30"
"78138","2024","COM","2022","10793","66","10859","2024-12-30"
"78140","2024","COM","2022","1337","23","1360","2024-12-30"
"78143","2024","COM","2022","1540","33","1573","2024-12-30"
"78146","2024","COM","2022","30054","450","30504","2024-12-30"
"78147","2024","COM","2022","454","5","459","2024-12-30"
"78152","2024","COM","2022","1741","75","1816","2024-12-30"
"78158","2024","COM","2022","31064","620","31684","2024-12-30"
"78160","2024","COM","2022","5531","139","5670","2024-12-30"
"78162","2024","COM","2022","537","29","566","2024-12-30"
"78163","2024","COM","2022","369","10","379","2024-12-30"
"78164","2024","COM","2022","851","84","935","2024-12-30"
"78165","2024","COM","2022","16940","207","17147","2024-12-30"
"78168","2024","COM","2022","4385","36","4421","2024-12-30"
"78171","2024","COM","2022","1264","27","1291","2024-12-30"
"78172","2024","COM","2022","36306","421","36727","2024-12-30"
"78185","2024","COM","2022","398","12","410","2024-12-30"
"78188","2024","COM","2022","436","6","442","2024-12-30"
"78189","2024","COM","2022","1717","63","1780","2024-12-30"
"78190","2024","COM","2022","10580","171","10751","2024-12-30"
"78192","2024","COM","2022","1417","24","1441","2024-12-30"
"78193","2024","COM","2022","1003","16","1019","2024-12-30"
"78194","2024","COM","2022","226","3","229","2024-12-30"
"78196","2024","COM","2022","282","15","297","2024-12-30"
"78202","2024","COM","2022","556","8","564","2024-12-30"
"78206","2024","COM","2022","4090","44","4134","2024-12-30"
"78208","2024","COM","2022","26348","249","26597","2024-12-30"
"78209","2024","COM","2022","882","16","898","2024-12-30"
"78217","2024","COM","2022","6778","62","6840","2024-12-30"
"78220","2024","COM","2022","6772","138","6910","2024-12-30"
"78224","2024","COM","2022","4915","146","5061","2024-12-30"
"78227","2024","COM","2022","759","6","765","2024-12-30"
"78230","2024","COM","2022","616","8","624","2024-12-30"
"78231","2024","COM","2022","159","6","165","2024-12-30"
"78233","2024","COM","2022","3038","89","3127","2024-12-30"
"78234","2024","COM","2022","185","1","186","2024-12-30"
"78236","2024","COM","2022","572","9","581","2024-12-30"
"78237","2024","COM","2022","160","5","165","2024-12-30"
"78238","2024","COM","2022","2436","24","2460","2024-12-30"
"78239","2024","COM","2022","2178","18","2196","2024-12-30"
"78242","2024","COM","2022","13640","165","13805","2024-12-30"
"78245","2024","COM","2022","449","13","462","2024-12-30"
"78246","2024","COM","2022","955","17","972","2024-12-30"
"78255","2024","COM","2022","4299","52","4351","2024-12-30"
"78261","2024","COM","2022","691","12","703","2024-12-30"
"78262","2024","COM","2022","1281","20","1301","2024-12-30"
"78263","2024","COM","2022","2513","56","2569","2024-12-30"
"78264","2024","COM","2022","65","1","66","2024-12-30"
"78265","2024","COM","2022","2577","47","2624","2024-12-30"
"78267","2024","COM","2022","7848","50","7898","2024-12-30"
"78269","2024","COM","2022","1337","30","1367","2024-12-30"
"78276","2024","COM","2022","621","7","628","2024-12-30"
"78278","2024","COM","2022","568","13","581","2024-12-30"
"78281","2024","COM","2022","643","16","659","2024-12-30"
"78283","2024","COM","2022","302","11","313","2024-12-30"
"78285","2024","COM","2022","539","15","554","2024-12-30"
"78289","2024","COM","2022","901","41","942","2024-12-30"
"78290","2024","COM","2022","1085","13","1098","2024-12-30"
"78291","2024","COM","2022","2088","29","2117","2024-12-30"
"78296","2024","COM","2022","642","12","654","2024-12-30"
"78297","2024","COM","2022","29758","437","30195","2024-12-30"
"78299","2024","COM","2022","2498","21","2519","2024-12-30"
"78300","2024","COM","2022","424","10","434","2024-12-30"
"78302","2024","COM","2022","165","5","170","2024-12-30"
"78305","2024","COM","2022","232","4","236","2024-12-30"
"78307","2024","COM","2022","958","26","984","2024-12-30"
"78310","2024","COM","2022","3716","39","3755","2024-12-30"
"78311","2024","COM","2022","33617","299","33916","2024-12-30"
"78314","2024","COM","2022","3858","46","3904","2024-12-30"
"78317","2024","COM","2022","777","13","790","2024-12-30"
"78320","2024","COM","2022","734","15","749","2024-12-30"
"78321","2024","COM","2022","5965","121","6086","2024-12-30"
"78322","2024","COM","2022","7985","124","8109","2024-12-30"
"78324","2024","COM","2022","564","3","567","2024-12-30"
"78325","2024","COM","2022","624","8","632","2024-12-30"
"78327","2024","COM","2022","4040","41","4081","2024-12-30"
"78329","2024","COM","2022","807","15","822","2024-12-30"
"78334","2024","COM","2022","1610","35","1645","2024-12-30"
"78335","2024","COM","2022","17584","93","17677","2024-12-30"
"78337","2024","COM","2022","2067","27","2094","2024-12-30"
"78343","2024","COM","2022","1655","64","1719","2024-12-30"
"78344","2024","COM","2022","643","9","652","2024-12-30"
"78346","2024","COM","2022","1582","24","1606","2024-12-30"
"78349","2024","COM","2022","498","8","506","2024-12-30"
"78350","2024","COM","2022","7744","133","7877","2024-12-30"
"78354","2024","COM","2022","6389","135","6524","2024-12-30"
"78356","2024","COM","2022","9353","162","9515","2024-12-30"
"78358","2024","COM","2022","22855","442","23297","2024-12-30"
"78361","2024","COM","2022","44246","146","44392","2024-12-30"
"78362","2024","COM","2022","21874","170","22044","2024-12-30"
"78364","2024","COM","2022","790","14","804","2024-12-30"
"78366","2024","COM","2022","413","9","422","2024-12-30"
"78367","2024","COM","2022","3984","121","4105","2024-12-30"
"78368","2024","COM","2022","1743","45","1788","2024-12-30"
"78372","2024","COM","2022","16619","440","17059","2024-12-30"
"78380","2024","COM","2022","6100","231","6331","2024-12-30"
"78381","2024","COM","2022","1054","15","1069","2024-12-30"
"78382","2024","COM","2022","4399","54","4453","2024-12-30"
"78383","2024","COM","2022","19960","191","20151","2024-12-30"
"78384","2024","COM","2022","1305","26","1331","2024-12-30"
"78385","2024","COM","2022","218","3","221","2024-12-30"
"78389","2024","COM","2022","1695","49","1744","2024-12-30"
"78391","2024","COM","2022","378","8","386","2024-12-30"
"78396","2024","COM","2022","6340","113","6453","2024-12-30"
"78397","2024","COM","2022","7103","198","7301","2024-12-30"
"78398","2024","COM","2022","893","17","910","2024-12-30"
"78401","2024","COM","2022","8996","77","9073","2024-12-30"
"78402","2024","COM","2022","3874","34","3908","2024-12-30"
"78403","2024","COM","2022","2261","36","2297","2024-12-30"
"78404","2024","COM","2022","278","7","285","2024-12-30"
"78406","2024","COM","2022","292","6","298","2024-12-30"
"78407","2024","COM","2022","650","13","663","2024-12-30"
"78410","2024","COM","2022","913","15","928","2024-12-30"
"78413","2024","COM","2022","390","7","397","2024-12-30"
"78415","2024","COM","2022","560","11","571","2024-12-30"
"78416","2024","COM","2022","321","5","326","2024-12-30"
"78417","2024","COM","2022","285","7","292","2024-12-30"
"78418","2024","COM","2022","14606","219","14825","2024-12-30"
"78420","2024","COM","2022","2790","76","2866","2024-12-30"
"78423","2024","COM","2022","32150","473","32623","2024-12-30"
"78431","2024","COM","2022","3102","68","3170","2024-12-30"
"78437","2024","COM","2022","680","9","689","2024-12-30"
"78439","2024","COM","2022","117","4","121","2024-12-30"
"78440","2024","COM","2022","34151","173","34324","2024-12-30"
"78442","2024","COM","2022","3295","46","3341","2024-12-30"
"78443","2024","COM","2022","924","21","945","2024-12-30"
"78444","2024","COM","2022","872","14","886","2024-12-30"
"78451","2024","COM","2022","1111","8","1119","2024-12-30"
"78455","2024","COM","2022","7597","281","7878","2024-12-30"
"78460","2024","COM","2022","1113","15","1128","2024-12-30"
"78464","2024","COM","2022","983","17","1000","2024-12-30"
"78465","2024","COM","2022","2484","44","2528","2024-12-30"
"78466","2024","COM","2022","7092","213","7305","2024-12-30"
"78470","2024","COM","2022","879","19","898","2024-12-30"
"78472","2024","COM","2022","325","8","333","2024-12-30"
"78474","2024","COM","2022","935","19","954","2024-12-30"
"78475","2024","COM","2022","407","9","416","2024-12-30"
"78478","2024","COM","2022","216","8","224","2024-12-30"
"78481","2024","COM","2022","15858","274","16132","2024-12-30"
"78484","2024","COM","2022","669","16","685","2024-12-30"
"78486","2024","COM","2022","6515","98","6613","2024-12-30"
"78490","2024","COM","2022","31971","344","32315","2024-12-30"
"78497","2024","COM","2022","930","34","964","2024-12-30"
"78498","2024","COM","2022","40792","279","41071","2024-12-30"
"78499","2024","COM","2022","700","21","721","2024-12-30"
"78501","2024","COM","2022","3167","59","3226","2024-12-30"
"78502","2024","COM","2022","5583","54","5637","2024-12-30"
"78505","2024","COM","2022","410","8","418","2024-12-30"
"78506","2024","COM","2022","820","7","827","2024-12-30"
"78513","2024","COM","2022","2505","33","2538","2024-12-30"
"78516","2024","COM","2022","990","28","1018","2024-12-30"
"78517","2024","COM","2022","27145","551","27696","2024-12-30"
"78518","2024","COM","2022","107","4","111","2024-12-30"
"78520","2024","COM","2022","1571","47","1618","2024-12-30"
"78522","2024","COM","2022","897","28","925","2024-12-30"
"78528","2024","COM","2022","351","2","353","2024-12-30"
"78530","2024","COM","2022","386","6","392","2024-12-30"
"78531","2024","COM","2022","7041","47","7088","2024-12-30"
"78536","2024","COM","2022","335","10","345","2024-12-30"
"78537","2024","COM","2022","5854","137","5991","2024-12-30"
"78545","2024","COM","2022","20451","568","21019","2024-12-30"
"78548","2024","COM","2022","445","12","457","2024-12-30"
"78550","2024","COM","2022","1842","38","1880","2024-12-30"
"78551","2024","COM","2022","45286","1695","46981","2024-12-30"
"78557","2024","COM","2022","988","22","1010","2024-12-30"
"78558","2024","COM","2022","356","6","362","2024-12-30"
"78559","2024","COM","2022","448","5","453","2024-12-30"
"78561","2024","COM","2022","448","35","483","2024-12-30"
"78562","2024","COM","2022","1462","33","1495","2024-12-30"
"78564","2024","COM","2022","688","9","697","2024-12-30"
"78565","2024","COM","2022","304","9","313","2024-12-30"
"78567","2024","COM","2022","947","11","958","2024-12-30"
"78569","2024","COM","2022","910","18","928","2024-12-30"
"78571","2024","COM","2022","4877","203","5080","2024-12-30"
"78575","2024","COM","2022","7747","160","7907","2024-12-30"
"78576","2024","COM","2022","1689","26","1715","2024-12-30"
"78586","2024","COM","2022","51570","371","51941","2024-12-30"
"78588","2024","COM","2022","956","18","974","2024-12-30"
"78590","2024","COM","2022","509","9","518","2024-12-30"
"78591","2024","COM","2022","2234","40","2274","2024-12-30"
"78597","2024","COM","2022","731","6","737","2024-12-30"
"78601","2024","COM","2022","1664","58","1722","2024-12-30"
"78605","2024","COM","2022","1194","17","1211","2024-12-30"
"78606","2024","COM","2022","37","1","38","2024-12-30"
"78608","2024","COM","2022","129","4","133","2024-12-30"
"78609","2024","COM","2022","971","11","982","2024-12-30"
"78615","2024","COM","2022","1102","10","1112","2024-12-30"
"78616","2024","COM","2022","1432","27","1459","2024-12-30"
"78618","2024","COM","2022","529","15","544","2024-12-30"
"78620","2024","COM","2022","1176","39","1215","2024-12-30"
"78621","2024","COM","2022","34276","103","34379","2024-12-30"
"78623","2024","COM","2022","956","149","1105","2024-12-30"
"78624","2024","COM","2022","12386","166","12552","2024-12-30"
"78638","2024","COM","2022","5143","72","5215","2024-12-30"
"78640","2024","COM","2022","22481","163","22644","2024-12-30"
"78642","2024","COM","2022","16112","284","16396","2024-12-30"
"78643","2024","COM","2022","9953","183","10136","2024-12-30"
"78644","2024","COM","2022","6142","77","6219","2024-12-30"
"78646","2024","COM","2022","83918","1692","85610","2024-12-30"
"78647","2024","COM","2022","852","18","870","2024-12-30"
"78650","2024","COM","2022","15712","447","16159","2024-12-30"
"78653","2024","COM","2022","391","10","401","2024-12-30"
"78655","2024","COM","2022","618","25","643","2024-12-30"
"78668","2024","COM","2022","662","17","679","2024-12-30"
"78672","2024","COM","2022","5792","142","5934","2024-12-30"
"78674","2024","COM","2022","11568","172","11740","2024-12-30"
"78677","2024","COM","2022","537","18","555","2024-12-30"
"78681","2024","COM","2022","872","11","883","2024-12-30"
"78683","2024","COM","2022","3231","119","3350","2024-12-30"
"78686","2024","COM","2022","16943","334","17277","2024-12-30"
"78688","2024","COM","2022","10740","374","11114","2024-12-30"
"79001","2024","COM","2022","1078","16","1094","2024-12-30"
"79002","2024","COM","2022","312","8","320","2024-12-30"
"79003","2024","COM","2022","5423","171","5594","2024-12-30"
"79005","2024","COM","2022","3295","47","3342","2024-12-30"
"79007","2024","COM","2022","616","19","635","2024-12-30"
"79008","2024","COM","2022","824","13","837","2024-12-30"
"79009","2024","COM","2022","429","9","438","2024-12-30"
"79010","2024","COM","2022","604","5","609","2024-12-30"
"79012","2024","COM","2022","1249","29","1278","2024-12-30"
"79013","2024","COM","2022","3229","83","3312","2024-12-30"
"79014","2024","COM","2022","2590","49","2639","2024-12-30"
"79015","2024","COM","2022","191","4","195","2024-12-30"
"79016","2024","COM","2022","766","20","786","2024-12-30"
"79018","2024","COM","2022","165","3","168","2024-12-30"
"79019","2024","COM","2022","169","6","175","2024-12-30"
"79020","2024","COM","2022","887","21","908","2024-12-30"
"79022","2024","COM","2022","184","4","188","2024-12-30"
"79023","2024","COM","2022","63","1","64","2024-12-30"
"79024","2024","COM","2022","1952","84","2036","2024-12-30"
"79025","2024","COM","2022","1111","30","1141","2024-12-30"
"79029","2024","COM","2022","676","18","694","2024-12-30"
"79030","2024","COM","2022","938","70","1008","2024-12-30"
"79031","2024","COM","2022","1772","34","1806","2024-12-30"
"79032","2024","COM","2022","760","14","774","2024-12-30"
"79034","2024","COM","2022","1882","55","1937","2024-12-30"
"79038","2024","COM","2022","1175","18","1193","2024-12-30"
"79040","2024","COM","2022","226","2","228","2024-12-30"
"79042","2024","COM","2022","170","6","176","2024-12-30"
"79046","2024","COM","2022","570","9","579","2024-12-30"
"79047","2024","COM","2022","448","9","457","2024-12-30"
"79048","2024","COM","2022","5681","137","5818","2024-12-30"
"79049","2024","COM","2022","19860","968","20828","2024-12-30"
"79050","2024","COM","2022","596","17","613","2024-12-30"
"79055","2024","COM","2022","99","4","103","2024-12-30"
"79056","2024","COM","2022","753","16","769","2024-12-30"
"79057","2024","COM","2022","1434","49","1483","2024-12-30"
"79058","2024","COM","2022","748","15","763","2024-12-30"
"79059","2024","COM","2022","734","7","741","2024-12-30"
"79060","2024","COM","2022","176","3","179","2024-12-30"
"79061","2024","COM","2022","3834","81","3915","2024-12-30"
"79062","2024","COM","2022","4795","80","4875","2024-12-30"
"79063","2024","COM","2022","2023","122","2145","2024-12-30"
"79064","2024","COM","2022","764","17","781","2024-12-30"
"79066","2024","COM","2022","1791","40","1831","2024-12-30"
"79069","2024","COM","2022","982","25","1007","2024-12-30"
"79070","2024","COM","2022","415","10","425","2024-12-30"
"79071","2024","COM","2022","456","15","471","2024-12-30"
"79074","2024","COM","2022","171","5","176","2024-12-30"
"79076","2024","COM","2022","2080","28","2108","2024-12-30"
"79077","2024","COM","2022","736","9","745","2024-12-30"
"79078","2024","COM","2022","993","20","1013","2024-12-30"
"79079","2024","COM","2022","8585","281","8866","2024-12-30"
"79080","2024","COM","2022","2675","56","2731","2024-12-30"
"79081","2024","COM","2022","7173","211","7384","2024-12-30"
"79083","2024","COM","2022","2387","107","2494","2024-12-30"
"79084","2024","COM","2022","456","10","466","2024-12-30"
"79085","2024","COM","2022","133","4","137","2024-12-30"
"79086","2024","COM","2022","1867","48","1915","2024-12-30"
"79087","2024","COM","2022","547","9","556","2024-12-30"
"79088","2024","COM","2022","1689","43","1732","2024-12-30"
"79089","2024","COM","2022","164","2","166","2024-12-30"
"79090","2024","COM","2022","843","17","860","2024-12-30"
"79091","2024","COM","2022","949","28","977","2024-12-30"
"79092","2024","COM","2022","352","8","360","2024-12-30"
"79094","2024","COM","2022","925","16","941","2024-12-30"
"79095","2024","COM","2022","571","12","583","2024-12-30"
"79096","2024","COM","2022","1194","30","1224","2024-12-30"
"79100","2024","COM","2022","2275","52","2327","2024-12-30"
"79101","2024","COM","2022","2341","54","2395","2024-12-30"
"79102","2024","COM","2022","445","10","455","2024-12-30"
"79103","2024","COM","2022","2403","48","2451","2024-12-30"
"79104","2024","COM","2022","544","21","565","2024-12-30"
"79105","2024","COM","2022","452","14","466","2024-12-30"
"79106","2024","COM","2022","408","2","410","2024-12-30"
"79108","2024","COM","2022","213","3","216","2024-12-30"
"79109","2024","COM","2022","3536","96","3632","2024-12-30"
"79111","2024","COM","2022","288","6","294","2024-12-30"
"79112","2024","COM","2022","851","20","871","2024-12-30"
"79114","2024","COM","2022","1562","27","1589","2024-12-30"
"79115","2024","COM","2022","540","16","556","2024-12-30"
"79116","2024","COM","2022","1126","19","1145","2024-12-30"
"79117","2024","COM","2022","658","9","667","2024-12-30"
"79118","2024","COM","2022","291","6","297","2024-12-30"
"79119","2024","COM","2022","643","11","654","2024-12-30"
"79120","2024","COM","2022","762","18","780","2024-12-30"
"79121","2024","COM","2022","388","10","398","2024-12-30"
"79122","2024","COM","2022","534","8","542","2024-12-30"
"79123","2024","COM","2022","2261","49","2310","2024-12-30"
"79124","2024","COM","2022","103","5","108","2024-12-30"
"79125","2024","COM","2022","1812","51","1863","2024-12-30"
"79126","2024","COM","2022","426","10","436","2024-12-30"
"79127","2024","COM","2022","839","17","856","2024-12-30"
"79128","2024","COM","2022","976","35","1011","2024-12-30"
"79129","2024","COM","2022","1769","51","1820","2024-12-30"
"79130","2024","COM","2022","2968","75","3043","2024-12-30"
"79131","2024","COM","2022","337","8","345","2024-12-30"
"79132","2024","COM","2022","306","10","316","2024-12-30"
"79133","2024","COM","2022","1180","36","1216","2024-12-30"
"79134","2024","COM","2022","539","13","552","2024-12-30"
"79135","2024","COM","2022","892","16","908","2024-12-30"
"79136","2024","COM","2022","905","17","922","2024-12-30"
"79137","2024","COM","2022","912","17","929","2024-12-30"
"79139","2024","COM","2022","54","0","54","2024-12-30"
"79140","2024","COM","2022","814","11","825","2024-12-30"
"79141","2024","COM","2022","209","4","213","2024-12-30"
"79142","2024","COM","2022","99","2","101","2024-12-30"
"79144","2024","COM","2022","380","6","386","2024-12-30"
"79145","2024","COM","2022","372","6","378","2024-12-30"
"79147","2024","COM","2022","750","8","758","2024-12-30"
"79148","2024","COM","2022","2013","27","2040","2024-12-30"
"79149","2024","COM","2022","147","4","151","2024-12-30"
"79150","2024","COM","2022","845","15","860","2024-12-30"
"79152","2024","COM","2022","302","5","307","2024-12-30"
"79153","2024","COM","2022","157","3","160","2024-12-30"
"79154","2024","COM","2022","359","6","365","2024-12-30"
"79156","2024","COM","2022","679","27","706","2024-12-30"
"79157","2024","COM","2022","1292","39","1331","2024-12-30"
"79158","2024","COM","2022","122","2","124","2024-12-30"
"79159","2024","COM","2022","533","11","544","2024-12-30"
"79160","2024","COM","2022","175","3","178","2024-12-30"
"79161","2024","COM","2022","621","11","632","2024-12-30"
"79162","2024","COM","2022","2708","61","2769","2024-12-30"
"79163","2024","COM","2022","562","11","573","2024-12-30"
"79164","2024","COM","2022","250","0","250","2024-12-30"
"79165","2024","COM","2022","130","5","135","2024-12-30"
"79166","2024","COM","2022","901","22","923","2024-12-30"
"79167","2024","COM","2022","220","6","226","2024-12-30"
"79170","2024","COM","2022","2917","49","2966","2024-12-30"
"79172","2024","COM","2022","1028","23","1051","2024-12-30"
"79174","2024","COM","2022","5790","273","6063","2024-12-30"
"79175","2024","COM","2022","479","10","489","2024-12-30"
"79176","2024","COM","2022","856","8","864","2024-12-30"
"79177","2024","COM","2022","211","3","214","2024-12-30"
"79179","2024","COM","2022","5100","175","5275","2024-12-30"
"79180","2024","COM","2022","298","4","302","2024-12-30"
"79183","2024","COM","2022","368","9","377","2024-12-30"
"79184","2024","COM","2022","1662","24","1686","2024-12-30"
"79185","2024","COM","2022","4685","132","4817","2024-12-30"
"79189","2024","COM","2022","1702","32","1734","2024-12-30"
"79190","2024","COM","2022","484","1","485","2024-12-30"
"79191","2024","COM","2022","60074","1821","61895","2024-12-30"
"79195","2024","COM","2022","5529","140","5669","2024-12-30"
"79196","2024","COM","2022","2334","49","2383","2024-12-30"
"79197","2024","COM","2022","102","4","106","2024-12-30"
"79198","2024","COM","2022","255","3","258","2024-12-30"
"79200","2024","COM","2022","256","3","259","2024-12-30"
"79201","2024","COM","2022","1685","19","1704","2024-12-30"
"79202","2024","COM","2022","10121","399","10520","2024-12-30"
"79203","2024","COM","2022","343","8","351","2024-12-30"
"79204","2024","COM","2022","954","34","988","2024-12-30"
"79205","2024","COM","2022","69","1","70","2024-12-30"
"79207","2024","COM","2022","625","18","643","2024-12-30"
"79208","2024","COM","2022","1113","30","1143","2024-12-30"
"79209","2024","COM","2022","323","10","333","2024-12-30"
"79210","2024","COM","2022","1069","25","1094","2024-12-30"
"79212","2024","COM","2022","219","3","222","2024-12-30"
"79213","2024","COM","2022","2052","50","2102","2024-12-30"
"79215","2024","COM","2022","360","11","371","2024-12-30"
"79216","2024","COM","2022","2249","65","2314","2024-12-30"
"79217","2024","COM","2022","936","22","958","2024-12-30"
"79218","2024","COM","2022","192","5","197","2024-12-30"
"79220","2024","COM","2022","597","12","609","2024-12-30"
"79223","2024","COM","2022","63","2","65","2024-12-30"
"79225","2024","COM","2022","386","3","389","2024-12-30"
"79226","2024","COM","2022","275","4","279","2024-12-30"
"79229","2024","COM","2022","526","15","541","2024-12-30"
"79230","2024","COM","2022","798","9","807","2024-12-30"
"79231","2024","COM","2022","702","25","727","2024-12-30"
"79235","2024","COM","2022","1421","42","1463","2024-12-30"
"79236","2024","COM","2022","637","14","651","2024-12-30"
"79238","2024","COM","2022","561","14","575","2024-12-30"
"79239","2024","COM","2022","1662","134","1796","2024-12-30"
"79241","2024","COM","2022","566","23","589","2024-12-30"
"79242","2024","COM","2022","1131","22","1153","2024-12-30"
"79243","2024","COM","2022","277","1","278","2024-12-30"
"79244","2024","COM","2022","373","6","379","2024-12-30"
"79246","2024","COM","2022","592","11","603","2024-12-30"
"79249","2024","COM","2022","2217","70","2287","2024-12-30"
"79250","2024","COM","2022","407","10","417","2024-12-30"
"79251","2024","COM","2022","726","18","744","2024-12-30"
"79252","2024","COM","2022","339","13","352","2024-12-30"
"79253","2024","COM","2022","685","15","700","2024-12-30"
"79254","2024","COM","2022","433","8","441","2024-12-30"
"79255","2024","COM","2022","387","4","391","2024-12-30"
"79256","2024","COM","2022","259","5","264","2024-12-30"
"79257","2024","COM","2022","1510","24","1534","2024-12-30"
"79258","2024","COM","2022","423","11","434","2024-12-30"
"79259","2024","COM","2022","1322","32","1354","2024-12-30"
"79263","2024","COM","2022","614","10","624","2024-12-30"
"79265","2024","COM","2022","1257","23","1280","2024-12-30"
"79267","2024","COM","2022","305","5","310","2024-12-30"
"79268","2024","COM","2022","1038","59","1097","2024-12-30"
"79269","2024","COM","2022","418","4","422","2024-12-30"
"79270","2024","COM","2022","7433","144","7577","2024-12-30"
"79271","2024","COM","2022","366","5","371","2024-12-30"
"79273","2024","COM","2022","814","19","833","2024-12-30"
"79274","2024","COM","2022","320","4","324","2024-12-30"
"79276","2024","COM","2022","1066","33","1099","2024-12-30"
"79277","2024","COM","2022","1037","17","1054","2024-12-30"
"79278","2024","COM","2022","252","2","254","2024-12-30"
"79280","2024","COM","2022","888","17","905","2024-12-30"
"79281","2024","COM","2022","1316","33","1349","2024-12-30"
"79283","2024","COM","2022","1353","32","1385","2024-12-30"
"79284","2024","COM","2022","772","10","782","2024-12-30"
"79285","2024","COM","2022","1872","44","1916","2024-12-30"
"79286","2024","COM","2022","496","15","511","2024-12-30"
"79289","2024","COM","2022","1396","30","1426","2024-12-30"
"79290","2024","COM","2022","954","25","979","2024-12-30"
"79293","2024","COM","2022","1090","33","1123","2024-12-30"
"79294","2024","COM","2022","167","2","169","2024-12-30"
"79295","2024","COM","2022","720","20","740","2024-12-30"
"79297","2024","COM","2022","345","5","350","2024-12-30"
"79298","2024","COM","2022","1986","75","2061","2024-12-30"
"79299","2024","COM","2022","2396","44","2440","2024-12-30"
"79300","2024","COM","2022","1404","30","1434","2024-12-30"
"79301","2024","COM","2022","599","6","605","2024-12-30"
"79302","2024","COM","2022","1322","33","1355","2024-12-30"
"79303","2024","COM","2022","323","6","329","2024-12-30"
"79304","2024","COM","2022","765","51","816","2024-12-30"
"79306","2024","COM","2022","182","5","187","2024-12-30"
"79307","2024","COM","2022","1497","27","1524","2024-12-30"
"79308","2024","COM","2022","663","8","671","2024-12-30"
"79309","2024","COM","2022","359","1","360","2024-12-30"
"79310","2024","COM","2022","487","11","498","2024-12-30"
"79311","2024","COM","2022","1791","77","1868","2024-12-30"
"79312","2024","COM","2022","112","3","115","2024-12-30"
"79313","2024","COM","2022","638","14","652","2024-12-30"
"79316","2024","COM","2022","424","13","437","2024-12-30"
"79319","2024","COM","2022","858","27","885","2024-12-30"
"79320","2024","COM","2022","649","26","675","2024-12-30"
"79322","2024","COM","2022","1972","56","2028","2024-12-30"
"79326","2024","COM","2022","1398","18","1416","2024-12-30"
"79329","2024","COM","2022","13949","277","14226","2024-12-30"
"79331","2024","COM","2022","126","6","132","2024-12-30"
"79332","2024","COM","2022","115","1","116","2024-12-30"
"79334","2024","COM","2022","1087","28","1115","2024-12-30"
"79335","2024","COM","2022","823","25","848","2024-12-30"
"79336","2024","COM","2022","225","3","228","2024-12-30"
"79337","2024","COM","2022","861","18","879","2024-12-30"
"79338","2024","COM","2022","242","6","248","2024-12-30"
"79339","2024","COM","2022","1666","30","1696","2024-12-30"
"79340","2024","COM","2022","330","8","338","2024-12-30"
"79341","2024","COM","2022","127","3","130","2024-12-30"
"79342","2024","COM","2022","583","10","593","2024-12-30"
"79343","2024","COM","2022","237","2","239","2024-12-30"
"79345","2024","COM","2022","895","21","916","2024-12-30"
"79346","2024","COM","2022","118","5","123","2024-12-30"
"79347","2024","COM","2022","1077","20","1097","2024-12-30"
"79348","2024","COM","2022","203","3","206","2024-12-30"
"79349","2024","COM","2022","151","1","152","2024-12-30"
"79350","2024","COM","2022","124","3","127","2024-12-30"
"79351","2024","COM","2022","1800","35","1835","2024-12-30"
"79352","2024","COM","2022","156","5","161","2024-12-30"
"79354","2024","COM","2022","351","11","362","2024-12-30"
"79355","2024","COM","2022","3538","105","3643","2024-12-30"
"79357","2024","COM","2022","238","2","240","2024-12-30"
"80001","2024","COM","2022","22406","391","22797","2024-12-30"
"80002","2024","COM","2022","268","3","271","2024-12-30"
"80003","2024","COM","2022","584","12","596","2024-12-30"
"80004","2024","COM","2022","498","4","502","2024-12-30"
"80005","2024","COM","2022","82","2","84","2024-12-30"
"80006","2024","COM","2022","231","8","239","2024-12-30"
"80008","2024","COM","2022","904","14","918","2024-12-30"
"80009","2024","COM","2022","1021","25","1046","2024-12-30"
"80010","2024","COM","2022","2669","37","2706","2024-12-30"
"80011","2024","COM","2022","2973","24","2997","2024-12-30"
"80013","2024","COM","2022","2227","28","2255","2024-12-30"
"80014","2024","COM","2022","65","0","65","2024-12-30"
"80015","2024","COM","2022","67","2","69","2024-12-30"
"80016","2024","COM","2022","9658","162","9820","2024-12-30"
"80017","2024","COM","2022","419","5","424","2024-12-30"
"80018","2024","COM","2022","252","4","256","2024-12-30"
"80019","2024","COM","2022","826","9","835","2024-12-30"
"80020","2024","COM","2022","777","15","792","2024-12-30"
"80021","2024","COM","2022","134780","2693","137473","2024-12-30"
"80022","2024","COM","2022","244","2","246","2024-12-30"
"80023","2024","COM","2022","285","4","289","2024-12-30"
"80024","2024","COM","2022","562","7","569","2024-12-30"
"80025","2024","COM","2022","324","2","326","2024-12-30"
"80026","2024","COM","2022","32","1","33","2024-12-30"
"80027","2024","COM","2022","33","0","33","2024-12-30"
"80028","2024","COM","2022","154","1","155","2024-12-30"
"80029","2024","COM","2022","825","28","853","2024-12-30"
"80030","2024","COM","2022","218","3","221","2024-12-30"
"80031","2024","COM","2022","764","16","780","2024-12-30"
"80032","2024","COM","2022","134","2","136","2024-12-30"
"80033","2024","COM","2022","310","3","313","2024-12-30"
"80034","2024","COM","2022","613","7","620","2024-12-30"
"80035","2024","COM","2022","72","0","72","2024-12-30"
"80036","2024","COM","2022","516","9","525","2024-12-30"
"80037","2024","COM","2022","167","2","169","2024-12-30"
"80038","2024","COM","2022","124","1","125","2024-12-30"
"80039","2024","COM","2022","1369","15","1384","2024-12-30"
"80040","2024","COM","2022","171","1","172","2024-12-30"
"80041","2024","COM","2022","128","8","136","2024-12-30"
"80042","2024","COM","2022","121","4","125","2024-12-30"
"80043","2024","COM","2022","258","9","267","2024-12-30"
"80044","2024","COM","2022","397","6","403","2024-12-30"
"80045","2024","COM","2022","157","1","158","2024-12-30"
"80046","2024","COM","2022","51","1","52","2024-12-30"
"80047","2024","COM","2022","537","7","544","2024-12-30"
"80048","2024","COM","2022","66","3","69","2024-12-30"
"80049","2024","COM","2022","153","6","159","2024-12-30"
"80050","2024","COM","2022","466","9","475","2024-12-30"
"80051","2024","COM","2022","252","3","255","2024-12-30"
"80052","2024","COM","2022","242","2","244","2024-12-30"
"80053","2024","COM","2022","75","1","76","2024-12-30"
"80054","2024","COM","2022","229","5","234","2024-12-30"
"80055","2024","COM","2022","163","1","164","2024-12-30"
"80056","2024","COM","2022","100","2","102","2024-12-30"
"80057","2024","COM","2022","73","3","76","2024-12-30"
"80058","2024","COM","2022","337","6","343","2024-12-30"
"80059","2024","COM","2022","82","1","83","2024-12-30"
"80060","2024","COM","2022","119","0","119","2024-12-30"
"80061","2024","COM","2022","193","4","197","2024-12-30"
"80062","2024","COM","2022","1421","16","1437","2024-12-30"
"80063","2024","COM","2022","943","16","959","2024-12-30"
"80064","2024","COM","2022","164","2","166","2024-12-30"
"80065","2024","COM","2022","89","3","92","2024-12-30"
"80066","2024","COM","2022","279","4","283","2024-12-30"
"80067","2024","COM","2022","189","2","191","2024-12-30"
"80068","2024","COM","2022","217","3","220","2024-12-30"
"80069","2024","COM","2022","202","0","202","2024-12-30"
"80070","2024","COM","2022","1341","61","1402","2024-12-30"
"80071","2024","COM","2022","1953","18","1971","2024-12-30"
"80073","2024","COM","2022","154","3","157","2024-12-30"
"80074","2024","COM","2022","116","1","117","2024-12-30"
"80076","2024","COM","2022","508","6","514","2024-12-30"
"80077","2024","COM","2022","306","4","310","2024-12-30"
"80078","2024","COM","2022","505","14","519","2024-12-30"
"80079","2024","COM","2022","299","4","303","2024-12-30"
"80080","2024","COM","2022","151","5","156","2024-12-30"
"80081","2024","COM","2022","84","0","84","2024-12-30"
"80082","2024","COM","2022","725","8","733","2024-12-30"
"80083","2024","COM","2022","143","2","145","2024-12-30"
"80084","2024","COM","2022","201","4","205","2024-12-30"
"80085","2024","COM","2022","38","1","39","2024-12-30"
"80086","2024","COM","2022","1047","13","1060","2024-12-30"
"80087","2024","COM","2022","240","7","247","2024-12-30"
"80088","2024","COM","2022","354","5","359","2024-12-30"
"80089","2024","COM","2022","274","0","274","2024-12-30"
"80090","2024","COM","2022","151","4","155","2024-12-30"
"80092","2024","COM","2022","797","7","804","2024-12-30"
"80093","2024","COM","2022","1095","11","1106","2024-12-30"
"80094","2024","COM","2022","497","7","504","2024-12-30"
"80095","2024","COM","2022","212","2","214","2024-12-30"
"80096","2024","COM","2022","897","17","914","2024-12-30"
"80097","2024","COM","2022","126","3","129","2024-12-30"
"80098","2024","COM","2022","96","3","99","2024-12-30"
"80099","2024","COM","2022","215","5","220","2024-12-30"
"80100","2024","COM","2022","612","3","615","2024-12-30"
"80101","2024","COM","2022","880","14","894","2024-12-30"
"80102","2024","COM","2022","386","8","394","2024-12-30"
"80103","2024","COM","2022","58","0","58","2024-12-30"
"80104","2024","COM","2022","142","3","145","2024-12-30"
"80105","2024","COM","2022","174","2","176","2024-12-30"
"80106","2024","COM","2022","165","2","167","2024-12-30"
"80107","2024","COM","2022","623","14","637","2024-12-30"
"80108","2024","COM","2022","66","0","66","2024-12-30"
"80109","2024","COM","2022","330","4","334","2024-12-30"
"80110","2024","COM","2022","457","10","467","2024-12-30"
"80112","2024","COM","2022","248","0","248","2024-12-30"
"80113","2024","COM","2022","331","2","333","2024-12-30"
"80114","2024","COM","2022","346","6","352","2024-12-30"
"80115","2024","COM","2022","287","1","288","2024-12-30"
"80116","2024","COM","2022","266","3","269","2024-12-30"
"80117","2024","COM","2022","158","5","163","2024-12-30"
"80118","2024","COM","2022","115","1","116","2024-12-30"
"80119","2024","COM","2022","395","8","403","2024-12-30"
"80120","2024","COM","2022","538","11","549","2024-12-30"
"80121","2024","COM","2022","144","3","147","2024-12-30"
"80122","2024","COM","2022","496","3","499","2024-12-30"
"80123","2024","COM","2022","374","3","377","2024-12-30"
"80124","2024","COM","2022","715","14","729","2024-12-30"
"80125","2024","COM","2022","82","1","83","2024-12-30"
"80126","2024","COM","2022","929","13","942","2024-12-30"
"80127","2024","COM","2022","800","19","819","2024-12-30"
"80128","2024","COM","2022","147","3","150","2024-12-30"
"80129","2024","COM","2022","536","12","548","2024-12-30"
"80130","2024","COM","2022","419","6","425","2024-12-30"
"80131","2024","COM","2022","3273","52","3325","2024-12-30"
"80132","2024","COM","2022","205","2","207","2024-12-30"
"80133","2024","COM","2022","214","4","218","2024-12-30"
"80134","2024","COM","2022","82","2","84","2024-12-30"
"80135","2024","COM","2022","250","6","256","2024-12-30"
"80136","2024","COM","2022","1191","11","1202","2024-12-30"
"80137","2024","COM","2022","724","6","730","2024-12-30"
"80138","2024","COM","2022","118","1","119","2024-12-30"
"80139","2024","COM","2022","45","0","45","2024-12-30"
"80140","2024","COM","2022","116","1","117","2024-12-30"
"80141","2024","COM","2022","341","8","349","2024-12-30"
"80142","2024","COM","2022","342","2","344","2024-12-30"
"80143","2024","COM","2022","108","0","108","2024-12-30"
"80144","2024","COM","2022","482","5","487","2024-12-30"
"80145","2024","COM","2022","150","3","153","2024-12-30"
"80146","2024","COM","2022","199","3","202","2024-12-30"
"80147","2024","COM","2022","337","7","344","2024-12-30"
"80148","2024","COM","2022","392","6","398","2024-12-30"
"80149","2024","COM","2022","522","11","533","2024-12-30"
"80150","2024","COM","2022","219","2","221","2024-12-30"
"80151","2024","COM","2022","296","4","300","2024-12-30"
"80152","2024","COM","2022","142","1","143","2024-12-30"
"80153","2024","COM","2022","137","1","138","2024-12-30"
"80154","2024","COM","2022","217","7","224","2024-12-30"
"80155","2024","COM","2022","306","6","312","2024-12-30"
"80156","2024","COM","2022","383","7","390","2024-12-30"
"80157","2024","COM","2022","92","5","97","2024-12-30"
"80158","2024","COM","2022","45","1","46","2024-12-30"
"80159","2024","COM","2022","285","5","290","2024-12-30"
"80160","2024","COM","2022","1198","22","1220","2024-12-30"
"80161","2024","COM","2022","221","7","228","2024-12-30"
"80162","2024","COM","2022","699","13","712","2024-12-30"
"80163","2024","COM","2022","751","16","767","2024-12-30"
"80164","2024","COM","2022","4387","56","4443","2024-12-30"
"80165","2024","COM","2022","183","3","186","2024-12-30"
"80166","2024","COM","2022","704","3","707","2024-12-30"
"80167","2024","COM","2022","346","10","356","2024-12-30"
"80168","2024","COM","2022","1046","16","1062","2024-12-30"
"80169","2024","COM","2022","61","0","61","2024-12-30"
"80170","2024","COM","2022","110","1","111","2024-12-30"
"80171","2024","COM","2022","565","15","580","2024-12-30"
"80172","2024","COM","2022","548","5","553","2024-12-30"
"80173","2024","COM","2022","514","6","520","2024-12-30"
"80174","2024","COM","2022","71","3","74","2024-12-30"
"80176","2024","COM","2022","258","4","262","2024-12-30"
"80177","2024","COM","2022","690","21","711","2024-12-30"
"80179","2024","COM","2022","218","3","221","2024-12-30"
"80180","2024","COM","2022","91","2","93","2024-12-30"
"80181","2024","COM","2022","123","0","123","2024-12-30"
"80182","2024","COM","2022","2344","30","2374","2024-12-30"
"80183","2024","COM","2022","277","5","282","2024-12-30"
"80184","2024","COM","2022","545","6","551","2024-12-30"
"80185","2024","COM","2022","279","7","286","2024-12-30"
"80186","2024","COM","2022","1983","27","2010","2024-12-30"
"80187","2024","COM","2022","693","13","706","2024-12-30"
"80188","2024","COM","2022","587","8","595","2024-12-30"
"80189","2024","COM","2022","64","3","67","2024-12-30"
"80190","2024","COM","2022","1212","33","1245","2024-12-30"
"80191","2024","COM","2022","163","5","168","2024-12-30"
"80192","2024","COM","2022","166","1","167","2024-12-30"
"80193","2024","COM","2022","153","2","155","2024-12-30"
"80194","2024","COM","2022","149","1","150","2024-12-30"
"80195","2024","COM","2022","147","2","149","2024-12-30"
"80196","2024","COM","2022","245","8","253","2024-12-30"
"80197","2024","COM","2022","26","0","26","2024-12-30"
"80198","2024","COM","2022","382","3","385","2024-12-30"
"80199","2024","COM","2022","515","10","525","2024-12-30"
"80200","2024","COM","2022","219","4","223","2024-12-30"
"80201","2024","COM","2022","49","2","51","2024-12-30"
"80202","2024","COM","2022","381","4","385","2024-12-30"
"80203","2024","COM","2022","83","1","84","2024-12-30"
"80204","2024","COM","2022","751","9","760","2024-12-30"
"80205","2024","COM","2022","876","10","886","2024-12-30"
"80206","2024","COM","2022","122","2","124","2024-12-30"
"80207","2024","COM","2022","310","4","314","2024-12-30"
"80208","2024","COM","2022","217","5","222","2024-12-30"
"80210","2024","COM","2022","146","2","148","2024-12-30"
"80211","2024","COM","2022","1709","56","1765","2024-12-30"
"80212","2024","COM","2022","6080","87","6167","2024-12-30"
"80213","2024","COM","2022","555","212","767","2024-12-30"
"80214","2024","COM","2022","309","1","310","2024-12-30"
"80215","2024","COM","2022","207","8","215","2024-12-30"
"80216","2024","COM","2022","151","2","153","2024-12-30"
"80217","2024","COM","2022","70","0","70","2024-12-30"
"80218","2024","COM","2022","158","0","158","2024-12-30"
"80219","2024","COM","2022","66","1","67","2024-12-30"
"80220","2024","COM","2022","99","2","101","2024-12-30"
"80221","2024","COM","2022","304","7","311","2024-12-30"
"80222","2024","COM","2022","1352","26","1378","2024-12-30"
"80223","2024","COM","2022","128","6","134","2024-12-30"
"80224","2024","COM","2022","126","2","128","2024-12-30"
"80225","2024","COM","2022","193","4","197","2024-12-30"
"80226","2024","COM","2022","270","9","279","2024-12-30"
"80227","2024","COM","2022","457","8","465","2024-12-30"
"80228","2024","COM","2022","1965","31","1996","2024-12-30"
"80229","2024","COM","2022","373","3","376","2024-12-30"
"80230","2024","COM","2022","293","1","294","2024-12-30"
"80231","2024","COM","2022","159","1","160","2024-12-30"
"80232","2024","COM","2022","222","1","223","2024-12-30"
"80233","2024","COM","2022","152","2","154","2024-12-30"
"80234","2024","COM","2022","755","14","769","2024-12-30"
"80235","2024","COM","2022","1150","18","1168","2024-12-30"
"80236","2024","COM","2022","548","5","553","2024-12-30"
"80237","2024","COM","2022","538","10","548","2024-12-30"
"80238","2024","COM","2022","519","9","528","2024-12-30"
"80239","2024","COM","2022","58","2","60","2024-12-30"
"80240","2024","COM","2022","1394","42","1436","2024-12-30"
"80241","2024","COM","2022","1066","12","1078","2024-12-30"
"80242","2024","COM","2022","404","3","407","2024-12-30"
"80243","2024","COM","2022","44","1","45","2024-12-30"
"80244","2024","COM","2022","170","3","173","2024-12-30"
"80245","2024","COM","2022","292","5","297","2024-12-30"
"80246","2024","COM","2022","342","4","346","2024-12-30"
"80247","2024","COM","2022","714","10","724","2024-12-30"
"80248","2024","COM","2022","423","7","430","2024-12-30"
"80249","2024","COM","2022","305","8","313","2024-12-30"
"80250","2024","COM","2022","341","4","345","2024-12-30"
"80251","2024","COM","2022","378","10","388","2024-12-30"
"80252","2024","COM","2022","250","6","256","2024-12-30"
"80253","2024","COM","2022","5814","164","5978","2024-12-30"
"80256","2024","COM","2022","1582","9","1591","2024-12-30"
"80258","2024","COM","2022","80","1","81","2024-12-30"
"80259","2024","COM","2022","83","0","83","2024-12-30"
"80260","2024","COM","2022","902","29","931","2024-12-30"
"80261","2024","COM","2022","1448","50","1498","2024-12-30"
"80262","2024","COM","2022","363","12","375","2024-12-30"
"80263","2024","COM","2022","45","2","47","2024-12-30"
"80264","2024","COM","2022","86","23","109","2024-12-30"
"80265","2024","COM","2022","561","10","571","2024-12-30"
"80266","2024","COM","2022","292","4","296","2024-12-30"
"80267","2024","COM","2022","247","5","252","2024-12-30"
"80268","2024","COM","2022","515","11","526","2024-12-30"
"80269","2024","COM","2022","107","2","109","2024-12-30"
"80270","2024","COM","2022","7","0","7","2024-12-30"
"80271","2024","COM","2022","1108","11","1119","2024-12-30"
"80272","2024","COM","2022","126","2","128","2024-12-30"
"80273","2024","COM","2022","342","8","350","2024-12-30"
"80274","2024","COM","2022","1719","26","1745","2024-12-30"
"80275","2024","COM","2022","298","3","301","2024-12-30"
"80276","2024","COM","2022","280","3","283","2024-12-30"
"80278","2024","COM","2022","195","5","200","2024-12-30"
"80279","2024","COM","2022","754","8","762","2024-12-30"
"80280","2024","COM","2022","126","1","127","2024-12-30"
"80281","2024","COM","2022","164","6","170","2024-12-30"
"80282","2024","COM","2022","507","3","510","2024-12-30"
"80283","2024","COM","2022","159","0","159","2024-12-30"
"80284","2024","COM","2022","713","32","745","2024-12-30"
"80285","2024","COM","2022","270","2","272","2024-12-30"
"80287","2024","COM","2022","241","4","245","2024-12-30"
"80288","2024","COM","2022","373","1","374","2024-12-30"
"80290","2024","COM","2022","397","7","404","2024-12-30"
"80291","2024","COM","2022","281","3","284","2024-12-30"
"80292","2024","COM","2022","128","8","136","2024-12-30"
"80293","2024","COM","2022","352","3","355","2024-12-30"
"80294","2024","COM","2022","168","3","171","2024-12-30"
"80295","2024","COM","2022","596","10","606","2024-12-30"
"80296","2024","COM","2022","1142","10","1152","2024-12-30"
"80297","2024","COM","2022","41","1","42","2024-12-30"
"80298","2024","COM","2022","525","3","528","2024-12-30"
"80299","2024","COM","2022","215","2","217","2024-12-30"
"80300","2024","COM","2022","162","0","162","2024-12-30"
"80301","2024","COM","2022","277","4","281","2024-12-30"
"80302","2024","COM","2022","173","2","175","2024-12-30"
"80303","2024","COM","2022","454","7","461","2024-12-30"
"80304","2024","COM","2022","93","5","98","2024-12-30"
"80305","2024","COM","2022","483","11","494","2024-12-30"
"80306","2024","COM","2022","134","1","135","2024-12-30"
"80307","2024","COM","2022","157","2","159","2024-12-30"
"80308","2024","COM","2022","2432","43","2475","2024-12-30"
"80310","2024","COM","2022","667","3","670","2024-12-30"
"80311","2024","COM","2022","143","3","146","2024-12-30"
"80312","2024","COM","2022","279","7","286","2024-12-30"
"80313","2024","COM","2022","296","3","299","2024-12-30"
"80314","2024","COM","2022","194","0","194","2024-12-30"
"80315","2024","COM","2022","522","6","528","2024-12-30"
"80316","2024","COM","2022","1956","16","1972","2024-12-30"
"80317","2024","COM","2022","204","3","207","2024-12-30"
"80318","2024","COM","2022","3247","69","3316","2024-12-30"
"80319","2024","COM","2022","320","5","325","2024-12-30"
"80320","2024","COM","2022","154","0","154","2024-12-30"
"80321","2024","COM","2022","142","2","144","2024-12-30"
"80322","2024","COM","2022","169","2","171","2024-12-30"
"80324","2024","COM","2022","142","3","145","2024-12-30"
"80325","2024","COM","2022","56","1","57","2024-12-30"
"80326","2024","COM","2022","98","2","100","2024-12-30"
"80327","2024","COM","2022","159","5","164","2024-12-30"
"80328","2024","COM","2022","505","6","511","2024-12-30"
"80329","2024","COM","2022","165","2","167","2024-12-30"
"80330","2024","COM","2022","231","4","235","2024-12-30"
"80331","2024","COM","2022","314","11","325","2024-12-30"
"80332","2024","COM","2022","389","8","397","2024-12-30"
"80333","2024","COM","2022","1328","12","1340","2024-12-30"
"80334","2024","COM","2022","101","3","104","2024-12-30"
"80335","2024","COM","2022","233","3","236","2024-12-30"
"80336","2024","COM","2022","79","3","82","2024-12-30"
"80337","2024","COM","2022","211","1","212","2024-12-30"
"80338","2024","COM","2022","1762","15","1777","2024-12-30"
"80339","2024","COM","2022","153","5","158","2024-12-30"
"80340","2024","COM","2022","191","1","192","2024-12-30"
"80341","2024","COM","2022","381","6","387","2024-12-30"
"80342","2024","COM","2022","447","9","456","2024-12-30"
"80343","2024","COM","2022","157","2","159","2024-12-30"
"80344","2024","COM","2022","172","7","179","2024-12-30"
"80345","2024","COM","2022","507","4","511","2024-12-30"
"80346","2024","COM","2022","158","1","159","2024-12-30"
"80347","2024","COM","2022","162","2","164","2024-12-30"
"80348","2024","COM","2022","191","4","195","2024-12-30"
"80349","2024","COM","2022","127","2","129","2024-12-30"
"80350","2024","COM","2022","555","3","558","2024-12-30"
"80351","2024","COM","2022","254","3","257","2024-12-30"
"80352","2024","COM","2022","166","2","168","2024-12-30"
"80353","2024","COM","2022","158","1","159","2024-12-30"
"80354","2024","COM","2022","211","3","214","2024-12-30"
"80355","2024","COM","2022","103","2","105","2024-12-30"
"80356","2024","COM","2022","94","5","99","2024-12-30"
"80357","2024","COM","2022","227","6","233","2024-12-30"
"80358","2024","COM","2022","140","2","142","2024-12-30"
"80359","2024","COM","2022","285","9","294","2024-12-30"
"80360","2024","COM","2022","2086","40","2126","2024-12-30"
"80361","2024","COM","2022","70","4","74","2024-12-30"
"80362","2024","COM","2022","297","7","304","2024-12-30"
"80364","2024","COM","2022","692","15","707","2024-12-30"
"80365","2024","COM","2022","179","3","182","2024-12-30"
"80366","2024","COM","2022","469","4","473","2024-12-30"
"80367","2024","COM","2022","176","3","179","2024-12-30"
"80368","2024","COM","2022","4394","103","4497","2024-12-30"
"80369","2024","COM","2022","243","7","250","2024-12-30"
"80371","2024","COM","2022","94","2","96","2024-12-30"
"80372","2024","COM","2022","119","3","122","2024-12-30"
"80373","2024","COM","2022","2421","89","2510","2024-12-30"
"80374","2024","COM","2022","273","7","280","2024-12-30"
"80375","2024","COM","2022","332","7","339","2024-12-30"
"80376","2024","COM","2022","633","5","638","2024-12-30"
"80377","2024","COM","2022","399","4","403","2024-12-30"
"80378","2024","COM","2022","73","1","74","2024-12-30"
"80379","2024","COM","2022","851","1","852","2024-12-30"
"80380","2024","COM","2022","236","5","241","2024-12-30"
"80381","2024","COM","2022","38","1","39","2024-12-30"
"80383","2024","COM","2022","97","0","97","2024-12-30"
"80384","2024","COM","2022","177","1","178","2024-12-30"
"80385","2024","COM","2022","462","8","470","2024-12-30"
"80386","2024","COM","2022","178","2","180","2024-12-30"
"80387","2024","COM","2022","320","5","325","2024-12-30"
"80388","2024","COM","2022","205","2","207","2024-12-30"
"80390","2024","COM","2022","410","5","415","2024-12-30"
"80391","2024","COM","2022","91","1","92","2024-12-30"
"80392","2024","COM","2022","571","9","580","2024-12-30"
"80393","2024","COM","2022","306","7","313","2024-12-30"
"80395","2024","COM","2022","275","6","281","2024-12-30"
"80396","2024","COM","2022","368","4","372","2024-12-30"
"80397","2024","COM","2022","96","2","98","2024-12-30"
"80399","2024","COM","2022","398","6","404","2024-12-30"
"80400","2024","COM","2022","391","5","396","2024-12-30"
"80401","2024","COM","2022","127","1","128","2024-12-30"
"80402","2024","COM","2022","121","3","124","2024-12-30"
"80403","2024","COM","2022","159","2","161","2024-12-30"
"80404","2024","COM","2022","144","2","146","2024-12-30"
"80405","2024","COM","2022","405","3","408","2024-12-30"
"80406","2024","COM","2022","1318","12","1330","2024-12-30"
"80407","2024","COM","2022","141","5","146","2024-12-30"
"80408","2024","COM","2022","325","2","327","2024-12-30"
"80409","2024","COM","2022","140","3","143","2024-12-30"
"80410","2024","COM","2022","4408","80","4488","2024-12-30"
"80411","2024","COM","2022","488","2","490","2024-12-30"
"80412","2024","COM","2022","633","6","639","2024-12-30"
"80413","2024","COM","2022","91","1","92","2024-12-30"
"80414","2024","COM","2022","121","4","125","2024-12-30"
"80415","2024","COM","2022","1024","10","1034","2024-12-30"
"80416","2024","COM","2022","762","10","772","2024-12-30"
"80417","2024","COM","2022","1640","10","1650","2024-12-30"
"80418","2024","COM","2022","86","0","86","2024-12-30"
"80420","2024","COM","2022","172","3","175","2024-12-30"
"80421","2024","COM","2022","300","7","307","2024-12-30"
"80422","2024","COM","2022","543","13","556","2024-12-30"
"80423","2024","COM","2022","375","5","380","2024-12-30"
"80424","2024","COM","2022","559","11","570","2024-12-30"
"80425","2024","COM","2022","107","1","108","2024-12-30"
"80426","2024","COM","2022","440","5","445","2024-12-30"
"80427","2024","COM","2022","365","8","373","2024-12-30"
"80428","2024","COM","2022","129","2","131","2024-12-30"
"80429","2024","COM","2022","192","1","193","2024-12-30"
"80430","2024","COM","2022","181","7","188","2024-12-30"
"80431","2024","COM","2022","757","9","766","2024-12-30"
"80432","2024","COM","2022","192","0","192","2024-12-30"
"80433","2024","COM","2022","40","0","40","2024-12-30"
"80434","2024","COM","2022","187","5","192","2024-12-30"
"80435","2024","COM","2022","49","2","51","2024-12-30"
"80436","2024","COM","2022","523","14","537","2024-12-30"
"80437","2024","COM","2022","107","1","108","2024-12-30"
"80438","2024","COM","2022","521","4","525","2024-12-30"
"80439","2024","COM","2022","162","3","165","2024-12-30"
"80440","2024","COM","2022","152","3","155","2024-12-30"
"80442","2024","COM","2022","1119","10","1129","2024-12-30"
"80443","2024","COM","2022","1641","24","1665","2024-12-30"
"80444","2024","COM","2022","681","14","695","2024-12-30"
"80445","2024","COM","2022","253","3","256","2024-12-30"
"80446","2024","COM","2022","747","17","764","2024-12-30"
"80449","2024","COM","2022","65","2","67","2024-12-30"
"80450","2024","COM","2022","120","2","122","2024-12-30"
"80451","2024","COM","2022","120","2","122","2024-12-30"
"80452","2024","COM","2022","531","1","532","2024-12-30"
"80453","2024","COM","2022","138","1","139","2024-12-30"
"80455","2024","COM","2022","89","1","90","2024-12-30"
"80456","2024","COM","2022","556","9","565","2024-12-30"
"80458","2024","COM","2022","449","10","459","2024-12-30"
"80459","2024","COM","2022","100","0","100","2024-12-30"
"80460","2024","COM","2022","56","1","57","2024-12-30"
"80461","2024","COM","2022","244","1","245","2024-12-30"
"80462","2024","COM","2022","330","9","339","2024-12-30"
"80463","2024","COM","2022","715","12","727","2024-12-30"
"80464","2024","COM","2022","889","21","910","2024-12-30"
"80465","2024","COM","2022","193","2","195","2024-12-30"
"80466","2024","COM","2022","131","3","134","2024-12-30"
"80467","2024","COM","2022","184","1","185","2024-12-30"
"80468","2024","COM","2022","169","1","170","2024-12-30"
"80469","2024","COM","2022","154","1","155","2024-12-30"
"80470","2024","COM","2022","158","1","159","2024-12-30"
"80472","2024","COM","2022","167","5","172","2024-12-30"
"80473","2024","COM","2022","292","2","294","2024-12-30"
"80474","2024","COM","2022","397","4","401","2024-12-30"
"80475","2024","COM","2022","212","6","218","2024-12-30"
"80476","2024","COM","2022","332","4","336","2024-12-30"
"80477","2024","COM","2022","222","2","224","2024-12-30"
"80478","2024","COM","2022","146","3","149","2024-12-30"
"80479","2024","COM","2022","344","4","348","2024-12-30"
"80480","2024","COM","2022","112","3","115","2024-12-30"
"80481","2024","COM","2022","461","6","467","2024-12-30"
"80482","2024","COM","2022","141","2","143","2024-12-30"
"80484","2024","COM","2022","385","3","388","2024-12-30"
"80485","2024","COM","2022","1153","12","1165","2024-12-30"
"80486","2024","COM","2022","599","8","607","2024-12-30"
"80487","2024","COM","2022","72","2","74","2024-12-30"
"80488","2024","COM","2022","1520","28","1548","2024-12-30"
"80489","2024","COM","2022","5726","41","5767","2024-12-30"
"80490","2024","COM","2022","285","2","287","2024-12-30"
"80491","2024","COM","2022","70","0","70","2024-12-30"
"80493","2024","COM","2022","295","3","298","2024-12-30"
"80494","2024","COM","2022","198","3","201","2024-12-30"
"80495","2024","COM","2022","521","4","525","2024-12-30"
"80496","2024","COM","2022","151","2","153","2024-12-30"
"80497","2024","COM","2022","118","4","122","2024-12-30"
"80498","2024","COM","2022","638","6","644","2024-12-30"
"80499","2024","COM","2022","303","5","308","2024-12-30"
"80500","2024","COM","2022","477","7","484","2024-12-30"
"80501","2024","COM","2022","285","4","289","2024-12-30"
"80502","2024","COM","2022","98","1","99","2024-12-30"
"80503","2024","COM","2022","187","2","189","2024-12-30"
"80504","2024","COM","2022","73","2","75","2024-12-30"
"80505","2024","COM","2022","268","5","273","2024-12-30"
"80507","2024","COM","2022","1293","17","1310","2024-12-30"
"80508","2024","COM","2022","50","0","50","2024-12-30"
"80509","2024","COM","2022","580","10","590","2024-12-30"
"80511","2024","COM","2022","116","2","118","2024-12-30"
"80512","2024","COM","2022","828","9","837","2024-12-30"
"80513","2024","COM","2022","179","3","182","2024-12-30"
"80514","2024","COM","2022","130","1","131","2024-12-30"
"80515","2024","COM","2022","148","2","150","2024-12-30"
"80516","2024","COM","2022","189","5","194","2024-12-30"
"80517","2024","COM","2022","187","3","190","2024-12-30"
"80518","2024","COM","2022","421","5","426","2024-12-30"
"80519","2024","COM","2022","499","7","506","2024-12-30"
"80520","2024","COM","2022","202","3","205","2024-12-30"
"80521","2024","COM","2022","223","1","224","2024-12-30"
"80522","2024","COM","2022","108","2","110","2024-12-30"
"80523","2024","COM","2022","1276","25","1301","2024-12-30"
"80524","2024","COM","2022","551","5","556","2024-12-30"
"80525","2024","COM","2022","179","3","182","2024-12-30"
"80526","2024","COM","2022","153","1","154","2024-12-30"
"80527","2024","COM","2022","303","10","313","2024-12-30"
"80528","2024","COM","2022","9","0","9","2024-12-30"
"80529","2024","COM","2022","187","3","190","2024-12-30"
"80530","2024","COM","2022","595","11","606","2024-12-30"
"80531","2024","COM","2022","104","0","104","2024-12-30"
"80533","2024","COM","2022","2536","54","2590","2024-12-30"
"80535","2024","COM","2022","148","6","154","2024-12-30"
"80536","2024","COM","2022","289","2","291","2024-12-30"
"80537","2024","COM","2022","89","2","91","2024-12-30"
"80538","2024","COM","2022","107","2","109","2024-12-30"
"80540","2024","COM","2022","237","4","241","2024-12-30"
"80541","2024","COM","2022","211","5","216","2024-12-30"
"80542","2024","COM","2022","563","10","573","2024-12-30"
"80543","2024","COM","2022","120","7","127","2024-12-30"
"80544","2024","COM","2022","182","3","185","2024-12-30"
"80545","2024","COM","2022","527","7","534","2024-12-30"
"80546","2024","COM","2022","602","12","614","2024-12-30"
"80547","2024","COM","2022","203","1","204","2024-12-30"
"80548","2024","COM","2022","343","7","350","2024-12-30"
"80549","2024","COM","2022","630","8","638","2024-12-30"
"80550","2024","COM","2022","120","4","124","2024-12-30"
"80552","2024","COM","2022","1118","23","1141","2024-12-30"
"80553","2024","COM","2022","345","5","350","2024-12-30"
"80554","2024","COM","2022","924","7","931","2024-12-30"
"80555","2024","COM","2022","574","17","591","2024-12-30"
"80556","2024","COM","2022","578","11","589","2024-12-30"
"80557","2024","COM","2022","594","11","605","2024-12-30"
"80558","2024","COM","2022","217","5","222","2024-12-30"
"80559","2024","COM","2022","145","4","149","2024-12-30"
"80560","2024","COM","2022","216","1","217","2024-12-30"
"80561","2024","COM","2022","5978","98","6076","2024-12-30"
"80562","2024","COM","2022","185","4","189","2024-12-30"
"80563","2024","COM","2022","101","1","102","2024-12-30"
"80565","2024","COM","2022","86","0","86","2024-12-30"
"80566","2024","COM","2022","346","6","352","2024-12-30"
"80568","2024","COM","2022","359","5","364","2024-12-30"
"80569","2024","COM","2022","330","2","332","2024-12-30"
"80570","2024","COM","2022","3968","38","4006","2024-12-30"
"80571","2024","COM","2022","475","10","485","2024-12-30"
"80572","2024","COM","2022","378","7","385","2024-12-30"
"80573","2024","COM","2022","376","9","385","2024-12-30"
"80574","2024","COM","2022","96","1","97","2024-12-30"
"80575","2024","COM","2022","73","7","80","2024-12-30"
"80576","2024","COM","2022","330","0","330","2024-12-30"
"80577","2024","COM","2022","165","2","167","2024-12-30"
"80578","2024","COM","2022","701","11","712","2024-12-30"
"80579","2024","COM","2022","790","9","799","2024-12-30"
"80580","2024","COM","2022","265","2","267","2024-12-30"
"80582","2024","COM","2022","1014","13","1027","2024-12-30"
"80583","2024","COM","2022","281","4","285","2024-12-30"
"80584","2024","COM","2022","1055","20","1075","2024-12-30"
"80585","2024","COM","2022","2296","21","2317","2024-12-30"
"80586","2024","COM","2022","172","0","172","2024-12-30"
"80587","2024","COM","2022","89","3","92","2024-12-30"
"80588","2024","COM","2022","363","8","371","2024-12-30"
"80589","2024","COM","2022","103","1","104","2024-12-30"
"80590","2024","COM","2022","328","5","333","2024-12-30"
"80591","2024","COM","2022","146","4","150","2024-12-30"
"80592","2024","COM","2022","511","10","521","2024-12-30"
"80593","2024","COM","2022","260","7","267","2024-12-30"
"80595","2024","COM","2022","279","6","285","2024-12-30"
"80596","2024","COM","2022","214","9","223","2024-12-30"
"80597","2024","COM","2022","828","16","844","2024-12-30"
"80598","2024","COM","2022","1207","37","1244","2024-12-30"
"80599","2024","COM","2022","243","4","247","2024-12-30"
"80600","2024","COM","2022","641","10","651","2024-12-30"
"80601","2024","COM","2022","370","4","374","2024-12-30"
"80602","2024","COM","2022","124","1","125","2024-12-30"
"80603","2024","COM","2022","320","3","323","2024-12-30"
"80604","2024","COM","2022","86","2","88","2024-12-30"
"80605","2024","COM","2022","199","5","204","2024-12-30"
"80606","2024","COM","2022","1134","45","1179","2024-12-30"
"80607","2024","COM","2022","207","5","212","2024-12-30"
"80609","2024","COM","2022","445","4","449","2024-12-30"
"80611","2024","COM","2022","978","13","991","2024-12-30"
"80613","2024","COM","2022","612","16","628","2024-12-30"
"80614","2024","COM","2022","320","8","328","2024-12-30"
"80615","2024","COM","2022","428","3","431","2024-12-30"
"80616","2024","COM","2022","196","1","197","2024-12-30"
"80617","2024","COM","2022","236","3","239","2024-12-30"
"80618","2024","COM","2022","1035","17","1052","2024-12-30"
"80619","2024","COM","2022","699","9","708","2024-12-30"
"80620","2024","COM","2022","7139","176","7315","2024-12-30"
"80621","2024","COM","2022","686","10","696","2024-12-30"
"80622","2024","COM","2022","1275","13","1288","2024-12-30"
"80623","2024","COM","2022","385","7","392","2024-12-30"
"80624","2024","COM","2022","282","6","288","2024-12-30"
"80625","2024","COM","2022","1484","19","1503","2024-12-30"
"80626","2024","COM","2022","290","2","292","2024-12-30"
"80627","2024","COM","2022","863","21","884","2024-12-30"
"80628","2024","COM","2022","765","7","772","2024-12-30"
"80629","2024","COM","2022","104","3","107","2024-12-30"
"80630","2024","COM","2022","2293","30","2323","2024-12-30"
"80631","2024","COM","2022","117","2","119","2024-12-30"
"80632","2024","COM","2022","2440","35","2475","2024-12-30"
"80633","2024","COM","2022","584","14","598","2024-12-30"
"80634","2024","COM","2022","815","15","830","2024-12-30"
"80635","2024","COM","2022","1467","20","1487","2024-12-30"
"80637","2024","COM","2022","268","4","272","2024-12-30"
"80638","2024","COM","2022","111","6","117","2024-12-30"
"80639","2024","COM","2022","1310","20","1330","2024-12-30"
"80640","2024","COM","2022","262","0","262","2024-12-30"
"80642","2024","COM","2022","312","3","315","2024-12-30"
"80643","2024","COM","2022","571","6","577","2024-12-30"
"80644","2024","COM","2022","762","4","766","2024-12-30"
"80645","2024","COM","2022","561","3","564","2024-12-30"
"80646","2024","COM","2022","79","1","80","2024-12-30"
"80647","2024","COM","2022","279","3","282","2024-12-30"
"80648","2024","COM","2022","126","0","126","2024-12-30"
"80649","2024","COM","2022","1280","27","1307","2024-12-30"
"80650","2024","COM","2022","621","11","632","2024-12-30"
"80651","2024","COM","2022","243","4","247","2024-12-30"
"80652","2024","COM","2022","780","8","788","2024-12-30"
"80654","2024","COM","2022","525","19","544","2024-12-30"
"80655","2024","COM","2022","421","8","429","2024-12-30"
"80656","2024","COM","2022","1106","8","1114","2024-12-30"
"80657","2024","COM","2022","313","5","318","2024-12-30"
"80658","2024","COM","2022","144","3","147","2024-12-30"
"80659","2024","COM","2022","262","6","268","2024-12-30"
"80661","2024","COM","2022","1085","12","1097","2024-12-30"
"80662","2024","COM","2022","260","7","267","2024-12-30"
"80663","2024","COM","2022","374","8","382","2024-12-30"
"80664","2024","COM","2022","189","2","191","2024-12-30"
"80665","2024","COM","2022","130","3","133","2024-12-30"
"80666","2024","COM","2022","30","0","30","2024-12-30"
"80667","2024","COM","2022","136","2","138","2024-12-30"
"80668","2024","COM","2022","172","6","178","2024-12-30"
"80669","2024","COM","2022","341","7","348","2024-12-30"
"80670","2024","COM","2022","518","11","529","2024-12-30"
"80671","2024","COM","2022","226","7","233","2024-12-30"
"80672","2024","COM","2022","619","12","631","2024-12-30"
"80673","2024","COM","2022","183","1","184","2024-12-30"
"80674","2024","COM","2022","3609","25","3634","2024-12-30"
"80675","2024","COM","2022","143","3","146","2024-12-30"
"80676","2024","COM","2022","153","1","154","2024-12-30"
"80677","2024","COM","2022","1609","21","1630","2024-12-30"
"80678","2024","COM","2022","768","18","786","2024-12-30"
"80679","2024","COM","2022","578","8","586","2024-12-30"
"80680","2024","COM","2022","2928","18","2946","2024-12-30"
"80681","2024","COM","2022","303","8","311","2024-12-30"
"80682","2024","COM","2022","209","6","215","2024-12-30"
"80683","2024","COM","2022","100","0","100","2024-12-30"
"80684","2024","COM","2022","103","2","105","2024-12-30"
"80685","2024","COM","2022","5748","75","5823","2024-12-30"
"80686","2024","COM","2022","723","10","733","2024-12-30"
"80687","2024","COM","2022","135","2","137","2024-12-30"
"80688","2024","COM","2022","3050","92","3142","2024-12-30"
"80690","2024","COM","2022","623","8","631","2024-12-30"
"80691","2024","COM","2022","336","10","346","2024-12-30"
"80692","2024","COM","2022","1014","17","1031","2024-12-30"
"80693","2024","COM","2022","337","1","338","2024-12-30"
"80694","2024","COM","2022","350","5","355","2024-12-30"
"80695","2024","COM","2022","478","9","487","2024-12-30"
"80696","2024","COM","2022","1200","37","1237","2024-12-30"
"80697","2024","COM","2022","36","0","36","2024-12-30"
"80698","2024","COM","2022","217","4","221","2024-12-30"
"80699","2024","COM","2022","116","2","118","2024-12-30"
"80700","2024","COM","2022","884","23","907","2024-12-30"
"80701","2024","COM","2022","429","9","438","2024-12-30"
"80702","2024","COM","2022","1418","28","1446","2024-12-30"
"80703","2024","COM","2022","219","5","224","2024-12-30"
"80704","2024","COM","2022","386","6","392","2024-12-30"
"80705","2024","COM","2022","73","1","74","2024-12-30"
"80706","2024","COM","2022","1813","10","1823","2024-12-30"
"80707","2024","COM","2022","78","2","80","2024-12-30"
"80708","2024","COM","2022","157","1","158","2024-12-30"
"80709","2024","COM","2022","280","7","287","2024-12-30"
"80710","2024","COM","2022","389","6","395","2024-12-30"
"80711","2024","COM","2022","1775","9","1784","2024-12-30"
"80713","2024","COM","2022","295","7","302","2024-12-30"
"80714","2024","COM","2022","1265","34","1299","2024-12-30"
"80716","2024","COM","2022","1268","14","1282","2024-12-30"
"80717","2024","COM","2022","981","14","995","2024-12-30"
"80718","2024","COM","2022","1336","9","1345","2024-12-30"
"80719","2024","COM","2022","48","4","52","2024-12-30"
"80721","2024","COM","2022","2350","29","2379","2024-12-30"
"80722","2024","COM","2022","503","8","511","2024-12-30"
"80723","2024","COM","2022","251","5","256","2024-12-30"
"80724","2024","COM","2022","2767","26","2793","2024-12-30"
"80725","2024","COM","2022","4188","58","4246","2024-12-30"
"80726","2024","COM","2022","268","5","273","2024-12-30"
"80728","2024","COM","2022","79","0","79","2024-12-30"
"80729","2024","COM","2022","184","0","184","2024-12-30"
"80730","2024","COM","2022","1086","8","1094","2024-12-30"
"80732","2024","COM","2022","629","16","645","2024-12-30"
"80733","2024","COM","2022","320","3","323","2024-12-30"
"80734","2024","COM","2022","212","2","214","2024-12-30"
"80735","2024","COM","2022","169","2","171","2024-12-30"
"80736","2024","COM","2022","233","5","238","2024-12-30"
"80737","2024","COM","2022","162","2","164","2024-12-30"
"80738","2024","COM","2022","125","2","127","2024-12-30"
"80740","2024","COM","2022","308","8","316","2024-12-30"
"80741","2024","COM","2022","189","5","194","2024-12-30"
"80742","2024","COM","2022","77","2","79","2024-12-30"
"80743","2024","COM","2022","191","4","195","2024-12-30"
"80744","2024","COM","2022","57","1","58","2024-12-30"
"80746","2024","COM","2022","1084","20","1104","2024-12-30"
"80747","2024","COM","2022","135","4","139","2024-12-30"
"80748","2024","COM","2022","196","3","199","2024-12-30"
"80749","2024","COM","2022","323","4","327","2024-12-30"
"80750","2024","COM","2022","143","4","147","2024-12-30"
"80751","2024","COM","2022","562","9","571","2024-12-30"
"80752","2024","COM","2022","666","6","672","2024-12-30"
"80753","2024","COM","2022","127","2","129","2024-12-30"
"80754","2024","COM","2022","382","9","391","2024-12-30"
"80755","2024","COM","2022","140","1","141","2024-12-30"
"80756","2024","COM","2022","57","1","58","2024-12-30"
"80757","2024","COM","2022","146","1","147","2024-12-30"
"80758","2024","COM","2022","208","2","210","2024-12-30"
"80759","2024","COM","2022","327","3","330","2024-12-30"
"80760","2024","COM","2022","361","9","370","2024-12-30"
"80762","2024","COM","2022","337","4","341","2024-12-30"
"80763","2024","COM","2022","339","8","347","2024-12-30"
"80764","2024","COM","2022","304","7","311","2024-12-30"
"80765","2024","COM","2022","805","18","823","2024-12-30"
"80766","2024","COM","2022","426","2","428","2024-12-30"
"80767","2024","COM","2022","234","5","239","2024-12-30"
"80769","2024","COM","2022","219","0","219","2024-12-30"
"80770","2024","COM","2022","544","9","553","2024-12-30"
"80771","2024","COM","2022","30","0","30","2024-12-30"
"80773","2024","COM","2022","102","1","103","2024-12-30"
"80774","2024","COM","2022","289","3","292","2024-12-30"
"80775","2024","COM","2022","638","10","648","2024-12-30"
"80776","2024","COM","2022","221","0","221","2024-12-30"
"80777","2024","COM","2022","135","1","136","2024-12-30"
"80778","2024","COM","2022","121","4","125","2024-12-30"
"80779","2024","COM","2022","809","22","831","2024-12-30"
"80780","2024","COM","2022","415","5","420","2024-12-30"
"80781","2024","COM","2022","218","5","223","2024-12-30"
"80782","2024","COM","2022","440","6","446","2024-12-30"
"80783","2024","COM","2022","80","0","80","2024-12-30"
"80784","2024","COM","2022","272","2","274","2024-12-30"
"80785","2024","COM","2022","540","9","549","2024-12-30"
"80786","2024","COM","2022","141","3","144","2024-12-30"
"80787","2024","COM","2022","97","1","98","2024-12-30"
"80788","2024","COM","2022","178","2","180","2024-12-30"
"80789","2024","COM","2022","150","1","151","2024-12-30"
"80790","2024","COM","2022","167","3","170","2024-12-30"
"80791","2024","COM","2022","862","8","870","2024-12-30"
"80792","2024","COM","2022","242","4","246","2024-12-30"
"80793","2024","COM","2022","2280","32","2312","2024-12-30"
"80794","2024","COM","2022","47","0","47","2024-12-30"
"80795","2024","COM","2022","464","40","504","2024-12-30"
"80796","2024","COM","2022","175","4","179","2024-12-30"
"80797","2024","COM","2022","145","4","149","2024-12-30"
"80798","2024","COM","2022","1509","54","1563","2024-12-30"
"80799","2024","COM","2022","4644","46","4690","2024-12-30"
"80800","2024","COM","2022","138","8","146","2024-12-30"
"80801","2024","COM","2022","300","4","304","2024-12-30"
"80802","2024","COM","2022","541","5","546","2024-12-30"
"80803","2024","COM","2022","281","0","281","2024-12-30"
"80804","2024","COM","2022","174","2","176","2024-12-30"
"80805","2024","COM","2022","158","4","162","2024-12-30"
"80806","2024","COM","2022","460","7","467","2024-12-30"
"80807","2024","COM","2022","274","3","277","2024-12-30"
"80808","2024","COM","2022","507","9","516","2024-12-30"
"80809","2024","COM","2022","473","12","485","2024-12-30"
"80810","2024","COM","2022","135","1","136","2024-12-30"
"80811","2024","COM","2022","592","3","595","2024-12-30"
"80812","2024","COM","2022","132","2","134","2024-12-30"
"80813","2024","COM","2022","95","1","96","2024-12-30"
"80814","2024","COM","2022","457","9","466","2024-12-30"
"80815","2024","COM","2022","835","14","849","2024-12-30"
"80819","2024","COM","2022","78","2","80","2024-12-30"
"80820","2024","COM","2022","749","10","759","2024-12-30"
"80821","2024","COM","2022","227","2","229","2024-12-30"
"80822","2024","COM","2022","136","7","143","2024-12-30"
"80823","2024","COM","2022","122","8","130","2024-12-30"
"80824","2024","COM","2022","252","3","255","2024-12-30"
"80825","2024","COM","2022","105","1","106","2024-12-30"
"80826","2024","COM","2022","751","13","764","2024-12-30"
"80827","2024","COM","2022","1276","12","1288","2024-12-30"
"80828","2024","COM","2022","47","1","48","2024-12-30"
"80829","2024","COM","2022","88","1","89","2024-12-30"
"80830","2024","COM","2022","247","3","250","2024-12-30"
"80832","2024","COM","2022","298","5","303","2024-12-30"
"80833","2024","COM","2022","126","2","128","2024-12-30"
"80834","2024","COM","2022","509","42","551","2024-12-30"
"80835","2024","COM","2022","267","0","267","2024-12-30"
"80836","2024","COM","2022","240","8","248","2024-12-30"
"81001","2024","COM","2022","237","5","242","2024-12-30"
"81002","2024","COM","2022","2507","50","2557","2024-12-30"
"81003","2024","COM","2022","949","26","975","2024-12-30"
"81004","2024","COM","2022","50605","1530","52135","2024-12-30"
"81005","2024","COM","2022","512","5","517","2024-12-30"
"81006","2024","COM","2022","213","4","217","2024-12-30"
"81007","2024","COM","2022","97","2","99","2024-12-30"
"81008","2024","COM","2022","294","8","302","2024-12-30"
"81009","2024","COM","2022","64","0","64","2024-12-30"
"81010","2024","COM","2022","470","7","477","2024-12-30"
"81011","2024","COM","2022","1031","42","1073","2024-12-30"
"81012","2024","COM","2022","123","4","127","2024-12-30"
"81013","2024","COM","2022","391","7","398","2024-12-30"
"81014","2024","COM","2022","517","11","528","2024-12-30"
"81015","2024","COM","2022","69","0","69","2024-12-30"
"81016","2024","COM","2022","178","2","180","2024-12-30"
"81017","2024","COM","2022","128","2","130","2024-12-30"
"81018","2024","COM","2022","2528","54","2582","2024-12-30"
"81019","2024","COM","2022","151","4","155","2024-12-30"
"81020","2024","COM","2022","263","12","275","2024-12-30"
"81021","2024","COM","2022","5617","101","5718","2024-12-30"
"81022","2024","COM","2022","211","4","215","2024-12-30"
"81023","2024","COM","2022","206","6","212","2024-12-30"
"81024","2024","COM","2022","376","7","383","2024-12-30"
"81025","2024","COM","2022","226","5","231","2024-12-30"
"81026","2024","COM","2022","695","13","708","2024-12-30"
"81027","2024","COM","2022","165","2","167","2024-12-30"
"81028","2024","COM","2022","113","1","114","2024-12-30"
"81029","2024","COM","2022","185","7","192","2024-12-30"
"81030","2024","COM","2022","108","2","110","2024-12-30"
"81031","2024","COM","2022","901","18","919","2024-12-30"
"81032","2024","COM","2022","1101","18","1119","2024-12-30"
"81033","2024","COM","2022","2920","184","3104","2024-12-30"
"81034","2024","COM","2022","392","11","403","2024-12-30"
"81035","2024","COM","2022","237","9","246","2024-12-30"
"81036","2024","COM","2022","1249","32","1281","2024-12-30"
"81037","2024","COM","2022","1293","31","1324","2024-12-30"
"81038","2024","COM","2022","2418","69","2487","2024-12-30"
"81039","2024","COM","2022","1948","32","1980","2024-12-30"
"81040","2024","COM","2022","439","7","446","2024-12-30"
"81041","2024","COM","2022","106","1","107","2024-12-30"
"81042","2024","COM","2022","2010","43","2053","2024-12-30"
"81043","2024","COM","2022","719","12","731","2024-12-30"
"81044","2024","COM","2022","309","7","316","2024-12-30"
"81045","2024","COM","2022","366","9","375","2024-12-30"
"81046","2024","COM","2022","1540","43","1583","2024-12-30"
"81047","2024","COM","2022","218","4","222","2024-12-30"
"81048","2024","COM","2022","2607","38","2645","2024-12-30"
"81049","2024","COM","2022","360","5","365","2024-12-30"
"81050","2024","COM","2022","355","12","367","2024-12-30"
"81051","2024","COM","2022","1214","18","1232","2024-12-30"
"81052","2024","COM","2022","2128","59","2187","2024-12-30"
"81053","2024","COM","2022","338","3","341","2024-12-30"
"81054","2024","COM","2022","972","27","999","2024-12-30"
"81055","2024","COM","2022","398","4","402","2024-12-30"
"81056","2024","COM","2022","159","3","162","2024-12-30"
"81058","2024","COM","2022","241","7","248","2024-12-30"
"81059","2024","COM","2022","659","14","673","2024-12-30"
"81060","2024","COM","2022","9927","158","10085","2024-12-30"
"81061","2024","COM","2022","199","2","201","2024-12-30"
"81062","2024","COM","2022","954","11","965","2024-12-30"
"81063","2024","COM","2022","1615","34","1649","2024-12-30"
"81064","2024","COM","2022","1055","19","1074","2024-12-30"
"81065","2024","COM","2022","42700","1357","44057","2024-12-30"
"81066","2024","COM","2022","288","5","293","2024-12-30"
"81067","2024","COM","2022","462","16","478","2024-12-30"
"81068","2024","COM","2022","197","4","201","2024-12-30"
"81069","2024","COM","2022","847","35","882","2024-12-30"
"81070","2024","COM","2022","3041","57","3098","2024-12-30"
"81071","2024","COM","2022","80","3","83","2024-12-30"
"81072","2024","COM","2022","101","2","103","2024-12-30"
"81073","2024","COM","2022","181","3","184","2024-12-30"
"81074","2024","COM","2022","1622","57","1679","2024-12-30"
"81075","2024","COM","2022","488","9","497","2024-12-30"
"81076","2024","COM","2022","709","21","730","2024-12-30"
"81077","2024","COM","2022","393","5","398","2024-12-30"
"81078","2024","COM","2022","1067","17","1084","2024-12-30"
"81079","2024","COM","2022","845","32","877","2024-12-30"
"81080","2024","COM","2022","59","2","61","2024-12-30"
"81081","2024","COM","2022","1310","22","1332","2024-12-30"
"81082","2024","COM","2022","116","3","119","2024-12-30"
"81083","2024","COM","2022","253","5","258","2024-12-30"
"81084","2024","COM","2022","611","17","628","2024-12-30"
"81085","2024","COM","2022","40","1","41","2024-12-30"
"81086","2024","COM","2022","155","2","157","2024-12-30"
"81087","2024","COM","2022","359","4","363","2024-12-30"
"81088","2024","COM","2022","604","11","615","2024-12-30"
"81089","2024","COM","2022","137","3","140","2024-12-30"
"81090","2024","COM","2022","247","4","251","2024-12-30"
"81092","2024","COM","2022","927","25","952","2024-12-30"
"81093","2024","COM","2022","735","29","764","2024-12-30"
"81094","2024","COM","2022","91","5","96","2024-12-30"
"81095","2024","COM","2022","79","1","80","2024-12-30"
"81096","2024","COM","2022","420","6","426","2024-12-30"
"81097","2024","COM","2022","1313","34","1347","2024-12-30"
"81098","2024","COM","2022","721","21","742","2024-12-30"
"81099","2024","COM","2022","16080","355","16435","2024-12-30"
"81100","2024","COM","2022","399","10","409","2024-12-30"
"81101","2024","COM","2022","1292","18","1310","2024-12-30"
"81102","2024","COM","2022","317","6","323","2024-12-30"
"81103","2024","COM","2022","122","4","126","2024-12-30"
"81104","2024","COM","2022","1543","49","1592","2024-12-30"
"81105","2024","COM","2022","13275","208","13483","2024-12-30"
"81106","2024","COM","2022","641","11","652","2024-12-30"
"81108","2024","COM","2022","178","1","179","2024-12-30"
"81109","2024","COM","2022","443","7","450","2024-12-30"
"81110","2024","COM","2022","100","4","104","2024-12-30"
"81111","2024","COM","2022","73","0","73","2024-12-30"
"81112","2024","COM","2022","963","25","988","2024-12-30"
"81114","2024","COM","2022","538","7","545","2024-12-30"
"81115","2024","COM","2022","1418","16","1434","2024-12-30"
"81116","2024","COM","2022","1985","54","2039","2024-12-30"
"81117","2024","COM","2022","726","22","748","2024-12-30"
"81118","2024","COM","2022","167","4","171","2024-12-30"
"81119","2024","COM","2022","508","6","514","2024-12-30"
"81120","2024","COM","2022","6567","116","6683","2024-12-30"
"81121","2024","COM","2022","289","1","290","2024-12-30"
"81122","2024","COM","2022","69","3","72","2024-12-30"
"81123","2024","COM","2022","90","4","94","2024-12-30"
"81124","2024","COM","2022","2469","77","2546","2024-12-30"
"81125","2024","COM","2022","317","7","324","2024-12-30"
"81126","2024","COM","2022","178","8","186","2024-12-30"
"81127","2024","COM","2022","100","7","107","2024-12-30"
"81128","2024","COM","2022","1533","34","1567","2024-12-30"
"81129","2024","COM","2022","232","7","239","2024-12-30"
"81130","2024","COM","2022","1786","37","1823","2024-12-30"
"81131","2024","COM","2022","2275","48","2323","2024-12-30"
"81132","2024","COM","2022","835","11","846","2024-12-30"
"81133","2024","COM","2022","510","13","523","2024-12-30"
"81134","2024","COM","2022","55","0","55","2024-12-30"
"81135","2024","COM","2022","93","1","94","2024-12-30"
"81136","2024","COM","2022","161","4","165","2024-12-30"
"81137","2024","COM","2022","88","1","89","2024-12-30"
"81138","2024","COM","2022","575","9","584","2024-12-30"
"81139","2024","COM","2022","1690","51","1741","2024-12-30"
"81140","2024","COM","2022","10884","341","11225","2024-12-30"
"81141","2024","COM","2022","161","6","167","2024-12-30"
"81142","2024","COM","2022","883","13","896","2024-12-30"
"81143","2024","COM","2022","774","14","788","2024-12-30"
"81144","2024","COM","2022","4585","92","4677","2024-12-30"
"81145","2024","COM","2022","4857","99","4956","2024-12-30"
"81146","2024","COM","2022","239","6","245","2024-12-30"
"81147","2024","COM","2022","1090","29","1119","2024-12-30"
"81148","2024","COM","2022","94","1","95","2024-12-30"
"81149","2024","COM","2022","448","13","461","2024-12-30"
"81150","2024","COM","2022","420","13","433","2024-12-30"
"81151","2024","COM","2022","135","3","138","2024-12-30"
"81152","2024","COM","2022","309","5","314","2024-12-30"
"81154","2024","COM","2022","82","1","83","2024-12-30"
"81156","2024","COM","2022","3486","72","3558","2024-12-30"
"81157","2024","COM","2022","311","10","321","2024-12-30"
"81158","2024","COM","2022","253","6","259","2024-12-30"
"81159","2024","COM","2022","493","25","518","2024-12-30"
"81160","2024","COM","2022","346","8","354","2024-12-30"
"81161","2024","COM","2022","113","2","115","2024-12-30"
"81162","2024","COM","2022","139","2","141","2024-12-30"
"81163","2024","COM","2022","10123","413","10536","2024-12-30"
"81164","2024","COM","2022","531","12","543","2024-12-30"
"81165","2024","COM","2022","231","7","238","2024-12-30"
"81166","2024","COM","2022","99","2","101","2024-12-30"
"81167","2024","COM","2022","107","1","108","2024-12-30"
"81168","2024","COM","2022","1031","17","1048","2024-12-30"
"81169","2024","COM","2022","98","1","99","2024-12-30"
"81170","2024","COM","2022","1385","17","1402","2024-12-30"
"81171","2024","COM","2022","1547","30","1577","2024-12-30"
"81172","2024","COM","2022","59","1","60","2024-12-30"
"81173","2024","COM","2022","315","10","325","2024-12-30"
"81174","2024","COM","2022","613","10","623","2024-12-30"
"81175","2024","COM","2022","394","5","399","2024-12-30"
"81176","2024","COM","2022","109","5","114","2024-12-30"
"81177","2024","COM","2022","468","16","484","2024-12-30"
"81178","2024","COM","2022","361","9","370","2024-12-30"
"81179","2024","COM","2022","274","8","282","2024-12-30"
"81180","2024","COM","2022","266","3","269","2024-12-30"
"81181","2024","COM","2022","186","6","192","2024-12-30"
"81182","2024","COM","2022","2080","43","2123","2024-12-30"
"81183","2024","COM","2022","192","2","194","2024-12-30"
"81184","2024","COM","2022","34","0","34","2024-12-30"
"81185","2024","COM","2022","243","3","246","2024-12-30"
"81186","2024","COM","2022","255","8","263","2024-12-30"
"81187","2024","COM","2022","216","5","221","2024-12-30"
"81188","2024","COM","2022","304","5","309","2024-12-30"
"81189","2024","COM","2022","117","3","120","2024-12-30"
"81190","2024","COM","2022","494","10","504","2024-12-30"
"81191","2024","COM","2022","249","8","257","2024-12-30"
"81192","2024","COM","2022","851","18","869","2024-12-30"
"81193","2024","COM","2022","345","4","349","2024-12-30"
"81195","2024","COM","2022","690","17","707","2024-12-30"
"81196","2024","COM","2022","835","14","849","2024-12-30"
"81197","2024","COM","2022","207","2","209","2024-12-30"
"81198","2024","COM","2022","337","5","342","2024-12-30"
"81199","2024","COM","2022","154","3","157","2024-12-30"
"81200","2024","COM","2022","447","43","490","2024-12-30"
"81201","2024","COM","2022","959","20","979","2024-12-30"
"81202","2024","COM","2022","1009","22","1031","2024-12-30"
"81203","2024","COM","2022","506","13","519","2024-12-30"
"81204","2024","COM","2022","2193","43","2236","2024-12-30"
"81205","2024","COM","2022","185","6","191","2024-12-30"
"81206","2024","COM","2022","597","10","607","2024-12-30"
"81207","2024","COM","2022","84","26","110","2024-12-30"
"81208","2024","COM","2022","557","16","573","2024-12-30"
"81209","2024","COM","2022","2866","75","2941","2024-12-30"
"81210","2024","COM","2022","271","7","278","2024-12-30"
"81211","2024","COM","2022","486","10","496","2024-12-30"
"81212","2024","COM","2022","118","4","122","2024-12-30"
"81213","2024","COM","2022","91","2","93","2024-12-30"
"81214","2024","COM","2022","109","0","109","2024-12-30"
"81215","2024","COM","2022","646","10","656","2024-12-30"
"81216","2024","COM","2022","215","3","218","2024-12-30"
"81217","2024","COM","2022","458","8","466","2024-12-30"
"81218","2024","COM","2022","3549","77","3626","2024-12-30"
"81219","2024","COM","2022","3212","76","3288","2024-12-30"
"81220","2024","COM","2022","5801","152","5953","2024-12-30"
"81221","2024","COM","2022","233","0","233","2024-12-30"
"81222","2024","COM","2022","3542","58","3600","2024-12-30"
"81223","2024","COM","2022","63","2","65","2024-12-30"
"81224","2024","COM","2022","99","1","100","2024-12-30"
"81225","2024","COM","2022","1065","28","1093","2024-12-30"
"81227","2024","COM","2022","2181","45","2226","2024-12-30"
"81228","2024","COM","2022","468","20","488","2024-12-30"
"81229","2024","COM","2022","137","3","140","2024-12-30"
"81230","2024","COM","2022","722","11","733","2024-12-30"
"81231","2024","COM","2022","387","6","393","2024-12-30"
"81232","2024","COM","2022","632","22","654","2024-12-30"
"81233","2024","COM","2022","1728","35","1763","2024-12-30"
"81234","2024","COM","2022","85","1","86","2024-12-30"
"81235","2024","COM","2022","750","16","766","2024-12-30"
"81236","2024","COM","2022","295","5","300","2024-12-30"
"81237","2024","COM","2022","176","4","180","2024-12-30"
"81238","2024","COM","2022","1524","124","1648","2024-12-30"
"81239","2024","COM","2022","862","6","868","2024-12-30"
"81240","2024","COM","2022","102","0","102","2024-12-30"
"81242","2024","COM","2022","279","2","281","2024-12-30"
"81243","2024","COM","2022","129","2","131","2024-12-30"
"81244","2024","COM","2022","2059","29","2088","2024-12-30"
"81245","2024","COM","2022","131","1","132","2024-12-30"
"81246","2024","COM","2022","120","1","121","2024-12-30"
"81247","2024","COM","2022","219","0","219","2024-12-30"
"81248","2024","COM","2022","912","20","932","2024-12-30"
"81249","2024","COM","2022","846","18","864","2024-12-30"
"81250","2024","COM","2022","281","12","293","2024-12-30"
"81251","2024","COM","2022","920","28","948","2024-12-30"
"81252","2024","COM","2022","156","1","157","2024-12-30"
"81253","2024","COM","2022","471","7","478","2024-12-30"
"81254","2024","COM","2022","385","4","389","2024-12-30"
"81255","2024","COM","2022","512","13","525","2024-12-30"
"81256","2024","COM","2022","84","4","88","2024-12-30"
"81257","2024","COM","2022","6575","100","6675","2024-12-30"
"81258","2024","COM","2022","446","4","450","2024-12-30"
"81259","2024","COM","2022","226","1","227","2024-12-30"
"81261","2024","COM","2022","1232","34","1266","2024-12-30"
"81262","2024","COM","2022","230","2","232","2024-12-30"
"81263","2024","COM","2022","396","4","400","2024-12-30"
"81264","2024","COM","2022","87","2","89","2024-12-30"
"81265","2024","COM","2022","80","0","80","2024-12-30"
"81266","2024","COM","2022","1060","30","1090","2024-12-30"
"81267","2024","COM","2022","617","12","629","2024-12-30"
"81268","2024","COM","2022","78","0","78","2024-12-30"
"81269","2024","COM","2022","528","7","535","2024-12-30"
"81270","2024","COM","2022","166","3","169","2024-12-30"
"81271","2024","COM","2022","9674","273","9947","2024-12-30"
"81272","2024","COM","2022","225","1","226","2024-12-30"
"81273","2024","COM","2022","3714","50","3764","2024-12-30"
"81274","2024","COM","2022","816","26","842","2024-12-30"
"81275","2024","COM","2022","196","2","198","2024-12-30"
"81276","2024","COM","2022","1236","17","1253","2024-12-30"
"81277","2024","COM","2022","627","16","643","2024-12-30"
"81278","2024","COM","2022","186","2","188","2024-12-30"
"81279","2024","COM","2022","257","8","265","2024-12-30"
"81280","2024","COM","2022","261","6","267","2024-12-30"
"81281","2024","COM","2022","2021","54","2075","2024-12-30"
"81282","2024","COM","2022","37","0","37","2024-12-30"
"81283","2024","COM","2022","1123","28","1151","2024-12-30"
"81284","2024","COM","2022","2025","29","2054","2024-12-30"
"81285","2024","COM","2022","500","4","504","2024-12-30"
"81286","2024","COM","2022","591","19","610","2024-12-30"
"81287","2024","COM","2022","263","7","270","2024-12-30"
"81288","2024","COM","2022","2978","69","3047","2024-12-30"
"81289","2024","COM","2022","2649","39","2688","2024-12-30"
"81290","2024","COM","2022","172","2","174","2024-12-30"
"81291","2024","COM","2022","537","8","545","2024-12-30"
"81292","2024","COM","2022","541","20","561","2024-12-30"
"81293","2024","COM","2022","396","3","399","2024-12-30"
"81294","2024","COM","2022","1099","26","1125","2024-12-30"
"81295","2024","COM","2022","451","7","458","2024-12-30"
"81297","2024","COM","2022","1200","30","1230","2024-12-30"
"81298","2024","COM","2022","483","13","496","2024-12-30"
"81299","2024","COM","2022","382","8","390","2024-12-30"
"81300","2024","COM","2022","105","1","106","2024-12-30"
"81302","2024","COM","2022","58","1","59","2024-12-30"
"81303","2024","COM","2022","404","4","408","2024-12-30"
"81304","2024","COM","2022","200","3","203","2024-12-30"
"81305","2024","COM","2022","716","15","731","2024-12-30"
"81306","2024","COM","2022","828","22","850","2024-12-30"
"81307","2024","COM","2022","886","17","903","2024-12-30"
"81308","2024","COM","2022","1276","25","1301","2024-12-30"
"81309","2024","COM","2022","361","8","369","2024-12-30"
"81310","2024","COM","2022","145","2","147","2024-12-30"
"81311","2024","COM","2022","723","18","741","2024-12-30"
"81312","2024","COM","2022","1026","169","1195","2024-12-30"
"81313","2024","COM","2022","227","7","234","2024-12-30"
"81314","2024","COM","2022","531","27","558","2024-12-30"
"81315","2024","COM","2022","1377","44","1421","2024-12-30"
"81316","2024","COM","2022","230","4","234","2024-12-30"
"81317","2024","COM","2022","1235","18","1253","2024-12-30"
"81318","2024","COM","2022","138","5","143","2024-12-30"
"81319","2024","COM","2022","533","14","547","2024-12-30"
"81320","2024","COM","2022","155","3","158","2024-12-30"
"81321","2024","COM","2022","91","1","92","2024-12-30"
"81322","2024","COM","2022","252","4","256","2024-12-30"
"81323","2024","COM","2022","360","7","367","2024-12-30"
"81324","2024","COM","2022","265","6","271","2024-12-30"
"81325","2024","COM","2022","1992","50","2042","2024-12-30"
"81326","2024","COM","2022","423","10","433","2024-12-30"
"82001","2024","COM","2022","590","12","602","2024-12-30"
"82002","2024","COM","2022","3272","54","3326","2024-12-30"
"82003","2024","COM","2022","238","6","244","2024-12-30"
"82004","2024","COM","2022","132","0","132","2024-12-30"
"82005","2024","COM","2022","1552","22","1574","2024-12-30"
"82006","2024","COM","2022","65","2","67","2024-12-30"
"82007","2024","COM","2022","144","5","149","2024-12-30"
"82008","2024","COM","2022","909","42","951","2024-12-30"
"82009","2024","COM","2022","40","0","40","2024-12-30"
"82010","2024","COM","2022","239","6","245","2024-12-30"
"82011","2024","COM","2022","931","19","950","2024-12-30"
"82012","2024","COM","2022","586","9","595","2024-12-30"
"82013","2024","COM","2022","3754","172","3926","2024-12-30"
"82014","2024","COM","2022","274","7","281","2024-12-30"
"82015","2024","COM","2022","168","4","172","2024-12-30"
"82016","2024","COM","2022","221","1","222","2024-12-30"
"82017","2024","COM","2022","1470","26","1496","2024-12-30"
"82018","2024","COM","2022","1194","26","1220","2024-12-30"
"82019","2024","COM","2022","755","15","770","2024-12-30"
"82020","2024","COM","2022","577","10","587","2024-12-30"
"82021","2024","COM","2022","189","3","192","2024-12-30"
"82022","2024","COM","2022","389","8","397","2024-12-30"
"82023","2024","COM","2022","974","19","993","2024-12-30"
"82024","2024","COM","2022","252","2","254","2024-12-30"
"82025","2024","COM","2022","3883","67","3950","2024-12-30"
"82026","2024","COM","2022","639","10","649","2024-12-30"
"82027","2024","COM","2022","1472","24","1496","2024-12-30"
"82028","2024","COM","2022","807","21","828","2024-12-30"
"82029","2024","COM","2022","275","3","278","2024-12-30"
"82030","2024","COM","2022","490","11","501","2024-12-30"
"82031","2024","COM","2022","1191","17","1208","2024-12-30"
"82032","2024","COM","2022","540","13","553","2024-12-30"
"82033","2024","COM","2022","14335","243","14578","2024-12-30"
"82034","2024","COM","2022","122","1","123","2024-12-30"
"82035","2024","COM","2022","346","10","356","2024-12-30"
"82036","2024","COM","2022","131","5","136","2024-12-30"
"82037","2024","COM","2022","6858","194","7052","2024-12-30"
"82038","2024","COM","2022","1463","32","1495","2024-12-30"
"82039","2024","COM","2022","562","22","584","2024-12-30"
"82040","2024","COM","2022","273","13","286","2024-12-30"
"82041","2024","COM","2022","240","2","242","2024-12-30"
"82042","2024","COM","2022","1226","15","1241","2024-12-30"
"82043","2024","COM","2022","268","1","269","2024-12-30"
"82044","2024","COM","2022","1707","51","1758","2024-12-30"
"82045","2024","COM","2022","359","6","365","2024-12-30"
"82046","2024","COM","2022","108","0","108","2024-12-30"
"82047","2024","COM","2022","51","0","51","2024-12-30"
"82048","2024","COM","2022","1644","15","1659","2024-12-30"
"82049","2024","COM","2022","1039","13","1052","2024-12-30"
"82050","2024","COM","2022","1218","24","1242","2024-12-30"
"82051","2024","COM","2022","842","63","905","2024-12-30"
"82052","2024","COM","2022","1139","101","1240","2024-12-30"
"82053","2024","COM","2022","289","7","296","2024-12-30"
"82054","2024","COM","2022","380","7","387","2024-12-30"
"82055","2024","COM","2022","254","10","264","2024-12-30"
"82056","2024","COM","2022","210","4","214","2024-12-30"
"82057","2024","COM","2022","695","16","711","2024-12-30"
"82058","2024","COM","2022","109","0","109","2024-12-30"
"82059","2024","COM","2022","292","4","296","2024-12-30"
"82060","2024","COM","2022","182","3","185","2024-12-30"
"82061","2024","COM","2022","164","6","170","2024-12-30"
"82062","2024","COM","2022","1475","19","1494","2024-12-30"
"82063","2024","COM","2022","677","21","698","2024-12-30"
"82064","2024","COM","2022","128","0","128","2024-12-30"
"82065","2024","COM","2022","406","10","416","2024-12-30"
"82066","2024","COM","2022","636","14","650","2024-12-30"
"82067","2024","COM","2022","103","1","104","2024-12-30"
"82068","2024","COM","2022","231","5","236","2024-12-30"
"82069","2024","COM","2022","195","2","197","2024-12-30"
"82070","2024","COM","2022","68","1","69","2024-12-30"
"82071","2024","COM","2022","37","2","39","2024-12-30"
"82072","2024","COM","2022","1010","12","1022","2024-12-30"
"82073","2024","COM","2022","970","21","991","2024-12-30"
"82074","2024","COM","2022","132","5","137","2024-12-30"
"82075","2024","COM","2022","4206","78","4284","2024-12-30"
"82076","2024","COM","2022","1608","33","1641","2024-12-30"
"82077","2024","COM","2022","390","12","402","2024-12-30"
"82078","2024","COM","2022","126","0","126","2024-12-30"
"82079","2024","COM","2022","3763","76","3839","2024-12-30"
"82080","2024","COM","2022","1137","30","1167","2024-12-30"
"82081","2024","COM","2022","162","3","165","2024-12-30"
"82082","2024","COM","2022","207","5","212","2024-12-30"
"82083","2024","COM","2022","119","1","120","2024-12-30"
"82084","2024","COM","2022","171","2","173","2024-12-30"
"82085","2024","COM","2022","1265","18","1283","2024-12-30"
"82086","2024","COM","2022","235","3","238","2024-12-30"
"82087","2024","COM","2022","2839","59","2898","2024-12-30"
"82088","2024","COM","2022","653","6","659","2024-12-30"
"82089","2024","COM","2022","1213","21","1234","2024-12-30"
"82090","2024","COM","2022","1076","26","1102","2024-12-30"
"82091","2024","COM","2022","126","1","127","2024-12-30"
"82092","2024","COM","2022","282","6","288","2024-12-30"
"82093","2024","COM","2022","686","9","695","2024-12-30"
"82094","2024","COM","2022","1447","10","1457","2024-12-30"
"82095","2024","COM","2022","214","13","227","2024-12-30"
"82096","2024","COM","2022","3305","47","3352","2024-12-30"
"82097","2024","COM","2022","1606","20","1626","2024-12-30"
"82098","2024","COM","2022","1279","29","1308","2024-12-30"
"82099","2024","COM","2022","545","7","552","2024-12-30"
"82100","2024","COM","2022","121","6","127","2024-12-30"
"82101","2024","COM","2022","1245","19","1264","2024-12-30"
"82102","2024","COM","2022","310","4","314","2024-12-30"
"82103","2024","COM","2022","102","1","103","2024-12-30"
"82104","2024","COM","2022","184","6","190","2024-12-30"
"82105","2024","COM","2022","1303","26","1329","2024-12-30"
"82106","2024","COM","2022","152","3","155","2024-12-30"
"82107","2024","COM","2022","51","2","53","2024-12-30"
"82108","2024","COM","2022","1464","35","1499","2024-12-30"
"82109","2024","COM","2022","201","6","207","2024-12-30"
"82110","2024","COM","2022","1042","13","1055","2024-12-30"
"82111","2024","COM","2022","307","8","315","2024-12-30"
"82112","2024","COM","2022","13652","276","13928","2024-12-30"
"82113","2024","COM","2022","1274","12","1286","2024-12-30"
"82114","2024","COM","2022","656","6","662","2024-12-30"
"82115","2024","COM","2022","2039","39","2078","2024-12-30"
"82116","2024","COM","2022","197","4","201","2024-12-30"
"82117","2024","COM","2022","1295","16","1311","2024-12-30"
"82118","2024","COM","2022","92","1","93","2024-12-30"
"82119","2024","COM","2022","654","17","671","2024-12-30"
"82120","2024","COM","2022","297","4","301","2024-12-30"
"82121","2024","COM","2022","62487","1561","64048","2024-12-30"
"82122","2024","COM","2022","160","1","161","2024-12-30"
"82123","2024","COM","2022","1727","19","1746","2024-12-30"
"82124","2024","COM","2022","4335","87","4422","2024-12-30"
"82125","2024","COM","2022","6657","147","6804","2024-12-30"
"82126","2024","COM","2022","1354","103","1457","2024-12-30"
"82127","2024","COM","2022","747","20","767","2024-12-30"
"82128","2024","COM","2022","109","2","111","2024-12-30"
"82129","2024","COM","2022","143","1","144","2024-12-30"
"82130","2024","COM","2022","171","1","172","2024-12-30"
"82131","2024","COM","2022","1600","37","1637","2024-12-30"
"82132","2024","COM","2022","1175","28","1203","2024-12-30"
"82133","2024","COM","2022","91","1","92","2024-12-30"
"82134","2024","COM","2022","5839","104","5943","2024-12-30"
"82135","2024","COM","2022","1384","16","1400","2024-12-30"
"82136","2024","COM","2022","1721","22","1743","2024-12-30"
"82137","2024","COM","2022","559","12","571","2024-12-30"
"82138","2024","COM","2022","169","5","174","2024-12-30"
"82139","2024","COM","2022","115","2","117","2024-12-30"
"82140","2024","COM","2022","455","15","470","2024-12-30"
"82141","2024","COM","2022","580","9","589","2024-12-30"
"82142","2024","COM","2022","1810","29","1839","2024-12-30"
"82143","2024","COM","2022","88","0","88","2024-12-30"
"82144","2024","COM","2022","772","9","781","2024-12-30"
"82145","2024","COM","2022","379","7","386","2024-12-30"
"82146","2024","COM","2022","55","2","57","2024-12-30"
"82147","2024","COM","2022","345","4","349","2024-12-30"
"82148","2024","COM","2022","698","10","708","2024-12-30"
"82149","2024","COM","2022","1867","34","1901","2024-12-30"
"82150","2024","COM","2022","878","23","901","2024-12-30"
"82151","2024","COM","2022","401","6","407","2024-12-30"
"82152","2024","COM","2022","407","7","414","2024-12-30"
"82153","2024","COM","2022","232","5","237","2024-12-30"
"82154","2024","COM","2022","214","5","219","2024-12-30"
"82155","2024","COM","2022","1951","33","1984","2024-12-30"
"82156","2024","COM","2022","145","5","150","2024-12-30"
"82157","2024","COM","2022","113","1","114","2024-12-30"
"82158","2024","COM","2022","148","4","152","2024-12-30"
"82159","2024","COM","2022","569","18","587","2024-12-30"
"82160","2024","COM","2022","258","8","266","2024-12-30"
"82161","2024","COM","2022","4050","80","4130","2024-12-30"
"82162","2024","COM","2022","271","5","276","2024-12-30"
"82163","2024","COM","2022","53","1","54","2024-12-30"
"82164","2024","COM","2022","126","3","129","2024-12-30"
"82165","2024","COM","2022","535","7","542","2024-12-30"
"82166","2024","COM","2022","274","6","280","2024-12-30"
"82167","2024","COM","2022","1934","39","1973","2024-12-30"
"82168","2024","COM","2022","311","3","314","2024-12-30"
"82169","2024","COM","2022","2287","28","2315","2024-12-30"
"82170","2024","COM","2022","561","17","578","2024-12-30"
"82171","2024","COM","2022","1340","26","1366","2024-12-30"
"82172","2024","COM","2022","288","9","297","2024-12-30"
"82173","2024","COM","2022","1135","11","1146","2024-12-30"
"82174","2024","COM","2022","283","9","292","2024-12-30"
"82175","2024","COM","2022","285","4","289","2024-12-30"
"82176","2024","COM","2022","967","14","981","2024-12-30"
"82177","2024","COM","2022","152","2","154","2024-12-30"
"82178","2024","COM","2022","828","16","844","2024-12-30"
"82179","2024","COM","2022","2254","44","2298","2024-12-30"
"82180","2024","COM","2022","521","8","529","2024-12-30"
"82181","2024","COM","2022","206","6","212","2024-12-30"
"82182","2024","COM","2022","336","4","340","2024-12-30"
"82183","2024","COM","2022","221","8","229","2024-12-30"
"82184","2024","COM","2022","952","18","970","2024-12-30"
"82185","2024","COM","2022","244","2","246","2024-12-30"
"82186","2024","COM","2022","5287","148","5435","2024-12-30"
"82187","2024","COM","2022","646","11","657","2024-12-30"
"82188","2024","COM","2022","640","13","653","2024-12-30"
"82189","2024","COM","2022","767","12","779","2024-12-30"
"82190","2024","COM","2022","4914","85","4999","2024-12-30"
"82191","2024","COM","2022","406","3","409","2024-12-30"
"82192","2024","COM","2022","565","13","578","2024-12-30"
"82193","2024","COM","2022","120","2","122","2024-12-30"
"82194","2024","COM","2022","1349","34","1383","2024-12-30"
"82195","2024","COM","2022","824","10","834","2024-12-30"
"83001","2024","COM","2022","2780","72","2852","2024-12-30"
"83002","2024","COM","2022","272","7","279","2024-12-30"
"83003","2024","COM","2022","894","24","918","2024-12-30"
"83004","2024","COM","2022","7844","163","8007","2024-12-30"
"83005","2024","COM","2022","278","6","284","2024-12-30"
"83006","2024","COM","2022","286","8","294","2024-12-30"
"83007","2024","COM","2022","2254","31","2285","2024-12-30"
"83008","2024","COM","2022","3049","51","3100","2024-12-30"
"83009","2024","COM","2022","8263","112","8375","2024-12-30"
"83010","2024","COM","2022","214","4","218","2024-12-30"
"83011","2024","COM","2022","1434","17","1451","2024-12-30"
"83012","2024","COM","2022","2995","34","3029","2024-12-30"
"83013","2024","COM","2022","215","2","217","2024-12-30"
"83014","2024","COM","2022","237","9","246","2024-12-30"
"83015","2024","COM","2022","318","6","324","2024-12-30"
"83016","2024","COM","2022","10098","180","10278","2024-12-30"
"83017","2024","COM","2022","2387","44","2431","2024-12-30"
"83018","2024","COM","2022","3123","56","3179","2024-12-30"
"83019","2024","COM","2022","8361","89","8450","2024-12-30"
"83020","2024","COM","2022","47","1","48","2024-12-30"
"83021","2024","COM","2022","2617","49","2666","2024-12-30"
"83022","2024","COM","2022","21","0","21","2024-12-30"
"83023","2024","COM","2022","17846","317","18163","2024-12-30"
"83025","2024","COM","2022","1456","24","1480","2024-12-30"
"83026","2024","COM","2022","1985","37","2022","2024-12-30"
"83027","2024","COM","2022","5657","31","5688","2024-12-30"
"83028","2024","COM","2022","2069","37","2106","2024-12-30"
"83029","2024","COM","2022","3794","77","3871","2024-12-30"
"83030","2024","COM","2022","1920","47","1967","2024-12-30"
"83031","2024","COM","2022","4866","68","4934","2024-12-30"
"83032","2024","COM","2022","3407","80","3487","2024-12-30"
"83033","2024","COM","2022","4120","34","4154","2024-12-30"
"83034","2024","COM","2022","9412","149","9561","2024-12-30"
"83035","2024","COM","2022","5992","69","6061","2024-12-30"
"83036","2024","COM","2022","7895","79","7974","2024-12-30"
"83037","2024","COM","2022","1647","80","1727","2024-12-30"
"83038","2024","COM","2022","476","14","490","2024-12-30"
"83039","2024","COM","2022","144","5","149","2024-12-30"
"83040","2024","COM","2022","73","1","74","2024-12-30"
"83041","2024","COM","2022","720","8","728","2024-12-30"
"83042","2024","COM","2022","12076","147","12223","2024-12-30"
"83043","2024","COM","2022","1813","88","1901","2024-12-30"
"83044","2024","COM","2022","346","4","350","2024-12-30"
"83045","2024","COM","2022","891","14","905","2024-12-30"
"83046","2024","COM","2022","2166","32","2198","2024-12-30"
"83047","2024","COM","2022","19416","358","19774","2024-12-30"
"83048","2024","COM","2022","3832","95","3927","2024-12-30"
"83049","2024","COM","2022","12841","136","12977","2024-12-30"
"83050","2024","COM","2022","40789","819","41608","2024-12-30"
"83051","2024","COM","2022","1132","23","1155","2024-12-30"
"83052","2024","COM","2022","370","5","375","2024-12-30"
"83053","2024","COM","2022","2406","28","2434","2024-12-30"
"83054","2024","COM","2022","9745","123","9868","2024-12-30"
"83055","2024","COM","2022","6024","84","6108","2024-12-30"
"83056","2024","COM","2022","2683","55","2738","2024-12-30"
"83057","2024","COM","2022","3661","67","3728","2024-12-30"
"83058","2024","COM","2022","4514","81","4595","2024-12-30"
"83059","2024","COM","2022","3353","40","3393","2024-12-30"
"83060","2024","COM","2022","501","7","508","2024-12-30"
"83061","2024","COM","2022","58499","832","59331","2024-12-30"
"83062","2024","COM","2022","26316","280","26596","2024-12-30"
"83063","2024","COM","2022","1848","42","1890","2024-12-30"
"83064","2024","COM","2022","5579","91","5670","2024-12-30"
"83065","2024","COM","2022","2674","58","2732","2024-12-30"
"83066","2024","COM","2022","2036","33","2069","2024-12-30"
"83067","2024","COM","2022","4349","58","4407","2024-12-30"
"83068","2024","COM","2022","4557","63","4620","2024-12-30"
"83069","2024","COM","2022","55384","856","56240","2024-12-30"
"83070","2024","COM","2022","6431","64","6495","2024-12-30"
"83071","2024","COM","2022","11010","127","11137","2024-12-30"
"83072","2024","COM","2022","9803","293","10096","2024-12-30"
"83073","2024","COM","2022","11124","144","11268","2024-12-30"
"83074","2024","COM","2022","221","1","222","2024-12-30"
"83075","2024","COM","2022","625","7","632","2024-12-30"
"83076","2024","COM","2022","894","13","907","2024-12-30"
"83077","2024","COM","2022","2260","28","2288","2024-12-30"
"83078","2024","COM","2022","309","5","314","2024-12-30"
"83079","2024","COM","2022","1502","26","1528","2024-12-30"
"83080","2024","COM","2022","873","13","886","2024-12-30"
"83081","2024","COM","2022","6787","130","6917","2024-12-30"
"83082","2024","COM","2022","1720","9","1729","2024-12-30"
"83083","2024","COM","2022","1464","27","1491","2024-12-30"
"83084","2024","COM","2022","595","4","599","2024-12-30"
"83085","2024","COM","2022","3050","56","3106","2024-12-30"
"83086","2024","COM","2022","9882","225","10107","2024-12-30"
"83087","2024","COM","2022","5090","91","5181","2024-12-30"
"83088","2024","COM","2022","2956","70","3026","2024-12-30"
"83089","2024","COM","2022","638","12","650","2024-12-30"
"83090","2024","COM","2022","14320","247","14567","2024-12-30"
"83091","2024","COM","2022","6084","101","6185","2024-12-30"
"83092","2024","COM","2022","4767","47","4814","2024-12-30"
"83093","2024","COM","2022","2430","42","2472","2024-12-30"
"83094","2024","COM","2022","3068","57","3125","2024-12-30"
"83095","2024","COM","2022","764","11","775","2024-12-30"
"83096","2024","COM","2022","1564","21","1585","2024-12-30"
"83097","2024","COM","2022","5620","110","5730","2024-12-30"
"83098","2024","COM","2022","10582","184","10766","2024-12-30"
"83099","2024","COM","2022","8473","120","8593","2024-12-30"
"83100","2024","COM","2022","4568","50","4618","2024-12-30"
"83101","2024","COM","2022","1889","33","1922","2024-12-30"
"83102","2024","COM","2022","2403","38","2441","2024-12-30"
"83103","2024","COM","2022","4046","63","4109","2024-12-30"
"83104","2024","COM","2022","4245","83","4328","2024-12-30"
"83105","2024","COM","2022","51","0","51","2024-12-30"
"83106","2024","COM","2022","5489","79","5568","2024-12-30"
"83107","2024","COM","2022","15006","223","15229","2024-12-30"
"83108","2024","COM","2022","2199","40","2239","2024-12-30"
"83109","2024","COM","2022","253","5","258","2024-12-30"
"83110","2024","COM","2022","1700","29","1729","2024-12-30"
"83111","2024","COM","2022","2138","24","2162","2024-12-30"
"83112","2024","COM","2022","11668","234","11902","2024-12-30"
"83113","2024","COM","2022","2399","41","2440","2024-12-30"
"83114","2024","COM","2022","271","5","276","2024-12-30"
"83115","2024","COM","2022","14394","151","14545","2024-12-30"
"83116","2024","COM","2022","17691","510","18201","2024-12-30"
"83117","2024","COM","2022","1747","42","1789","2024-12-30"
"83118","2024","COM","2022","36632","583","37215","2024-12-30"
"83119","2024","COM","2022","3586","69","3655","2024-12-30"
"83120","2024","COM","2022","5877","72","5949","2024-12-30"
"83121","2024","COM","2022","3812","78","3890","2024-12-30"
"83122","2024","COM","2022","235","3","238","2024-12-30"
"83123","2024","COM","2022","17938","252","18190","2024-12-30"
"83124","2024","COM","2022","2852","44","2896","2024-12-30"
"83125","2024","COM","2022","2717","34","2751","2024-12-30"
"83126","2024","COM","2022","62905","695","63600","2024-12-30"
"83127","2024","COM","2022","3126","43","3169","2024-12-30"
"83128","2024","COM","2022","783","44","827","2024-12-30"
"83129","2024","COM","2022","36843","501","37344","2024-12-30"
"83130","2024","COM","2022","12210","143","12353","2024-12-30"
"83131","2024","COM","2022","6087","109","6196","2024-12-30"
"83132","2024","COM","2022","2532","46","2578","2024-12-30"
"83133","2024","COM","2022","1723","26","1749","2024-12-30"
"83134","2024","COM","2022","1899","36","1935","2024-12-30"
"83135","2024","COM","2022","1444","19","1463","2024-12-30"
"83136","2024","COM","2022","2636","47","2683","2024-12-30"
"83137","2024","COM","2022","180834","1701","182535","2024-12-30"
"83138","2024","COM","2022","2920","45","2965","2024-12-30"
"83139","2024","COM","2022","583","14","597","2024-12-30"
"83140","2024","COM","2022","5220","80","5300","2024-12-30"
"83141","2024","COM","2022","6595","113","6708","2024-12-30"
"83142","2024","COM","2022","221","4","225","2024-12-30"
"83143","2024","COM","2022","4257","93","4350","2024-12-30"
"83144","2024","COM","2022","23660","241","23901","2024-12-30"
"83145","2024","COM","2022","1170","15","1185","2024-12-30"
"83146","2024","COM","2022","1674","23","1697","2024-12-30"
"83147","2024","COM","2022","8","0","8","2024-12-30"
"83148","2024","COM","2022","12712","157","12869","2024-12-30"
"83149","2024","COM","2022","1504","20","1524","2024-12-30"
"83150","2024","COM","2022","4387","103","4490","2024-12-30"
"83151","2024","COM","2022","936","14","950","2024-12-30"
"83152","2024","COM","2022","644","13","657","2024-12-30"
"83153","2024","COM","2022","6064","61","6125","2024-12-30"
"83154","2024","COM","2022","808","8","816","2024-12-30"
"84001","2024","COM","2022","2881","61","2942","2024-12-30"
"84002","2024","COM","2022","1066","24","1090","2024-12-30"
"84003","2024","COM","2022","10297","218","10515","2024-12-30"
"84004","2024","COM","2022","5962","98","6060","2024-12-30"
"84005","2024","COM","2022","186","3","189","2024-12-30"
"84006","2024","COM","2022","70","0","70","2024-12-30"
"84007","2024","COM","2022","91760","1416","93176","2024-12-30"
"84008","2024","COM","2022","663","21","684","2024-12-30"
"84009","2024","COM","2022","1723","100","1823","2024-12-30"
"84010","2024","COM","2022","914","13","927","2024-12-30"
"84011","2024","COM","2022","381","6","387","2024-12-30"
"84012","2024","COM","2022","2428","48","2476","2024-12-30"
"84013","2024","COM","2022","308","4","312","2024-12-30"
"84014","2024","COM","2022","1102","16","1118","2024-12-30"
"84015","2024","COM","2022","307","4","311","2024-12-30"
"84016","2024","COM","2022","5521","81","5602","2024-12-30"
"84017","2024","COM","2022","3077","67","3144","2024-12-30"
"84018","2024","COM","2022","555","12","567","2024-12-30"
"84019","2024","COM","2022","13871","202","14073","2024-12-30"
"84020","2024","COM","2022","1166","26","1192","2024-12-30"
"84021","2024","COM","2022","86","1","87","2024-12-30"
"84022","2024","COM","2022","256","11","267","2024-12-30"
"84023","2024","COM","2022","103","3","106","2024-12-30"
"84024","2024","COM","2022","947","14","961","2024-12-30"
"84025","2024","COM","2022","1741","42","1783","2024-12-30"
"84026","2024","COM","2022","4327","80","4407","2024-12-30"
"84027","2024","COM","2022","2541","58","2599","2024-12-30"
"84028","2024","COM","2022","1121","20","1141","2024-12-30"
"84029","2024","COM","2022","4549","90","4639","2024-12-30"
"84030","2024","COM","2022","3469","41","3510","2024-12-30"
"84031","2024","COM","2022","30854","704","31558","2024-12-30"
"84032","2024","COM","2022","519","9","528","2024-12-30"
"84033","2024","COM","2022","114","1","115","2024-12-30"
"84034","2024","COM","2022","5499","113","5612","2024-12-30"
"84035","2024","COM","2022","25890","346","26236","2024-12-30"
"84036","2024","COM","2022","3495","72","3567","2024-12-30"
"84037","2024","COM","2022","2045","34","2079","2024-12-30"
"84038","2024","COM","2022","4340","83","4423","2024-12-30"
"84039","2024","COM","2022","6245","71","6316","2024-12-30"
"84040","2024","COM","2022","418","11","429","2024-12-30"
"84041","2024","COM","2022","489","11","500","2024-12-30"
"84042","2024","COM","2022","1849","35","1884","2024-12-30"
"84043","2024","COM","2022","8888","125","9013","2024-12-30"
"84044","2024","COM","2022","1164","19","1183","2024-12-30"
"84045","2024","COM","2022","454","11","465","2024-12-30"
"84046","2024","COM","2022","455","12","467","2024-12-30"
"84047","2024","COM","2022","3020","54","3074","2024-12-30"
"84048","2024","COM","2022","73","1","74","2024-12-30"
"84049","2024","COM","2022","435","11","446","2024-12-30"
"84050","2024","COM","2022","1664","32","1696","2024-12-30"
"84051","2024","COM","2022","1067","15","1082","2024-12-30"
"84052","2024","COM","2022","1204","27","1231","2024-12-30"
"84053","2024","COM","2022","1724","38","1762","2024-12-30"
"84054","2024","COM","2022","20315","500","20815","2024-12-30"
"84055","2024","COM","2022","1597","38","1635","2024-12-30"
"84056","2024","COM","2022","5213","65","5278","2024-12-30"
"84057","2024","COM","2022","348","2","350","2024-12-30"
"84058","2024","COM","2022","453","4","457","2024-12-30"
"84059","2024","COM","2022","127","3","130","2024-12-30"
"84060","2024","COM","2022","30","1","31","2024-12-30"
"84061","2024","COM","2022","321","12","333","2024-12-30"
"84062","2024","COM","2022","1707","33","1740","2024-12-30"
"84063","2024","COM","2022","397","5","402","2024-12-30"
"84064","2024","COM","2022","3831","72","3903","2024-12-30"
"84065","2024","COM","2022","3929","71","4000","2024-12-30"
"84066","2024","COM","2022","287","6","293","2024-12-30"
"84067","2024","COM","2022","2481","54","2535","2024-12-30"
"84068","2024","COM","2022","1031","26","1057","2024-12-30"
"84069","2024","COM","2022","2759","61","2820","2024-12-30"
"84070","2024","COM","2022","1952","32","1984","2024-12-30"
"84071","2024","COM","2022","1915","34","1949","2024-12-30"
"84072","2024","COM","2022","6272","137","6409","2024-12-30"
"84073","2024","COM","2022","967","19","986","2024-12-30"
"84074","2024","COM","2022","2273","38","2311","2024-12-30"
"84075","2024","COM","2022","453","8","461","2024-12-30"
"84076","2024","COM","2022","1434","36","1470","2024-12-30"
"84077","2024","COM","2022","461","16","477","2024-12-30"
"84078","2024","COM","2022","3756","57","3813","2024-12-30"
"84079","2024","COM","2022","268","8","276","2024-12-30"
"84080","2024","COM","2022","13159","240","13399","2024-12-30"
"84081","2024","COM","2022","8996","132","9128","2024-12-30"
"84082","2024","COM","2022","1882","53","1935","2024-12-30"
"84083","2024","COM","2022","2530","32","2562","2024-12-30"
"84084","2024","COM","2022","1418","35","1453","2024-12-30"
"84085","2024","COM","2022","390","6","396","2024-12-30"
"84086","2024","COM","2022","1285","30","1315","2024-12-30"
"84087","2024","COM","2022","29357","643","30000","2024-12-30"
"84088","2024","COM","2022","10433","240","10673","2024-12-30"
"84089","2024","COM","2022","19764","268","20032","2024-12-30"
"84090","2024","COM","2022","663","14","677","2024-12-30"
"84091","2024","COM","2022","5679","107","5786","2024-12-30"
"84092","2024","COM","2022","17985","169","18154","2024-12-30"
"84093","2024","COM","2022","881","23","904","2024-12-30"
"84094","2024","COM","2022","584","12","596","2024-12-30"
"84095","2024","COM","2022","842","17","859","2024-12-30"
"84096","2024","COM","2022","791","20","811","2024-12-30"
"84097","2024","COM","2022","539","82","621","2024-12-30"
"84098","2024","COM","2022","622","15","637","2024-12-30"
"84099","2024","COM","2022","4803","93","4896","2024-12-30"
"84100","2024","COM","2022","51","1","52","2024-12-30"
"84101","2024","COM","2022","431","13","444","2024-12-30"
"84102","2024","COM","2022","1318","20","1338","2024-12-30"
"84103","2024","COM","2022","682","21","703","2024-12-30"
"84104","2024","COM","2022","1433","34","1467","2024-12-30"
"84105","2024","COM","2022","922","20","942","2024-12-30"
"84106","2024","COM","2022","2639","53","2692","2024-12-30"
"84107","2024","COM","2022","1416","21","1437","2024-12-30"
"84108","2024","COM","2022","2192","41","2233","2024-12-30"
"84109","2024","COM","2022","170","9","179","2024-12-30"
"84110","2024","COM","2022","27","1","28","2024-12-30"
"84111","2024","COM","2022","335","11","346","2024-12-30"
"84112","2024","COM","2022","695","7","702","2024-12-30"
"84113","2024","COM","2022","811","23","834","2024-12-30"
"84114","2024","COM","2022","207","2","209","2024-12-30"
"84115","2024","COM","2022","504","11","515","2024-12-30"
"84116","2024","COM","2022","860","12","872","2024-12-30"
"84117","2024","COM","2022","339","7","346","2024-12-30"
"84118","2024","COM","2022","2986","74","3060","2024-12-30"
"84119","2024","COM","2022","5211","83","5294","2024-12-30"
"84120","2024","COM","2022","120","1","121","2024-12-30"
"84121","2024","COM","2022","292","0","292","2024-12-30"
"84122","2024","COM","2022","5834","82","5916","2024-12-30"
"84123","2024","COM","2022","1348","28","1376","2024-12-30"
"84124","2024","COM","2022","890","15","905","2024-12-30"
"84125","2024","COM","2022","74","3","77","2024-12-30"
"84126","2024","COM","2022","773","17","790","2024-12-30"
"84127","2024","COM","2022","2896","83","2979","2024-12-30"
"84128","2024","COM","2022","44","4","48","2024-12-30"
"84129","2024","COM","2022","19030","217","19247","2024-12-30"
"84130","2024","COM","2022","111","5","116","2024-12-30"
"84131","2024","COM","2022","1998","45","2043","2024-12-30"
"84132","2024","COM","2022","8887","181","9068","2024-12-30"
"84133","2024","COM","2022","4375","125","4500","2024-12-30"
"84134","2024","COM","2022","721","14","735","2024-12-30"
"84135","2024","COM","2022","1702","50","1752","2024-12-30"
"84136","2024","COM","2022","1192","30","1222","2024-12-30"
"84137","2024","COM","2022","5920","126","6046","2024-12-30"
"84138","2024","COM","2022","9285","225","9510","2024-12-30"
"84139","2024","COM","2022","576","11","587","2024-12-30"
"84140","2024","COM","2022","556","16","572","2024-12-30"
"84141","2024","COM","2022","11799","322","12121","2024-12-30"
"84142","2024","COM","2022","3138","75","3213","2024-12-30"
"84143","2024","COM","2022","1069","23","1092","2024-12-30"
"84144","2024","COM","2022","624","16","640","2024-12-30"
"84145","2024","COM","2022","770","14","784","2024-12-30"
"84146","2024","COM","2022","480","10","490","2024-12-30"
"84147","2024","COM","2022","3395","84","3479","2024-12-30"
"84148","2024","COM","2022","1292","23","1315","2024-12-30"
"84149","2024","COM","2022","1745","30","1775","2024-12-30"
"84150","2024","COM","2022","1875","34","1909","2024-12-30"
"84151","2024","COM","2022","199","3","202","2024-12-30"
"85001","2024","COM","2022","2808","31","2839","2024-12-30"
"85002","2024","COM","2022","2207","30","2237","2024-12-30"
"85003","2024","COM","2022","10218","201","10419","2024-12-30"
"85004","2024","COM","2022","2966","30","2996","2024-12-30"
"85005","2024","COM","2022","1035","11","1046","2024-12-30"
"85006","2024","COM","2022","2028","30","2058","2024-12-30"
"85008","2024","COM","2022","7129","131","7260","2024-12-30"
"85009","2024","COM","2022","1118","22","1140","2024-12-30"
"85010","2024","COM","2022","1408","18","1426","2024-12-30"
"85011","2024","COM","2022","1790","36","1826","2024-12-30"
"85012","2024","COM","2022","2356","34","2390","2024-12-30"
"85013","2024","COM","2022","1551","26","1577","2024-12-30"
"85014","2024","COM","2022","1161","27","1188","2024-12-30"
"85015","2024","COM","2022","1654","26","1680","2024-12-30"
"85016","2024","COM","2022","2366","44","2410","2024-12-30"
"85017","2024","COM","2022","2406","68","2474","2024-12-30"
"85018","2024","COM","2022","3955","57","4012","2024-12-30"
"85019","2024","COM","2022","6239","148","6387","2024-12-30"
"85020","2024","COM","2022","4059","94","4153","2024-12-30"
"85021","2024","COM","2022","1913","42","1955","2024-12-30"
"85022","2024","COM","2022","1320","18","1338","2024-12-30"
"85023","2024","COM","2022","449","9","458","2024-12-30"
"85024","2024","COM","2022","2215","30","2245","2024-12-30"
"85025","2024","COM","2022","2295","49","2344","2024-12-30"
"85026","2024","COM","2022","1465","18","1483","2024-12-30"
"85028","2024","COM","2022","595","11","606","2024-12-30"
"85029","2024","COM","2022","2169","31","2200","2024-12-30"
"85031","2024","COM","2022","3170","64","3234","2024-12-30"
"85033","2024","COM","2022","717","17","734","2024-12-30"
"85034","2024","COM","2022","3471","90","3561","2024-12-30"
"85035","2024","COM","2022","5139","87","5226","2024-12-30"
"85036","2024","COM","2022","587","18","605","2024-12-30"
"85038","2024","COM","2022","2916","46","2962","2024-12-30"
"85039","2024","COM","2022","4015","78","4093","2024-12-30"
"85040","2024","COM","2022","1100","19","1119","2024-12-30"
"85042","2024","COM","2022","1909","29","1938","2024-12-30"
"85045","2024","COM","2022","1103","13","1116","2024-12-30"
"85046","2024","COM","2022","3883","62","3945","2024-12-30"
"85047","2024","COM","2022","22890","722","23612","2024-12-30"
"85049","2024","COM","2022","1816","23","1839","2024-12-30"
"85050","2024","COM","2022","2041","18","2059","2024-12-30"
"85051","2024","COM","2022","8518","495","9013","2024-12-30"
"85054","2024","COM","2022","1083","12","1095","2024-12-30"
"85055","2024","COM","2022","1108","28","1136","2024-12-30"
"85056","2024","COM","2022","394","11","405","2024-12-30"
"85058","2024","COM","2022","792","16","808","2024-12-30"
"85059","2024","COM","2022","2590","38","2628","2024-12-30"
"85061","2024","COM","2022","1550","28","1578","2024-12-30"
"85062","2024","COM","2022","1144","15","1159","2024-12-30"
"85064","2024","COM","2022","2559","38","2597","2024-12-30"
"85065","2024","COM","2022","3648","105","3753","2024-12-30"
"85066","2024","COM","2022","847","13","860","2024-12-30"
"85067","2024","COM","2022","1002","20","1022","2024-12-30"
"85070","2024","COM","2022","3416","38","3454","2024-12-30"
"85071","2024","COM","2022","3708","58","3766","2024-12-30"
"85072","2024","COM","2022","1047","18","1065","2024-12-30"
"85073","2024","COM","2022","1025","16","1041","2024-12-30"
"85074","2024","COM","2022","229","5","234","2024-12-30"
"85076","2024","COM","2022","3746","90","3836","2024-12-30"
"85077","2024","COM","2022","492","6","498","2024-12-30"
"85078","2024","COM","2022","731","13","744","2024-12-30"
"85080","2024","COM","2022","1757","33","1790","2024-12-30"
"85081","2024","COM","2022","4535","126","4661","2024-12-30"
"85082","2024","COM","2022","2984","72","3056","2024-12-30"
"85083","2024","COM","2022","1643","35","1678","2024-12-30"
"85084","2024","COM","2022","6835","114","6949","2024-12-30"
"85086","2024","COM","2022","1704","17","1721","2024-12-30"
"85087","2024","COM","2022","205","5","210","2024-12-30"
"85088","2024","COM","2022","4978","120","5098","2024-12-30"
"85089","2024","COM","2022","5411","157","5568","2024-12-30"
"85090","2024","COM","2022","6401","254","6655","2024-12-30"
"85092","2024","COM","2022","13806","636","14442","2024-12-30"
"85093","2024","COM","2022","1242","19","1261","2024-12-30"
"85094","2024","COM","2022","1176","28","1204","2024-12-30"
"85095","2024","COM","2022","2128","23","2151","2024-12-30"
"85096","2024","COM","2022","5413","104","5517","2024-12-30"
"85097","2024","COM","2022","3223","70","3293","2024-12-30"
"85098","2024","COM","2022","1963","39","2002","2024-12-30"
"85099","2024","COM","2022","1144","20","1164","2024-12-30"
"85100","2024","COM","2022","2216","52","2268","2024-12-30"
"85101","2024","COM","2022","484","4","488","2024-12-30"
"85102","2024","COM","2022","725","5","730","2024-12-30"
"85103","2024","COM","2022","2216","41","2257","2024-12-30"
"85104","2024","COM","2022","910","7","917","2024-12-30"
"85105","2024","COM","2022","516","16","532","2024-12-30"
"85106","2024","COM","2022","1335","31","1366","2024-12-30"
"85108","2024","COM","2022","3437","115","3552","2024-12-30"
"85109","2024","COM","2022","16589","562","17151","2024-12-30"
"85110","2024","COM","2022","903","18","921","2024-12-30"
"85111","2024","COM","2022","1505","21","1526","2024-12-30"
"85112","2024","COM","2022","2805","57","2862","2024-12-30"
"85113","2024","COM","2022","4887","138","5025","2024-12-30"
"85114","2024","COM","2022","3046","37","3083","2024-12-30"
"85115","2024","COM","2022","647","12","659","2024-12-30"
"85116","2024","COM","2022","483","3","486","2024-12-30"
"85117","2024","COM","2022","601","8","609","2024-12-30"
"85118","2024","COM","2022","2285","43","2328","2024-12-30"
"85119","2024","COM","2022","2572","51","2623","2024-12-30"
"85120","2024","COM","2022","1512","36","1548","2024-12-30"
"85121","2024","COM","2022","1050","21","1071","2024-12-30"
"85123","2024","COM","2022","296","9","305","2024-12-30"
"85125","2024","COM","2022","383","2","385","2024-12-30"
"85126","2024","COM","2022","1360","30","1390","2024-12-30"
"85127","2024","COM","2022","2442","21","2463","2024-12-30"
"85128","2024","COM","2022","9450","309","9759","2024-12-30"
"85129","2024","COM","2022","3671","78","3749","2024-12-30"
"85130","2024","COM","2022","1754","17","1771","2024-12-30"
"85131","2024","COM","2022","1461","33","1494","2024-12-30"
"85132","2024","COM","2022","757","11","768","2024-12-30"
"85133","2024","COM","2022","895","18","913","2024-12-30"
"85134","2024","COM","2022","240","9","249","2024-12-30"
"85135","2024","COM","2022","2773","112","2885","2024-12-30"
"85136","2024","COM","2022","124","0","124","2024-12-30"
"85137","2024","COM","2022","526","11","537","2024-12-30"
"85138","2024","COM","2022","1199","12","1211","2024-12-30"
"85139","2024","COM","2022","457","11","468","2024-12-30"
"85140","2024","COM","2022","1489","31","1520","2024-12-30"
"85141","2024","COM","2022","681","12","693","2024-12-30"
"85142","2024","COM","2022","1010","15","1025","2024-12-30"
"85143","2024","COM","2022","1073","17","1090","2024-12-30"
"85144","2024","COM","2022","1560","33","1593","2024-12-30"
"85145","2024","COM","2022","989","20","1009","2024-12-30"
"85146","2024","COM","2022","20754","620","21374","2024-12-30"
"85147","2024","COM","2022","1626","48","1674","2024-12-30"
"85148","2024","COM","2022","820","23","843","2024-12-30"
"85149","2024","COM","2022","408","8","416","2024-12-30"
"85151","2024","COM","2022","6065","136","6201","2024-12-30"
"85152","2024","COM","2022","5451","114","5565","2024-12-30"
"85153","2024","COM","2022","2986","58","3044","2024-12-30"
"85154","2024","COM","2022","1749","87","1836","2024-12-30"
"85155","2024","COM","2022","5209","132","5341","2024-12-30"
"85156","2024","COM","2022","2341","42","2383","2024-12-30"
"85157","2024","COM","2022","823","10","833","2024-12-30"
"85158","2024","COM","2022","1211","28","1239","2024-12-30"
"85159","2024","COM","2022","2372","38","2410","2024-12-30"
"85160","2024","COM","2022","3056","61","3117","2024-12-30"
"85161","2024","COM","2022","2546","36","2582","2024-12-30"
"85162","2024","COM","2022","2054","63","2117","2024-12-30"
"85163","2024","COM","2022","4502","101","4603","2024-12-30"
"85164","2024","COM","2022","2293","30","2323","2024-12-30"
"85165","2024","COM","2022","1264","28","1292","2024-12-30"
"85167","2024","COM","2022","801","21","822","2024-12-30"
"85169","2024","COM","2022","1110","17","1127","2024-12-30"
"85171","2024","COM","2022","618","22","640","2024-12-30"
"85172","2024","COM","2022","2210","38","2248","2024-12-30"
"85174","2024","COM","2022","684","15","699","2024-12-30"
"85175","2024","COM","2022","678","7","685","2024-12-30"
"85176","2024","COM","2022","1144","32","1176","2024-12-30"
"85177","2024","COM","2022","1366","31","1397","2024-12-30"
"85178","2024","COM","2022","8637","276","8913","2024-12-30"
"85179","2024","COM","2022","1234","12","1246","2024-12-30"
"85181","2024","COM","2022","643","18","661","2024-12-30"
"85182","2024","COM","2022","5641","202","5843","2024-12-30"
"85184","2024","COM","2022","318","7","325","2024-12-30"
"85185","2024","COM","2022","646","10","656","2024-12-30"
"85186","2024","COM","2022","1018","26","1044","2024-12-30"
"85187","2024","COM","2022","861","15","876","2024-12-30"
"85188","2024","COM","2022","1157","14","1171","2024-12-30"
"85189","2024","COM","2022","2179","45","2224","2024-12-30"
"85190","2024","COM","2022","3571","67","3638","2024-12-30"
"85191","2024","COM","2022","54699","2828","57527","2024-12-30"
"85192","2024","COM","2022","980","19","999","2024-12-30"
"85193","2024","COM","2022","664","13","677","2024-12-30"
"85194","2024","COM","2022","48740","1251","49991","2024-12-30"
"85196","2024","COM","2022","1942","37","1979","2024-12-30"
"85197","2024","COM","2022","3833","63","3896","2024-12-30"
"85198","2024","COM","2022","1382","33","1415","2024-12-30"
"85199","2024","COM","2022","533","8","541","2024-12-30"
"85200","2024","COM","2022","1166","18","1184","2024-12-30"
"85201","2024","COM","2022","511","11","522","2024-12-30"
"85202","2024","COM","2022","1587","113","1700","2024-12-30"
"85204","2024","COM","2022","2653","42","2695","2024-12-30"
"85205","2024","COM","2022","543","6","549","2024-12-30"
"85206","2024","COM","2022","400","13","413","2024-12-30"
"85207","2024","COM","2022","413","10","423","2024-12-30"
"85208","2024","COM","2022","2425","40","2465","2024-12-30"
"85209","2024","COM","2022","613","10","623","2024-12-30"
"85210","2024","COM","2022","2251","24","2275","2024-12-30"
"85211","2024","COM","2022","2547","25","2572","2024-12-30"
"85212","2024","COM","2022","1338","22","1360","2024-12-30"
"85213","2024","COM","2022","4285","186","4471","2024-12-30"
"85214","2024","COM","2022","2592","37","2629","2024-12-30"
"85215","2024","COM","2022","3924","139","4063","2024-12-30"
"85216","2024","COM","2022","2074","198","2272","2024-12-30"
"85218","2024","COM","2022","1820","29","1849","2024-12-30"
"85220","2024","COM","2022","1629","27","1656","2024-12-30"
"85221","2024","COM","2022","2752","46","2798","2024-12-30"
"85222","2024","COM","2022","8140","242","8382","2024-12-30"
"85223","2024","COM","2022","2962","61","3023","2024-12-30"
"85226","2024","COM","2022","12923","263","13186","2024-12-30"
"85227","2024","COM","2022","1904","53","1957","2024-12-30"
"85229","2024","COM","2022","628","13","641","2024-12-30"
"85231","2024","COM","2022","824","11","835","2024-12-30"
"85232","2024","COM","2022","1095","25","1120","2024-12-30"
"85233","2024","COM","2022","631","11","642","2024-12-30"
"85234","2024","COM","2022","8809","215","9024","2024-12-30"
"85235","2024","COM","2022","427","13","440","2024-12-30"
"85236","2024","COM","2022","2018","28","2046","2024-12-30"
"85237","2024","COM","2022","394","7","401","2024-12-30"
"85238","2024","COM","2022","3613","366","3979","2024-12-30"
"85239","2024","COM","2022","1196","5","1201","2024-12-30"
"85240","2024","COM","2022","1619","57","1676","2024-12-30"
"85242","2024","COM","2022","1033","20","1053","2024-12-30"
"85243","2024","COM","2022","2933","47","2980","2024-12-30"
"85244","2024","COM","2022","802","69","871","2024-12-30"
"85245","2024","COM","2022","169","4","173","2024-12-30"
"85246","2024","COM","2022","2540","40","2580","2024-12-30"
"85247","2024","COM","2022","1144","19","1163","2024-12-30"
"85248","2024","COM","2022","421","13","434","2024-12-30"
"85250","2024","COM","2022","2443","45","2488","2024-12-30"
"85251","2024","COM","2022","637","16","653","2024-12-30"
"85252","2024","COM","2022","598","27","625","2024-12-30"
"85254","2024","COM","2022","1771","46","1817","2024-12-30"
"85255","2024","COM","2022","2347","69","2416","2024-12-30"
"85256","2024","COM","2022","1263","31","1294","2024-12-30"
"85259","2024","COM","2022","1382","37","1419","2024-12-30"
"85260","2024","COM","2022","857","12","869","2024-12-30"
"85261","2024","COM","2022","297","12","309","2024-12-30"
"85262","2024","COM","2022","3622","56","3678","2024-12-30"
"85264","2024","COM","2022","1340","18","1358","2024-12-30"
"85265","2024","COM","2022","924","23","947","2024-12-30"
"85266","2024","COM","2022","1671","27","1698","2024-12-30"
"85267","2024","COM","2022","982","18","1000","2024-12-30"
"85268","2024","COM","2022","1526","32","1558","2024-12-30"
"85269","2024","COM","2022","424","7","431","2024-12-30"
"85273","2024","COM","2022","1996","35","2031","2024-12-30"
"85274","2024","COM","2022","549","21","570","2024-12-30"
"85276","2024","COM","2022","753","13","766","2024-12-30"
"85277","2024","COM","2022","1592","24","1616","2024-12-30"
"85278","2024","COM","2022","1602","18","1620","2024-12-30"
"85280","2024","COM","2022","3390","63","3453","2024-12-30"
"85281","2024","COM","2022","1029","30","1059","2024-12-30"
"85282","2024","COM","2022","972","23","995","2024-12-30"
"85284","2024","COM","2022","4535","80","4615","2024-12-30"
"85285","2024","COM","2022","756","11","767","2024-12-30"
"85286","2024","COM","2022","551","4","555","2024-12-30"
"85287","2024","COM","2022","447","8","455","2024-12-30"
"85288","2024","COM","2022","8327","167","8494","2024-12-30"
"85289","2024","COM","2022","2173","43","2216","2024-12-30"
"85290","2024","COM","2022","538","12","550","2024-12-30"
"85291","2024","COM","2022","1255","20","1275","2024-12-30"
"85292","2024","COM","2022","1504","24","1528","2024-12-30"
"85293","2024","COM","2022","1556","33","1589","2024-12-30"
"85294","2024","COM","2022","3129","57","3186","2024-12-30"
"85295","2024","COM","2022","3361","84","3445","2024-12-30"
"85296","2024","COM","2022","1240","25","1265","2024-12-30"
"85297","2024","COM","2022","1061","9","1070","2024-12-30"
"85298","2024","COM","2022","1951","23","1974","2024-12-30"
"85300","2024","COM","2022","4743","181","4924","2024-12-30"
"85301","2024","COM","2022","1802","46","1848","2024-12-30"
"85302","2024","COM","2022","5580","130","5710","2024-12-30"
"85303","2024","COM","2022","1829","27","1856","2024-12-30"
"85304","2024","COM","2022","782","8","790","2024-12-30"
"85305","2024","COM","2022","823","64","887","2024-12-30"
"85306","2024","COM","2022","743","10","753","2024-12-30"
"86001","2024","COM","2022","701","18","719","2024-12-30"
"86002","2024","COM","2022","565","13","578","2024-12-30"
"86003","2024","COM","2022","329","11","340","2024-12-30"
"86004","2024","COM","2022","362","11","373","2024-12-30"
"86005","2024","COM","2022","607","19","626","2024-12-30"
"86006","2024","COM","2022","543","27","570","2024-12-30"
"86007","2024","COM","2022","1156","33","1189","2024-12-30"
"86008","2024","COM","2022","342","7","349","2024-12-30"
"86009","2024","COM","2022","1060","16","1076","2024-12-30"
"86010","2024","COM","2022","1130","22","1152","2024-12-30"
"86011","2024","COM","2022","189","2","191","2024-12-30"
"86012","2024","COM","2022","132","2","134","2024-12-30"
"86013","2024","COM","2022","101","1","102","2024-12-30"
"86014","2024","COM","2022","1738","42","1780","2024-12-30"
"86015","2024","COM","2022","1287","16","1303","2024-12-30"
"86016","2024","COM","2022","2227","41","2268","2024-12-30"
"86017","2024","COM","2022","1087","19","1106","2024-12-30"
"86018","2024","COM","2022","336","4","340","2024-12-30"
"86019","2024","COM","2022","2941","45","2986","2024-12-30"
"86020","2024","COM","2022","250","4","254","2024-12-30"
"86022","2024","COM","2022","253","5","258","2024-12-30"
"86023","2024","COM","2022","262","4","266","2024-12-30"
"86024","2024","COM","2022","1538","29","1567","2024-12-30"
"86025","2024","COM","2022","470","5","475","2024-12-30"
"86026","2024","COM","2022","558","5","563","2024-12-30"
"86027","2024","COM","2022","1908","32","1940","2024-12-30"
"86028","2024","COM","2022","1083","20","1103","2024-12-30"
"86029","2024","COM","2022","804","23","827","2024-12-30"
"86031","2024","COM","2022","1686","28","1714","2024-12-30"
"86032","2024","COM","2022","2096","95","2191","2024-12-30"
"86034","2024","COM","2022","623","13","636","2024-12-30"
"86035","2024","COM","2022","171","1","172","2024-12-30"
"86036","2024","COM","2022","929","21","950","2024-12-30"
"86037","2024","COM","2022","460","7","467","2024-12-30"
"86038","2024","COM","2022","221","5","226","2024-12-30"
"86039","2024","COM","2022","765","7","772","2024-12-30"
"86040","2024","COM","2022","301","9","310","2024-12-30"
"86041","2024","COM","2022","10253","122","10375","2024-12-30"
"86042","2024","COM","2022","901","15","916","2024-12-30"
"86044","2024","COM","2022","555","6","561","2024-12-30"
"86045","2024","COM","2022","1373","25","1398","2024-12-30"
"86046","2024","COM","2022","1690","28","1718","2024-12-30"
"86047","2024","COM","2022","478","10","488","2024-12-30"
"86048","2024","COM","2022","1258","19","1277","2024-12-30"
"86049","2024","COM","2022","474","8","482","2024-12-30"
"86050","2024","COM","2022","794","17","811","2024-12-30"
"86051","2024","COM","2022","213","2","215","2024-12-30"
"86052","2024","COM","2022","994","19","1013","2024-12-30"
"86053","2024","COM","2022","1890","46","1936","2024-12-30"
"86054","2024","COM","2022","354","4","358","2024-12-30"
"86055","2024","COM","2022","350","8","358","2024-12-30"
"86058","2024","COM","2022","730","7","737","2024-12-30"
"86059","2024","COM","2022","564","10","574","2024-12-30"
"86061","2024","COM","2022","1046","19","1065","2024-12-30"
"86062","2024","COM","2022","4776","66","4842","2024-12-30"
"86063","2024","COM","2022","241","4","245","2024-12-30"
"86064","2024","COM","2022","601","9","610","2024-12-30"
"86065","2024","COM","2022","1046","25","1071","2024-12-30"
"86066","2024","COM","2022","31105","696","31801","2024-12-30"
"86068","2024","COM","2022","1201","26","1227","2024-12-30"
"86069","2024","COM","2022","187","1","188","2024-12-30"
"86070","2024","COM","2022","7037","150","7187","2024-12-30"
"86072","2024","COM","2022","442","8","450","2024-12-30"
"86073","2024","COM","2022","516","8","524","2024-12-30"
"86074","2024","COM","2022","923","16","939","2024-12-30"
"86075","2024","COM","2022","801","11","812","2024-12-30"
"86076","2024","COM","2022","2875","48","2923","2024-12-30"
"86077","2024","COM","2022","1205","14","1219","2024-12-30"
"86078","2024","COM","2022","2543","132","2675","2024-12-30"
"86079","2024","COM","2022","562","36","598","2024-12-30"
"86080","2024","COM","2022","492","11","503","2024-12-30"
"86081","2024","COM","2022","1418","32","1450","2024-12-30"
"86082","2024","COM","2022","4323","128","4451","2024-12-30"
"86083","2024","COM","2022","1143","14","1157","2024-12-30"
"86084","2024","COM","2022","232","4","236","2024-12-30"
"86085","2024","COM","2022","260","7","267","2024-12-30"
"86086","2024","COM","2022","913","17","930","2024-12-30"
"86087","2024","COM","2022","183","5","188","2024-12-30"
"86088","2024","COM","2022","937","13","950","2024-12-30"
"86089","2024","COM","2022","389","6","395","2024-12-30"
"86090","2024","COM","2022","230","2","232","2024-12-30"
"86091","2024","COM","2022","374","7","381","2024-12-30"
"86092","2024","COM","2022","2968","58","3026","2024-12-30"
"86093","2024","COM","2022","163","4","167","2024-12-30"
"86094","2024","COM","2022","583","11","594","2024-12-30"
"86095","2024","COM","2022","3143","51","3194","2024-12-30"
"86096","2024","COM","2022","680","6","686","2024-12-30"
"86097","2024","COM","2022","334","4","338","2024-12-30"
"86098","2024","COM","2022","144","3","147","2024-12-30"
"86099","2024","COM","2022","1108","18","1126","2024-12-30"
"86100","2024","COM","2022","3971","78","4049","2024-12-30"
"86102","2024","COM","2022","612","10","622","2024-12-30"
"86103","2024","COM","2022","1681","61","1742","2024-12-30"
"86104","2024","COM","2022","493","5","498","2024-12-30"
"86105","2024","COM","2022","364","5","369","2024-12-30"
"86106","2024","COM","2022","100","2","102","2024-12-30"
"86107","2024","COM","2022","473","9","482","2024-12-30"
"86108","2024","COM","2022","396","4","400","2024-12-30"
"86109","2024","COM","2022","232","4","236","2024-12-30"
"86110","2024","COM","2022","230","8","238","2024-12-30"
"86111","2024","COM","2022","1704","64","1768","2024-12-30"
"86112","2024","COM","2022","1146","18","1164","2024-12-30"
"86113","2024","COM","2022","2989","59","3048","2024-12-30"
"86114","2024","COM","2022","1250","30","1280","2024-12-30"
"86115","2024","COM","2022","7597","263","7860","2024-12-30"
"86116","2024","COM","2022","797","20","817","2024-12-30"
"86117","2024","COM","2022","510","12","522","2024-12-30"
"86118","2024","COM","2022","368","9","377","2024-12-30"
"86119","2024","COM","2022","309","2","311","2024-12-30"
"86120","2024","COM","2022","1214","19","1233","2024-12-30"
"86121","2024","COM","2022","1483","21","1504","2024-12-30"
"86122","2024","COM","2022","68","2","70","2024-12-30"
"86123","2024","COM","2022","3041","55","3096","2024-12-30"
"86124","2024","COM","2022","1179","16","1195","2024-12-30"
"86125","2024","COM","2022","565","16","581","2024-12-30"
"86126","2024","COM","2022","644","16","660","2024-12-30"
"86127","2024","COM","2022","453","10","463","2024-12-30"
"86128","2024","COM","2022","2490","39","2529","2024-12-30"
"86129","2024","COM","2022","525","10","535","2024-12-30"
"86130","2024","COM","2022","370","3","373","2024-12-30"
"86131","2024","COM","2022","912","23","935","2024-12-30"
"86132","2024","COM","2022","301","5","306","2024-12-30"
"86133","2024","COM","2022","3429","57","3486","2024-12-30"
"86134","2024","COM","2022","217","0","217","2024-12-30"
"86135","2024","COM","2022","586","14","600","2024-12-30"
"86136","2024","COM","2022","381","8","389","2024-12-30"
"86137","2024","COM","2022","6791","291","7082","2024-12-30"
"86138","2024","COM","2022","248","3","251","2024-12-30"
"86139","2024","COM","2022","2556","57","2613","2024-12-30"
"86140","2024","COM","2022","2261","48","2309","2024-12-30"
"86141","2024","COM","2022","672","13","685","2024-12-30"
"86142","2024","COM","2022","640","14","654","2024-12-30"
"86143","2024","COM","2022","174","3","177","2024-12-30"
"86144","2024","COM","2022","324","7","331","2024-12-30"
"86145","2024","COM","2022","1119","27","1146","2024-12-30"
"86147","2024","COM","2022","603","7","610","2024-12-30"
"86148","2024","COM","2022","714","12","726","2024-12-30"
"86149","2024","COM","2022","360","11","371","2024-12-30"
"86150","2024","COM","2022","271","8","279","2024-12-30"
"86151","2024","COM","2022","187","3","190","2024-12-30"
"86152","2024","COM","2022","590","10","600","2024-12-30"
"86153","2024","COM","2022","853","11","864","2024-12-30"
"86154","2024","COM","2022","245","2","247","2024-12-30"
"86156","2024","COM","2022","241","5","246","2024-12-30"
"86157","2024","COM","2022","5224","182","5406","2024-12-30"
"86158","2024","COM","2022","6276","98","6374","2024-12-30"
"86159","2024","COM","2022","467","10","477","2024-12-30"
"86160","2024","COM","2022","2144","34","2178","2024-12-30"
"86161","2024","COM","2022","982","20","1002","2024-12-30"
"86162","2024","COM","2022","118","3","121","2024-12-30"
"86163","2024","COM","2022","3710","72","3782","2024-12-30"
"86164","2024","COM","2022","672","6","678","2024-12-30"
"86165","2024","COM","2022","5867","417","6284","2024-12-30"
"86167","2024","COM","2022","917","10","927","2024-12-30"
"86169","2024","COM","2022","368","4","372","2024-12-30"
"86170","2024","COM","2022","361","9","370","2024-12-30"
"86171","2024","COM","2022","433","21","454","2024-12-30"
"86172","2024","COM","2022","167","0","167","2024-12-30"
"86173","2024","COM","2022","621","7","628","2024-12-30"
"86174","2024","COM","2022","5954","81","6035","2024-12-30"
"86175","2024","COM","2022","306","14","320","2024-12-30"
"86176","2024","COM","2022","117","3","120","2024-12-30"
"86177","2024","COM","2022","5465","88","5553","2024-12-30"
"86178","2024","COM","2022","2680","53","2733","2024-12-30"
"86180","2024","COM","2022","2955","51","3006","2024-12-30"
"86181","2024","COM","2022","218","8","226","2024-12-30"
"86182","2024","COM","2022","356","8","364","2024-12-30"
"86183","2024","COM","2022","1620","22","1642","2024-12-30"
"86184","2024","COM","2022","954","12","966","2024-12-30"
"86186","2024","COM","2022","964","19","983","2024-12-30"
"86187","2024","COM","2022","474","14","488","2024-12-30"
"86189","2024","COM","2022","463","6","469","2024-12-30"
"86190","2024","COM","2022","718","13","731","2024-12-30"
"86191","2024","COM","2022","248","5","253","2024-12-30"
"86192","2024","COM","2022","177","3","180","2024-12-30"
"86193","2024","COM","2022","1208","11","1219","2024-12-30"
"86194","2024","COM","2022","89472","2236","91708","2024-12-30"
"86195","2024","COM","2022","548","7","555","2024-12-30"
"86196","2024","COM","2022","232","5","237","2024-12-30"
"86197","2024","COM","2022","412","12","424","2024-12-30"
"86198","2024","COM","2022","731","12","743","2024-12-30"
"86200","2024","COM","2022","551","12","563","2024-12-30"
"86201","2024","COM","2022","204","6","210","2024-12-30"
"86202","2024","COM","2022","604","8","612","2024-12-30"
"86203","2024","COM","2022","570","10","580","2024-12-30"
"86204","2024","COM","2022","2113","57","2170","2024-12-30"
"86205","2024","COM","2022","204","9","213","2024-12-30"
"86206","2024","COM","2022","135","2","137","2024-12-30"
"86207","2024","COM","2022","1571","31","1602","2024-12-30"
"86209","2024","COM","2022","2174","37","2211","2024-12-30"
"86210","2024","COM","2022","748","16","764","2024-12-30"
"86211","2024","COM","2022","803","98","901","2024-12-30"
"86213","2024","COM","2022","2521","190","2711","2024-12-30"
"86214","2024","COM","2022","7306","183","7489","2024-12-30"
"86217","2024","COM","2022","278","9","287","2024-12-30"
"86218","2024","COM","2022","205","5","210","2024-12-30"
"86220","2024","COM","2022","312","8","320","2024-12-30"
"86221","2024","COM","2022","1211","19","1230","2024-12-30"
"86222","2024","COM","2022","4345","61","4406","2024-12-30"
"86223","2024","COM","2022","883","25","908","2024-12-30"
"86224","2024","COM","2022","1318","31","1349","2024-12-30"
"86225","2024","COM","2022","1292","20","1312","2024-12-30"
"86226","2024","COM","2022","2871","55","2926","2024-12-30"
"86227","2024","COM","2022","136","1","137","2024-12-30"
"86228","2024","COM","2022","196","6","202","2024-12-30"
"86229","2024","COM","2022","347","7","354","2024-12-30"
"86230","2024","COM","2022","171","3","174","2024-12-30"
"86233","2024","COM","2022","2728","61","2789","2024-12-30"
"86234","2024","COM","2022","369","6","375","2024-12-30"
"86235","2024","COM","2022","1310","36","1346","2024-12-30"
"86236","2024","COM","2022","852","26","878","2024-12-30"
"86237","2024","COM","2022","728","7","735","2024-12-30"
"86239","2024","COM","2022","184","0","184","2024-12-30"
"86241","2024","COM","2022","453","7","460","2024-12-30"
"86242","2024","COM","2022","390","9","399","2024-12-30"
"86244","2024","COM","2022","1298","27","1325","2024-12-30"
"86245","2024","COM","2022","1724","42","1766","2024-12-30"
"86246","2024","COM","2022","816","11","827","2024-12-30"
"86247","2024","COM","2022","1007","33","1040","2024-12-30"
"86248","2024","COM","2022","531","15","546","2024-12-30"
"86249","2024","COM","2022","124","2","126","2024-12-30"
"86250","2024","COM","2022","263","9","272","2024-12-30"
"86252","2024","COM","2022","648","16","664","2024-12-30"
"86253","2024","COM","2022","548","13","561","2024-12-30"
"86254","2024","COM","2022","1005","15","1020","2024-12-30"
"86255","2024","COM","2022","1265","21","1286","2024-12-30"
"86256","2024","COM","2022","1247","26","1273","2024-12-30"
"86257","2024","COM","2022","377","4","381","2024-12-30"
"86258","2024","COM","2022","2177","44","2221","2024-12-30"
"86260","2024","COM","2022","314","4","318","2024-12-30"
"86261","2024","COM","2022","2354","77","2431","2024-12-30"
"86262","2024","COM","2022","571","13","584","2024-12-30"
"86263","2024","COM","2022","2941","48","2989","2024-12-30"
"86264","2024","COM","2022","738","19","757","2024-12-30"
"86265","2024","COM","2022","414","6","420","2024-12-30"
"86266","2024","COM","2022","124","1","125","2024-12-30"
"86268","2024","COM","2022","1134","20","1154","2024-12-30"
"86269","2024","COM","2022","192","3","195","2024-12-30"
"86270","2024","COM","2022","163","3","166","2024-12-30"
"86271","2024","COM","2022","732","15","747","2024-12-30"
"86272","2024","COM","2022","2787","166","2953","2024-12-30"
"86273","2024","COM","2022","863","21","884","2024-12-30"
"86274","2024","COM","2022","1082","24","1106","2024-12-30"
"86275","2024","COM","2022","582","11","593","2024-12-30"
"86276","2024","COM","2022","1226","16","1242","2024-12-30"
"86279","2024","COM","2022","543","12","555","2024-12-30"
"86280","2024","COM","2022","349","6","355","2024-12-30"
"86281","2024","COM","2022","5663","84","5747","2024-12-30"
"86284","2024","COM","2022","721","11","732","2024-12-30"
"86285","2024","COM","2022","930","23","953","2024-12-30"
"86286","2024","COM","2022","382","5","387","2024-12-30"
"86287","2024","COM","2022","346","7","353","2024-12-30"
"86288","2024","COM","2022","656","19","675","2024-12-30"
"86289","2024","COM","2022","656","29","685","2024-12-30"
"86290","2024","COM","2022","1526","33","1559","2024-12-30"
"86291","2024","COM","2022","101","4","105","2024-12-30"
"86292","2024","COM","2022","955","18","973","2024-12-30"
"86293","2024","COM","2022","4505","76","4581","2024-12-30"
"86294","2024","COM","2022","3707","79","3786","2024-12-30"
"86295","2024","COM","2022","394","6","400","2024-12-30"
"86296","2024","COM","2022","468","8","476","2024-12-30"
"86297","2024","COM","2022","6245","149","6394","2024-12-30"
"86298","2024","COM","2022","2278","46","2324","2024-12-30"
"86299","2024","COM","2022","563","9","572","2024-12-30"
"86300","2024","COM","2022","636","5","641","2024-12-30"
"87001","2024","COM","2022","5860","80","5940","2024-12-30"
"87002","2024","COM","2022","5565","68","5633","2024-12-30"
"87003","2024","COM","2022","911","13","924","2024-12-30"
"87004","2024","COM","2022","124","1","125","2024-12-30"
"87005","2024","COM","2022","1033","22","1055","2024-12-30"
"87006","2024","COM","2022","240","3","243","2024-12-30"
"87007","2024","COM","2022","199","2","201","2024-12-30"
"87008","2024","COM","2022","144","2","146","2024-12-30"
"87009","2024","COM","2022","136","1","137","2024-12-30"
"87011","2024","COM","2022","3569","133","3702","2024-12-30"
"87012","2024","COM","2022","429","4","433","2024-12-30"
"87013","2024","COM","2022","626","5","631","2024-12-30"
"87014","2024","COM","2022","2739","54","2793","2024-12-30"
"87015","2024","COM","2022","727","53","780","2024-12-30"
"87016","2024","COM","2022","298","6","304","2024-12-30"
"87017","2024","COM","2022","479","9","488","2024-12-30"
"87018","2024","COM","2022","690","24","714","2024-12-30"
"87019","2024","COM","2022","2997","63","3060","2024-12-30"
"87020","2024","COM","2022","1644","29","1673","2024-12-30"
"87021","2024","COM","2022","2620","34","2654","2024-12-30"
"87022","2024","COM","2022","114","1","115","2024-12-30"
"87023","2024","COM","2022","183","4","187","2024-12-30"
"87024","2024","COM","2022","873","10","883","2024-12-30"
"87025","2024","COM","2022","858","18","876","2024-12-30"
"87027","2024","COM","2022","1284","14","1298","2024-12-30"
"87028","2024","COM","2022","1712","22","1734","2024-12-30"
"87029","2024","COM","2022","618","10","628","2024-12-30"
"87030","2024","COM","2022","1253","28","1281","2024-12-30"
"87031","2024","COM","2022","302","4","306","2024-12-30"
"87032","2024","COM","2022","1671","29","1700","2024-12-30"
"87033","2024","COM","2022","788","6","794","2024-12-30"
"87034","2024","COM","2022","591","4","595","2024-12-30"
"87035","2024","COM","2022","517","9","526","2024-12-30"
"87036","2024","COM","2022","688","10","698","2024-12-30"
"87037","2024","COM","2022","264","4","268","2024-12-30"
"87038","2024","COM","2022","2096","18","2114","2024-12-30"
"87039","2024","COM","2022","791","20","811","2024-12-30"
"87040","2024","COM","2022","1536","27","1563","2024-12-30"
"87041","2024","COM","2022","2028","26","2054","2024-12-30"
"87042","2024","COM","2022","399","3","402","2024-12-30"
"87043","2024","COM","2022","223","1","224","2024-12-30"
"87044","2024","COM","2022","315","5","320","2024-12-30"
"87045","2024","COM","2022","1001","21","1022","2024-12-30"
"87046","2024","COM","2022","1199","8","1207","2024-12-30"
"87047","2024","COM","2022","1866","25","1891","2024-12-30"
"87048","2024","COM","2022","5208","69","5277","2024-12-30"
"87049","2024","COM","2022","1272","24","1296","2024-12-30"
"87050","2024","COM","2022","10011","133","10144","2024-12-30"
"87051","2024","COM","2022","690","8","698","2024-12-30"
"87052","2024","COM","2022","163","3","166","2024-12-30"
"87053","2024","COM","2022","246","1","247","2024-12-30"
"87054","2024","COM","2022","1148","12","1160","2024-12-30"
"87056","2024","COM","2022","245","5","250","2024-12-30"
"87057","2024","COM","2022","373","3","376","2024-12-30"
"87058","2024","COM","2022","99","5","104","2024-12-30"
"87059","2024","COM","2022","1526","61","1587","2024-12-30"
"87060","2024","COM","2022","669","8","677","2024-12-30"
"87061","2024","COM","2022","361","5","366","2024-12-30"
"87062","2024","COM","2022","471","8","479","2024-12-30"
"87063","2024","COM","2022","1335","20","1355","2024-12-30"
"87064","2024","COM","2022","2067","27","2094","2024-12-30"
"87065","2024","COM","2022","6174","68","6242","2024-12-30"
"87066","2024","COM","2022","1060","11","1071","2024-12-30"
"87067","2024","COM","2022","443","5","448","2024-12-30"
"87068","2024","COM","2022","517","15","532","2024-12-30"
"87069","2024","COM","2022","148","1","149","2024-12-30"
"87070","2024","COM","2022","988","18","1006","2024-12-30"
"87071","2024","COM","2022","806","13","819","2024-12-30"
"87072","2024","COM","2022","510","11","521","2024-12-30"
"87073","2024","COM","2022","388","6","394","2024-12-30"
"87074","2024","COM","2022","227","7","234","2024-12-30"
"87075","2024","COM","2022","7915","105","8020","2024-12-30"
"87076","2024","COM","2022","239","3","242","2024-12-30"
"87077","2024","COM","2022","525","9","534","2024-12-30"
"87078","2024","COM","2022","702","11","713","2024-12-30"
"87079","2024","COM","2022","802","13","815","2024-12-30"
"87080","2024","COM","2022","189","0","189","2024-12-30"
"87081","2024","COM","2022","1112","15","1127","2024-12-30"
"87082","2024","COM","2022","1159","13","1172","2024-12-30"
"87083","2024","COM","2022","528","7","535","2024-12-30"
"87084","2024","COM","2022","162","4","166","2024-12-30"
"87085","2024","COM","2022","129754","1905","131659","2024-12-30"
"87086","2024","COM","2022","1004","15","1019","2024-12-30"
"87087","2024","COM","2022","463","3","466","2024-12-30"
"87088","2024","COM","2022","1115","19","1134","2024-12-30"
"87089","2024","COM","2022","1693","165","1858","2024-12-30"
"87090","2024","COM","2022","273","5","278","2024-12-30"
"87091","2024","COM","2022","376","4","380","2024-12-30"
"87092","2024","COM","2022","481","6","487","2024-12-30"
"87093","2024","COM","2022","286","7","293","2024-12-30"
"87094","2024","COM","2022","526","13","539","2024-12-30"
"87095","2024","COM","2022","733","11","744","2024-12-30"
"87096","2024","COM","2022","842","19","861","2024-12-30"
"87097","2024","COM","2022","1031","10","1041","2024-12-30"
"87099","2024","COM","2022","328","16","344","2024-12-30"
"87100","2024","COM","2022","253","2","255","2024-12-30"
"87101","2024","COM","2022","127","1","128","2024-12-30"
"87103","2024","COM","2022","1584","21","1605","2024-12-30"
"87104","2024","COM","2022","455","6","461","2024-12-30"
"87105","2024","COM","2022","874","13","887","2024-12-30"
"87106","2024","COM","2022","2542","47","2589","2024-12-30"
"87107","2024","COM","2022","1594","14","1608","2024-12-30"
"87108","2024","COM","2022","430","7","437","2024-12-30"
"87109","2024","COM","2022","354","35","389","2024-12-30"
"87110","2024","COM","2022","2517","34","2551","2024-12-30"
"87111","2024","COM","2022","1602","25","1627","2024-12-30"
"87112","2024","COM","2022","639","6","645","2024-12-30"
"87113","2024","COM","2022","5861","69","5930","2024-12-30"
"87114","2024","COM","2022","11207","185","11392","2024-12-30"
"87115","2024","COM","2022","179","1","180","2024-12-30"
"87116","2024","COM","2022","1059","16","1075","2024-12-30"
"87117","2024","COM","2022","1028","14","1042","2024-12-30"
"87118","2024","COM","2022","1356","20","1376","2024-12-30"
"87119","2024","COM","2022","1147","20","1167","2024-12-30"
"87120","2024","COM","2022","518","10","528","2024-12-30"
"87121","2024","COM","2022","477","9","486","2024-12-30"
"87122","2024","COM","2022","1161","10","1171","2024-12-30"
"87123","2024","COM","2022","145","0","145","2024-12-30"
"87124","2024","COM","2022","381","5","386","2024-12-30"
"87125","2024","COM","2022","4733","69","4802","2024-12-30"
"87126","2024","COM","2022","3637","47","3684","2024-12-30"
"87127","2024","COM","2022","594","14","608","2024-12-30"
"87128","2024","COM","2022","1364","22","1386","2024-12-30"
"87129","2024","COM","2022","942","8","950","2024-12-30"
"87130","2024","COM","2022","161","0","161","2024-12-30"
"87131","2024","COM","2022","826","12","838","2024-12-30"
"87132","2024","COM","2022","112","2","114","2024-12-30"
"87133","2024","COM","2022","485","4","489","2024-12-30"
"87134","2024","COM","2022","140","3","143","2024-12-30"
"87135","2024","COM","2022","969","15","984","2024-12-30"
"87137","2024","COM","2022","143","2","145","2024-12-30"
"87138","2024","COM","2022","538","11","549","2024-12-30"
"87139","2024","COM","2022","456","6","462","2024-12-30"
"87140","2024","COM","2022","1651","31","1682","2024-12-30"
"87141","2024","COM","2022","676","9","685","2024-12-30"
"87142","2024","COM","2022","549","6","555","2024-12-30"
"87143","2024","COM","2022","2208","39","2247","2024-12-30"
"87144","2024","COM","2022","541","3","544","2024-12-30"
"87145","2024","COM","2022","232","3","235","2024-12-30"
"87146","2024","COM","2022","1148","15","1163","2024-12-30"
"87147","2024","COM","2022","44","1","45","2024-12-30"
"87148","2024","COM","2022","1005","17","1022","2024-12-30"
"87149","2024","COM","2022","360","3","363","2024-12-30"
"87150","2024","COM","2022","830","15","845","2024-12-30"
"87151","2024","COM","2022","489","5","494","2024-12-30"
"87152","2024","COM","2022","1630","29","1659","2024-12-30"
"87153","2024","COM","2022","296","0","296","2024-12-30"
"87154","2024","COM","2022","11382","288","11670","2024-12-30"
"87155","2024","COM","2022","182","8","190","2024-12-30"
"87156","2024","COM","2022","2654","55","2709","2024-12-30"
"87157","2024","COM","2022","842","32","874","2024-12-30"
"87158","2024","COM","2022","1391","12","1403","2024-12-30"
"87159","2024","COM","2022","358","3","361","2024-12-30"
"87160","2024","COM","2022","489","4","493","2024-12-30"
"87161","2024","COM","2022","4319","111","4430","2024-12-30"
"87162","2024","COM","2022","206","2","208","2024-12-30"
"87163","2024","COM","2022","146","2","148","2024-12-30"
"87164","2024","COM","2022","567","9","576","2024-12-30"
"87165","2024","COM","2022","145","1","146","2024-12-30"
"87166","2024","COM","2022","878","11","889","2024-12-30"
"87167","2024","COM","2022","580","11","591","2024-12-30"
"87168","2024","COM","2022","1069","15","1084","2024-12-30"
"87169","2024","COM","2022","1041","24","1065","2024-12-30"
"87170","2024","COM","2022","367","4","371","2024-12-30"
"87172","2024","COM","2022","214","5","219","2024-12-30"
"87174","2024","COM","2022","1235","26","1261","2024-12-30"
"87176","2024","COM","2022","696","5","701","2024-12-30"
"87177","2024","COM","2022","1764","25","1789","2024-12-30"
"87178","2024","COM","2022","2896","27","2923","2024-12-30"
"87179","2024","COM","2022","224","0","224","2024-12-30"
"87180","2024","COM","2022","562","4","566","2024-12-30"
"87181","2024","COM","2022","804","17","821","2024-12-30"
"87182","2024","COM","2022","1196","16","1212","2024-12-30"
"87183","2024","COM","2022","922","11","933","2024-12-30"
"87185","2024","COM","2022","1767","25","1792","2024-12-30"
"87186","2024","COM","2022","323","5","328","2024-12-30"
"87187","2024","COM","2022","6873","336","7209","2024-12-30"
"87188","2024","COM","2022","441","2","443","2024-12-30"
"87189","2024","COM","2022","157","1","158","2024-12-30"
"87190","2024","COM","2022","879","9","888","2024-12-30"
"87191","2024","COM","2022","2045","20","2065","2024-12-30"
"87192","2024","COM","2022","1561","24","1585","2024-12-30"
"87193","2024","COM","2022","54","2","56","2024-12-30"
"87194","2024","COM","2022","364","0","364","2024-12-30"
"87195","2024","COM","2022","128","1","129","2024-12-30"
"87197","2024","COM","2022","563","6","569","2024-12-30"
"87198","2024","COM","2022","397","7","404","2024-12-30"
"87199","2024","COM","2022","708","6","714","2024-12-30"
"87200","2024","COM","2022","122","1","123","2024-12-30"
"87201","2024","COM","2022","4940","216","5156","2024-12-30"
"87202","2024","COM","2022","2162","33","2195","2024-12-30"
"87203","2024","COM","2022","1327","31","1358","2024-12-30"
"87204","2024","COM","2022","204","4","208","2024-12-30"
"87205","2024","COM","2022","2298","38","2336","2024-12-30"
"87206","2024","COM","2022","164","2","166","2024-12-30"
"88001","2024","COM","2022","67","3","70","2024-12-30"
"88002","2024","COM","2022","67","4","71","2024-12-30"
"88003","2024","COM","2022","61","0","61","2024-12-30"
"88004","2024","COM","2022","136","2","138","2024-12-30"
"88005","2024","COM","2022","209","2","211","2024-12-30"
"88006","2024","COM","2022","290","4","294","2024-12-30"
"88007","2024","COM","2022","47","1","48","2024-12-30"
"88008","2024","COM","2022","152","3","155","2024-12-30"
"88009","2024","COM","2022","3262","65","3327","2024-12-30"
"88010","2024","COM","2022","196","3","199","2024-12-30"
"88011","2024","COM","2022","1614","56","1670","2024-12-30"
"88012","2024","COM","2022","1110","22","1132","2024-12-30"
"88013","2024","COM","2022","91","0","91","2024-12-30"
"88014","2024","COM","2022","177","4","181","2024-12-30"
"88015","2024","COM","2022","210","2","212","2024-12-30"
"88016","2024","COM","2022","202","8","210","2024-12-30"
"88017","2024","COM","2022","165","3","168","2024-12-30"
"88019","2024","COM","2022","136","3","139","2024-12-30"
"88020","2024","COM","2022","191","5","196","2024-12-30"
"88021","2024","COM","2022","275","9","284","2024-12-30"
"88022","2024","COM","2022","207","4","211","2024-12-30"
"88023","2024","COM","2022","87","0","87","2024-12-30"
"88024","2024","COM","2022","115","0","115","2024-12-30"
"88025","2024","COM","2022","69","0","69","2024-12-30"
"88026","2024","COM","2022","1007","22","1029","2024-12-30"
"88027","2024","COM","2022","139","6","145","2024-12-30"
"88028","2024","COM","2022","621","69","690","2024-12-30"
"88029","2024","COM","2022","1556","137","1693","2024-12-30"
"88030","2024","COM","2022","160","0","160","2024-12-30"
"88031","2024","COM","2022","100","4","104","2024-12-30"
"88032","2024","COM","2022","1163","35","1198","2024-12-30"
"88033","2024","COM","2022","358","6","364","2024-12-30"
"88035","2024","COM","2022","144","5","149","2024-12-30"
"88036","2024","COM","2022","80","1","81","2024-12-30"
"88037","2024","COM","2022","854","20","874","2024-12-30"
"88038","2024","COM","2022","34","0","34","2024-12-30"
"88039","2024","COM","2022","330","7","337","2024-12-30"
"88040","2024","COM","2022","234","5","239","2024-12-30"
"88041","2024","COM","2022","98","7","105","2024-12-30"
"88042","2024","COM","2022","79","1","80","2024-12-30"
"88043","2024","COM","2022","115","2","117","2024-12-30"
"88044","2024","COM","2022","612","15","627","2024-12-30"
"88045","2024","COM","2022","88","0","88","2024-12-30"
"88046","2024","COM","2022","132","1","133","2024-12-30"
"88047","2024","COM","2022","141","2","143","2024-12-30"
"88048","2024","COM","2022","959","25","984","2024-12-30"
"88049","2024","COM","2022","109","5","114","2024-12-30"
"88050","2024","COM","2022","297","6","303","2024-12-30"
"88051","2024","COM","2022","124","3","127","2024-12-30"
"88052","2024","COM","2022","91","2","93","2024-12-30"
"88053","2024","COM","2022","153","0","153","2024-12-30"
"88054","2024","COM","2022","312","4","316","2024-12-30"
"88055","2024","COM","2022","162","0","162","2024-12-30"
"88056","2024","COM","2022","91","3","94","2024-12-30"
"88057","2024","COM","2022","90","2","92","2024-12-30"
"88058","2024","COM","2022","91","5","96","2024-12-30"
"88059","2024","COM","2022","393","9","402","2024-12-30"
"88060","2024","COM","2022","30","0","30","2024-12-30"
"88061","2024","COM","2022","285","10","295","2024-12-30"
"88062","2024","COM","2022","91","1","92","2024-12-30"
"88063","2024","COM","2022","133","6","139","2024-12-30"
"88064","2024","COM","2022","105","4","109","2024-12-30"
"88065","2024","COM","2022","275","6","281","2024-12-30"
"88066","2024","COM","2022","63","4","67","2024-12-30"
"88068","2024","COM","2022","862","22","884","2024-12-30"
"88069","2024","COM","2022","144","5","149","2024-12-30"
"88070","2024","COM","2022","178","2","180","2024-12-30"
"88071","2024","COM","2022","47","3","50","2024-12-30"
"88073","2024","COM","2022","200","4","204","2024-12-30"
"88074","2024","COM","2022","57","2","59","2024-12-30"
"88075","2024","COM","2022","3947","129","4076","2024-12-30"
"88076","2024","COM","2022","411","8","419","2024-12-30"
"88077","2024","COM","2022","566","13","579","2024-12-30"
"88078","2024","COM","2022","2935","36","2971","2024-12-30"
"88079","2024","COM","2022","1523","103","1626","2024-12-30"
"88080","2024","COM","2022","303","7","310","2024-12-30"
"88081","2024","COM","2022","1289","18","1307","2024-12-30"
"88082","2024","COM","2022","751","11","762","2024-12-30"
"88083","2024","COM","2022","214","12","226","2024-12-30"
"88084","2024","COM","2022","442","7","449","2024-12-30"
"88085","2024","COM","2022","192","2","194","2024-12-30"
"88086","2024","COM","2022","481","22","503","2024-12-30"
"88087","2024","COM","2022","3201","93","3294","2024-12-30"
"88088","2024","COM","2022","672","8","680","2024-12-30"
"88089","2024","COM","2022","549","13","562","2024-12-30"
"88090","2024","COM","2022","4489","48","4537","2024-12-30"
"88091","2024","COM","2022","379","10","389","2024-12-30"
"88092","2024","COM","2022","584","9","593","2024-12-30"
"88093","2024","COM","2022","36","1","37","2024-12-30"
"88094","2024","COM","2022","1726","53","1779","2024-12-30"
"88095","2024","COM","2022","1721","28","1749","2024-12-30"
"88096","2024","COM","2022","106","6","112","2024-12-30"
"88097","2024","COM","2022","41","0","41","2024-12-30"
"88098","2024","COM","2022","913","20","933","2024-12-30"
"88099","2024","COM","2022","1372","33","1405","2024-12-30"
"88100","2024","COM","2022","48","1","49","2024-12-30"
"88101","2024","COM","2022","1227","11","1238","2024-12-30"
"88102","2024","COM","2022","86","2","88","2024-12-30"
"88103","2024","COM","2022","80","1","81","2024-12-30"
"88104","2024","COM","2022","184","2","186","2024-12-30"
"88105","2024","COM","2022","216","3","219","2024-12-30"
"88106","2024","COM","2022","961","22","983","2024-12-30"
"88107","2024","COM","2022","27","0","27","2024-12-30"
"88108","2024","COM","2022","463","13","476","2024-12-30"
"88109","2024","COM","2022","648","13","661","2024-12-30"
"88110","2024","COM","2022","219","4","223","2024-12-30"
"88111","2024","COM","2022","349","4","353","2024-12-30"
"88113","2024","COM","2022","137","1","138","2024-12-30"
"88114","2024","COM","2022","2932","198","3130","2024-12-30"
"88115","2024","COM","2022","1490","11","1501","2024-12-30"
"88116","2024","COM","2022","3037","71","3108","2024-12-30"
"88117","2024","COM","2022","76","0","76","2024-12-30"
"88118","2024","COM","2022","719","19","738","2024-12-30"
"88119","2024","COM","2022","180","5","185","2024-12-30"
"88120","2024","COM","2022","456","7","463","2024-12-30"
"88121","2024","COM","2022","273","3","276","2024-12-30"
"88122","2024","COM","2022","384","7","391","2024-12-30"
"88123","2024","COM","2022","258","5","263","2024-12-30"
"88124","2024","COM","2022","1078","36","1114","2024-12-30"
"88125","2024","COM","2022","62","2","64","2024-12-30"
"88126","2024","COM","2022","1367","26","1393","2024-12-30"
"88127","2024","COM","2022","55","1","56","2024-12-30"
"88128","2024","COM","2022","250","6","256","2024-12-30"
"88129","2024","COM","2022","99","2","101","2024-12-30"
"88130","2024","COM","2022","238","5","243","2024-12-30"
"88131","2024","COM","2022","298","13","311","2024-12-30"
"88132","2024","COM","2022","1350","38","1388","2024-12-30"
"88133","2024","COM","2022","207","9","216","2024-12-30"
"88134","2024","COM","2022","652","16","668","2024-12-30"
"88135","2024","COM","2022","864","23","887","2024-12-30"
"88136","2024","COM","2022","1511","27","1538","2024-12-30"
"88137","2024","COM","2022","90","1","91","2024-12-30"
"88138","2024","COM","2022","77","2","79","2024-12-30"
"88139","2024","COM","2022","124","1","125","2024-12-30"
"88140","2024","COM","2022","358","14","372","2024-12-30"
"88141","2024","COM","2022","241","1","242","2024-12-30"
"88142","2024","COM","2022","433","6","439","2024-12-30"
"88143","2024","COM","2022","266","2","268","2024-12-30"
"88144","2024","COM","2022","61","0","61","2024-12-30"
"88145","2024","COM","2022","212","2","214","2024-12-30"
"88146","2024","COM","2022","177","2","179","2024-12-30"
"88147","2024","COM","2022","399","9","408","2024-12-30"
"88148","2024","COM","2022","1900","38","1938","2024-12-30"
"88149","2024","COM","2022","52","4","56","2024-12-30"
"88150","2024","COM","2022","292","6","298","2024-12-30"
"88151","2024","COM","2022","1079","25","1104","2024-12-30"
"88152","2024","COM","2022","240","7","247","2024-12-30"
"88153","2024","COM","2022","338","7","345","2024-12-30"
"88154","2024","COM","2022","94","1","95","2024-12-30"
"88155","2024","COM","2022","95","3","98","2024-12-30"
"88156","2024","COM","2022","156","1","157","2024-12-30"
"88157","2024","COM","2022","871","13","884","2024-12-30"
"88158","2024","COM","2022","3117","55","3172","2024-12-30"
"88159","2024","COM","2022","509","13","522","2024-12-30"
"88160","2024","COM","2022","32296","1292","33588","2024-12-30"
"88161","2024","COM","2022","385","10","395","2024-12-30"
"88162","2024","COM","2022","170","4","174","2024-12-30"
"88163","2024","COM","2022","745","10","755","2024-12-30"
"88164","2024","COM","2022","106","1","107","2024-12-30"
"88165","2024","COM","2022","2454","55","2509","2024-12-30"
"88166","2024","COM","2022","355","5","360","2024-12-30"
"88167","2024","COM","2022","227","4","231","2024-12-30"
"88168","2024","COM","2022","131","2","133","2024-12-30"
"88169","2024","COM","2022","219","3","222","2024-12-30"
"88170","2024","COM","2022","731","11","742","2024-12-30"
"88171","2024","COM","2022","50","1","51","2024-12-30"
"88172","2024","COM","2022","232","6","238","2024-12-30"
"88173","2024","COM","2022","473","10","483","2024-12-30"
"88174","2024","COM","2022","141","4","145","2024-12-30"
"88175","2024","COM","2022","471","16","487","2024-12-30"
"88176","2024","COM","2022","499","35","534","2024-12-30"
"88177","2024","COM","2022","515","9","524","2024-12-30"
"88178","2024","COM","2022","1779","67","1846","2024-12-30"
"88179","2024","COM","2022","41","3","44","2024-12-30"
"88180","2024","COM","2022","125","2","127","2024-12-30"
"88181","2024","COM","2022","2849","24","2873","2024-12-30"
"88182","2024","COM","2022","199","9","208","2024-12-30"
"88183","2024","COM","2022","352","6","358","2024-12-30"
"88184","2024","COM","2022","421","7","428","2024-12-30"
"88185","2024","COM","2022","101","3","104","2024-12-30"
"88186","2024","COM","2022","47","0","47","2024-12-30"
"88187","2024","COM","2022","49","3","52","2024-12-30"
"88188","2024","COM","2022","1662","38","1700","2024-12-30"
"88189","2024","COM","2022","132","7","139","2024-12-30"
"88190","2024","COM","2022","484","8","492","2024-12-30"
"88192","2024","COM","2022","107","1","108","2024-12-30"
"88193","2024","COM","2022","152","1","153","2024-12-30"
"88194","2024","COM","2022","126","8","134","2024-12-30"
"88195","2024","COM","2022","104","2","106","2024-12-30"
"88196","2024","COM","2022","7685","596","8281","2024-12-30"
"88197","2024","COM","2022","353","10","363","2024-12-30"
"88198","2024","COM","2022","537","16","553","2024-12-30"
"88199","2024","COM","2022","76","1","77","2024-12-30"
"88200","2024","COM","2022","58","1","59","2024-12-30"
"88201","2024","COM","2022","873","18","891","2024-12-30"
"88202","2024","COM","2022","195","3","198","2024-12-30"
"88203","2024","COM","2022","353","6","359","2024-12-30"
"88205","2024","COM","2022","256","4","260","2024-12-30"
"88206","2024","COM","2022","858","22","880","2024-12-30"
"88208","2024","COM","2022","116","3","119","2024-12-30"
"88209","2024","COM","2022","8827","119","8946","2024-12-30"
"88210","2024","COM","2022","169","3","172","2024-12-30"
"88212","2024","COM","2022","364","2","366","2024-12-30"
"88213","2024","COM","2022","130","0","130","2024-12-30"
"88214","2024","COM","2022","70","3","73","2024-12-30"
"88215","2024","COM","2022","75","2","77","2024-12-30"
"88216","2024","COM","2022","724","12","736","2024-12-30"
"88218","2024","COM","2022","2560","53","2613","2024-12-30"
"88219","2024","COM","2022","132","6","138","2024-12-30"
"88220","2024","COM","2022","47","1","48","2024-12-30"
"88221","2024","COM","2022","210","11","221","2024-12-30"
"88222","2024","COM","2022","228","33","261","2024-12-30"
"88223","2024","COM","2022","171","4","175","2024-12-30"
"88224","2024","COM","2022","378","12","390","2024-12-30"
"88225","2024","COM","2022","2331","88","2419","2024-12-30"
"88226","2024","COM","2022","128","1","129","2024-12-30"
"88227","2024","COM","2022","81","3","84","2024-12-30"
"88228","2024","COM","2022","181","3","184","2024-12-30"
"88229","2024","COM","2022","87","2","89","2024-12-30"
"88230","2024","COM","2022","35","1","36","2024-12-30"
"88231","2024","COM","2022","470","20","490","2024-12-30"
"88232","2024","COM","2022","210","3","213","2024-12-30"
"88233","2024","COM","2022","627","70","697","2024-12-30"
"88236","2024","COM","2022","134","0","134","2024-12-30"
"88237","2024","COM","2022","342","8","350","2024-12-30"
"88238","2024","COM","2022","387","10","397","2024-12-30"
"88239","2024","COM","2022","130","2","132","2024-12-30"
"88240","2024","COM","2022","268","3","271","2024-12-30"
"88241","2024","COM","2022","424","11","435","2024-12-30"
"88242","2024","COM","2022","43","1","44","2024-12-30"
"88243","2024","COM","2022","489","11","500","2024-12-30"
"88244","2024","COM","2022","509","18","527","2024-12-30"
"88245","2024","COM","2022","291","6","297","2024-12-30"
"88246","2024","COM","2022","488","15","503","2024-12-30"
"88247","2024","COM","2022","1143","13","1156","2024-12-30"
"88248","2024","COM","2022","172","5","177","2024-12-30"
"88249","2024","COM","2022","72","0","72","2024-12-30"
"88250","2024","COM","2022","437","8","445","2024-12-30"
"88251","2024","COM","2022","1108","24","1132","2024-12-30"
"88252","2024","COM","2022","151","3","154","2024-12-30"
"88253","2024","COM","2022","663","13","676","2024-12-30"
"88254","2024","COM","2022","81","2","83","2024-12-30"
"88255","2024","COM","2022","89","3","92","2024-12-30"
"88256","2024","COM","2022","260","3","263","2024-12-30"
"88257","2024","COM","2022","183","2","185","2024-12-30"
"88258","2024","COM","2022","814","10","824","2024-12-30"
"88259","2024","COM","2022","291","4","295","2024-12-30"
"88260","2024","COM","2022","144","1","145","2024-12-30"
"88261","2024","COM","2022","630","9","639","2024-12-30"
"88262","2024","COM","2022","578","8","586","2024-12-30"
"88263","2024","COM","2022","207","4","211","2024-12-30"
"88264","2024","COM","2022","63","3","66","2024-12-30"
"88265","2024","COM","2022","24","0","24","2024-12-30"
"88266","2024","COM","2022","838","19","857","2024-12-30"
"88267","2024","COM","2022","456","10","466","2024-12-30"
"88268","2024","COM","2022","138","7","145","2024-12-30"
"88269","2024","COM","2022","301","12","313","2024-12-30"
"88270","2024","COM","2022","2108","59","2167","2024-12-30"
"88271","2024","COM","2022","300","8","308","2024-12-30"
"88272","2024","COM","2022","71","1","72","2024-12-30"
"88273","2024","COM","2022","460","5","465","2024-12-30"
"88274","2024","COM","2022","81","2","83","2024-12-30"
"88275","2024","COM","2022","245","4","249","2024-12-30"
"88276","2024","COM","2022","361","14","375","2024-12-30"
"88277","2024","COM","2022","117","1","118","2024-12-30"
"88278","2024","COM","2022","67","3","70","2024-12-30"
"88279","2024","COM","2022","50","2","52","2024-12-30"
"88280","2024","COM","2022","126","3","129","2024-12-30"
"88281","2024","COM","2022","407","10","417","2024-12-30"
"88283","2024","COM","2022","80","3","83","2024-12-30"
"88284","2024","COM","2022","590","11","601","2024-12-30"
"88285","2024","COM","2022","438","127","565","2024-12-30"
"88286","2024","COM","2022","98","0","98","2024-12-30"
"88287","2024","COM","2022","71","1","72","2024-12-30"
"88288","2024","COM","2022","5","0","5","2024-12-30"
"88289","2024","COM","2022","793","64","857","2024-12-30"
"88290","2024","COM","2022","116","2","118","2024-12-30"
"88291","2024","COM","2022","126","2","128","2024-12-30"
"88292","2024","COM","2022","801","17","818","2024-12-30"
"88293","2024","COM","2022","216","3","219","2024-12-30"
"88294","2024","COM","2022","267","3","270","2024-12-30"
"88295","2024","COM","2022","237","7","244","2024-12-30"
"88296","2024","COM","2022","54","1","55","2024-12-30"
"88297","2024","COM","2022","175","0","175","2024-12-30"
"88298","2024","COM","2022","60","0","60","2024-12-30"
"88299","2024","COM","2022","168","2","170","2024-12-30"
"88300","2024","COM","2022","122","6","128","2024-12-30"
"88301","2024","COM","2022","289","4","293","2024-12-30"
"88302","2024","COM","2022","984","24","1008","2024-12-30"
"88303","2024","COM","2022","177","1","178","2024-12-30"
"88304","2024","COM","2022","4746","470","5216","2024-12-30"
"88305","2024","COM","2022","180","4","184","2024-12-30"
"88306","2024","COM","2022","52","0","52","2024-12-30"
"88307","2024","COM","2022","94","2","96","2024-12-30"
"88308","2024","COM","2022","279","7","286","2024-12-30"
"88309","2024","COM","2022","174","3","177","2024-12-30"
"88310","2024","COM","2022","870","19","889","2024-12-30"
"88311","2024","COM","2022","34","0","34","2024-12-30"
"88312","2024","COM","2022","192","4","196","2024-12-30"
"88313","2024","COM","2022","436","7","443","2024-12-30"
"88314","2024","COM","2022","94","3","97","2024-12-30"
"88315","2024","COM","2022","188","4","192","2024-12-30"
"88316","2024","COM","2022","42","2","44","2024-12-30"
"88317","2024","COM","2022","549","6","555","2024-12-30"
"88318","2024","COM","2022","221","4","225","2024-12-30"
"88319","2024","COM","2022","3003","57","3060","2024-12-30"
"88320","2024","COM","2022","776","34","810","2024-12-30"
"88321","2024","COM","2022","6507","262","6769","2024-12-30"
"88322","2024","COM","2022","502","13","515","2024-12-30"
"88324","2024","COM","2022","368","9","377","2024-12-30"
"88325","2024","COM","2022","182","9","191","2024-12-30"
"88326","2024","COM","2022","357","11","368","2024-12-30"
"88327","2024","COM","2022","1927","17","1944","2024-12-30"
"88328","2024","COM","2022","535","13","548","2024-12-30"
"88330","2024","COM","2022","188","3","191","2024-12-30"
"88331","2024","COM","2022","55","2","57","2024-12-30"
"88332","2024","COM","2022","208","6","214","2024-12-30"
"88333","2024","COM","2022","125","1","126","2024-12-30"
"88334","2024","COM","2022","269","8","277","2024-12-30"
"88335","2024","COM","2022","150","2","152","2024-12-30"
"88336","2024","COM","2022","74","1","75","2024-12-30"
"88338","2024","COM","2022","87","1","88","2024-12-30"
"88340","2024","COM","2022","492","10","502","2024-12-30"
"88341","2024","COM","2022","491","17","508","2024-12-30"
"88342","2024","COM","2022","172","4","176","2024-12-30"
"88343","2024","COM","2022","172","4","176","2024-12-30"
"88344","2024","COM","2022","184","4","188","2024-12-30"
"88345","2024","COM","2022","84","4","88","2024-12-30"
"88346","2024","COM","2022","737","10","747","2024-12-30"
"88347","2024","COM","2022","126","1","127","2024-12-30"
"88348","2024","COM","2022","143","3","146","2024-12-30"
"88349","2024","COM","2022","1592","19","1611","2024-12-30"
"88350","2024","COM","2022","72","2","74","2024-12-30"
"88351","2024","COM","2022","1571","32","1603","2024-12-30"
"88352","2024","COM","2022","191","3","194","2024-12-30"
"88353","2024","COM","2022","102","0","102","2024-12-30"
"88354","2024","COM","2022","181","6","187","2024-12-30"
"88355","2024","COM","2022","1215","16","1231","2024-12-30"
"88356","2024","COM","2022","302","5","307","2024-12-30"
"88357","2024","COM","2022","660","11","671","2024-12-30"
"88358","2024","COM","2022","1952","35","1987","2024-12-30"
"88359","2024","COM","2022","89","1","90","2024-12-30"
"88360","2024","COM","2022","144","5","149","2024-12-30"
"88361","2024","COM","2022","1299","100","1399","2024-12-30"
"88362","2024","COM","2022","118","1","119","2024-12-30"
"88363","2024","COM","2022","149","4","153","2024-12-30"
"88364","2024","COM","2022","145","3","148","2024-12-30"
"88365","2024","COM","2022","146","9","155","2024-12-30"
"88366","2024","COM","2022","274","13","287","2024-12-30"
"88367","2024","COM","2022","5032","81","5113","2024-12-30"
"88368","2024","COM","2022","148","3","151","2024-12-30"
"88369","2024","COM","2022","1817","142","1959","2024-12-30"
"88370","2024","COM","2022","76","0","76","2024-12-30"
"88371","2024","COM","2022","1207","32","1239","2024-12-30"
"88372","2024","COM","2022","6011","125","6136","2024-12-30"
"88373","2024","COM","2022","139","4","143","2024-12-30"
"88374","2024","COM","2022","24","0","24","2024-12-30"
"88375","2024","COM","2022","480","9","489","2024-12-30"
"88376","2024","COM","2022","295","6","301","2024-12-30"
"88377","2024","COM","2022","122","3","125","2024-12-30"
"88378","2024","COM","2022","103","3","106","2024-12-30"
"88379","2024","COM","2022","361","6","367","2024-12-30"
"88380","2024","COM","2022","208","2","210","2024-12-30"
"88381","2024","COM","2022","190","7","197","2024-12-30"
"88382","2024","COM","2022","63","1","64","2024-12-30"
"88383","2024","COM","2022","7500","245","7745","2024-12-30"
"88385","2024","COM","2022","568","12","580","2024-12-30"
"88386","2024","COM","2022","435","4","439","2024-12-30"
"88387","2024","COM","2022","194","4","198","2024-12-30"
"88388","2024","COM","2022","120","3","123","2024-12-30"
"88389","2024","COM","2022","82","0","82","2024-12-30"
"88390","2024","COM","2022","104","7","111","2024-12-30"
"88391","2024","COM","2022","676","16","692","2024-12-30"
"88393","2024","COM","2022","306","6","312","2024-12-30"
"88394","2024","COM","2022","47","1","48","2024-12-30"
"88395","2024","COM","2022","362","6","368","2024-12-30"
"88398","2024","COM","2022","79","5","84","2024-12-30"
"88399","2024","COM","2022","210","4","214","2024-12-30"
"88400","2024","COM","2022","262","12","274","2024-12-30"
"88401","2024","COM","2022","459","8","467","2024-12-30"
"88402","2024","COM","2022","369","136","505","2024-12-30"
"88403","2024","COM","2022","185","1","186","2024-12-30"
"88404","2024","COM","2022","69","1","70","2024-12-30"
"88406","2024","COM","2022","131","1","132","2024-12-30"
"88407","2024","COM","2022","144","2","146","2024-12-30"
"88408","2024","COM","2022","3458","62","3520","2024-12-30"
"88409","2024","COM","2022","2140","51","2191","2024-12-30"
"88410","2024","COM","2022","268","2","270","2024-12-30"
"88411","2024","COM","2022","84","2","86","2024-12-30"
"88412","2024","COM","2022","445","6","451","2024-12-30"
"88413","2024","COM","2022","19324","455","19779","2024-12-30"
"88415","2024","COM","2022","3814","65","3879","2024-12-30"
"88416","2024","COM","2022","133","2","135","2024-12-30"
"88417","2024","COM","2022","366","9","375","2024-12-30"
"88418","2024","COM","2022","445","6","451","2024-12-30"
"88419","2024","COM","2022","128","0","128","2024-12-30"
"88421","2024","COM","2022","103","1","104","2024-12-30"
"88423","2024","COM","2022","1379","20","1399","2024-12-30"
"88424","2024","COM","2022","2253","63","2316","2024-12-30"
"88425","2024","COM","2022","181","3","184","2024-12-30"
"88426","2024","COM","2022","1364","32","1396","2024-12-30"
"88427","2024","COM","2022","117","0","117","2024-12-30"
"88428","2024","COM","2022","1794","52","1846","2024-12-30"
"88429","2024","COM","2022","3983","258","4241","2024-12-30"
"88430","2024","COM","2022","495","13","508","2024-12-30"
"88431","2024","COM","2022","148","2","150","2024-12-30"
"88432","2024","COM","2022","153","0","153","2024-12-30"
"88433","2024","COM","2022","67","1","68","2024-12-30"
"88434","2024","COM","2022","211","8","219","2024-12-30"
"88435","2024","COM","2022","519","10","529","2024-12-30"
"88436","2024","COM","2022","72","0","72","2024-12-30"
"88437","2024","COM","2022","100","3","103","2024-12-30"
"88438","2024","COM","2022","398","7","405","2024-12-30"
"88439","2024","COM","2022","953","28","981","2024-12-30"
"88440","2024","COM","2022","174","2","176","2024-12-30"
"88441","2024","COM","2022","129","2","131","2024-12-30"
"88442","2024","COM","2022","629","11","640","2024-12-30"
"88443","2024","COM","2022","90","1","91","2024-12-30"
"88444","2024","COM","2022","297","6","303","2024-12-30"
"88445","2024","COM","2022","2319","52","2371","2024-12-30"
"88446","2024","COM","2022","231","3","234","2024-12-30"
"88447","2024","COM","2022","2537","74","2611","2024-12-30"
"88448","2024","COM","2022","169","7","176","2024-12-30"
"88449","2024","COM","2022","203","4","207","2024-12-30"
"88450","2024","COM","2022","183","5","188","2024-12-30"
"88451","2024","COM","2022","2334","29","2363","2024-12-30"
"88452","2024","COM","2022","133","0","133","2024-12-30"
"88453","2024","COM","2022","31","0","31","2024-12-30"
"88454","2024","COM","2022","224","9","233","2024-12-30"
"88455","2024","COM","2022","100","2","102","2024-12-30"
"88456","2024","COM","2022","83","2","85","2024-12-30"
"88457","2024","COM","2022","141","0","141","2024-12-30"
"88458","2024","COM","2022","282","1","283","2024-12-30"
"88459","2024","COM","2022","43","1","44","2024-12-30"
"88460","2024","COM","2022","653","12","665","2024-12-30"
"88461","2024","COM","2022","200","5","205","2024-12-30"
"88462","2024","COM","2022","1859","35","1894","2024-12-30"
"88463","2024","COM","2022","1450","30","1480","2024-12-30"
"88464","2024","COM","2022","504","9","513","2024-12-30"
"88465","2024","COM","2022","8433","214","8647","2024-12-30"
"88466","2024","COM","2022","123","5","128","2024-12-30"
"88467","2024","COM","2022","583","12","595","2024-12-30"
"88468","2024","COM","2022","3198","48","3246","2024-12-30"
"88469","2024","COM","2022","100","6","106","2024-12-30"
"88470","2024","COM","2022","1495","36","1531","2024-12-30"
"88471","2024","COM","2022","97","1","98","2024-12-30"
"88472","2024","COM","2022","111","3","114","2024-12-30"
"88473","2024","COM","2022","82","2","84","2024-12-30"
"88474","2024","COM","2022","71","0","71","2024-12-30"
"88475","2024","COM","2022","117","5","122","2024-12-30"
"88476","2024","COM","2022","114","3","117","2024-12-30"
"88477","2024","COM","2022","101","1","102","2024-12-30"
"88478","2024","COM","2022","89","1","90","2024-12-30"
"88479","2024","COM","2022","235","6","241","2024-12-30"
"88480","2024","COM","2022","169","1","170","2024-12-30"
"88481","2024","COM","2022","1326","23","1349","2024-12-30"
"88482","2024","COM","2022","55","2","57","2024-12-30"
"88483","2024","COM","2022","2249","54","2303","2024-12-30"
"88484","2024","COM","2022","1050","26","1076","2024-12-30"
"88485","2024","COM","2022","128","2","130","2024-12-30"
"88486","2024","COM","2022","3873","104","3977","2024-12-30"
"88487","2024","COM","2022","3873","91","3964","2024-12-30"
"88488","2024","COM","2022","229","4","233","2024-12-30"
"88489","2024","COM","2022","256","8","264","2024-12-30"
"88490","2024","COM","2022","186","4","190","2024-12-30"
"88491","2024","COM","2022","124","4","128","2024-12-30"
"88492","2024","COM","2022","74","1","75","2024-12-30"
"88493","2024","COM","2022","24","1","25","2024-12-30"
"88494","2024","COM","2022","121","3","124","2024-12-30"
"88495","2024","COM","2022","195","6","201","2024-12-30"
"88496","2024","COM","2022","151","4","155","2024-12-30"
"88497","2024","COM","2022","502","3","505","2024-12-30"
"88498","2024","COM","2022","863","13","876","2024-12-30"
"88499","2024","COM","2022","159","2","161","2024-12-30"
"88500","2024","COM","2022","839","13","852","2024-12-30"
"88501","2024","COM","2022","73","0","73","2024-12-30"
"88502","2024","COM","2022","117","3","120","2024-12-30"
"88503","2024","COM","2022","147","2","149","2024-12-30"
"88504","2024","COM","2022","158","2","160","2024-12-30"
"88505","2024","COM","2022","120","2","122","2024-12-30"
"88506","2024","COM","2022","321","6","327","2024-12-30"
"88507","2024","COM","2022","189","6","195","2024-12-30"
"88508","2024","COM","2022","513","9","522","2024-12-30"
"88509","2024","COM","2022","100","1","101","2024-12-30"
"88510","2024","COM","2022","119","5","124","2024-12-30"
"88511","2024","COM","2022","86","1","87","2024-12-30"
"88512","2024","COM","2022","235","3","238","2024-12-30"
"88513","2024","COM","2022","2073","27","2100","2024-12-30"
"88514","2024","COM","2022","165","7","172","2024-12-30"
"88515","2024","COM","2022","153","4","157","2024-12-30"
"88516","2024","COM","2022","4766","136","4902","2024-12-30"
"88517","2024","COM","2022","182","6","188","2024-12-30"
"88518","2024","COM","2022","27","0","27","2024-12-30"
"88519","2024","COM","2022","656","18","674","2024-12-30"
"88520","2024","COM","2022","285","9","294","2024-12-30"
"88521","2024","COM","2022","258","4","262","2024-12-30"
"88522","2024","COM","2022","68","2","70","2024-12-30"
"88523","2024","COM","2022","169","6","175","2024-12-30"
"88524","2024","COM","2022","349","4","353","2024-12-30"
"88525","2024","COM","2022","133","2","135","2024-12-30"
"88526","2024","COM","2022","428","9","437","2024-12-30"
"88527","2024","COM","2022","133","2","135","2024-12-30"
"88528","2024","COM","2022","152","5","157","2024-12-30"
"88529","2024","COM","2022","108","1","109","2024-12-30"
"88530","2024","COM","2022","2572","47","2619","2024-12-30"
"88531","2024","COM","2022","1475","31","1506","2024-12-30"
"88532","2024","COM","2022","76","2","78","2024-12-30"
"89002","2024","COM","2022","71","5","76","2024-12-30"
"89003","2024","COM","2022","2730","84","2814","2024-12-30"
"89004","2024","COM","2022","236","5","241","2024-12-30"
"89005","2024","COM","2022","837","24","861","2024-12-30"
"89006","2024","COM","2022","141","5","146","2024-12-30"
"89007","2024","COM","2022","445","13","458","2024-12-30"
"89008","2024","COM","2022","152","6","158","2024-12-30"
"89009","2024","COM","2022","340","7","347","2024-12-30"
"89010","2024","COM","2022","203","7","210","2024-12-30"
"89011","2024","COM","2022","115","5","120","2024-12-30"
"89012","2024","COM","2022","84","1","85","2024-12-30"
"89013","2024","COM","2022","3133","84","3217","2024-12-30"
"89014","2024","COM","2022","612","15","627","2024-12-30"
"89015","2024","COM","2022","482","17","499","2024-12-30"
"89016","2024","COM","2022","79","1","80","2024-12-30"
"89017","2024","COM","2022","224","2","226","2024-12-30"
"89018","2024","COM","2022","759","11","770","2024-12-30"
"89019","2024","COM","2022","150","0","150","2024-12-30"
"89020","2024","COM","2022","114","1","115","2024-12-30"
"89021","2024","COM","2022","297","9","306","2024-12-30"
"89022","2024","COM","2022","134","2","136","2024-12-30"
"89023","2024","COM","2022","963","25","988","2024-12-30"
"89024","2024","COM","2022","35236","1099","36335","2024-12-30"
"89025","2024","COM","2022","6346","181","6527","2024-12-30"
"89027","2024","COM","2022","201","6","207","2024-12-30"
"89028","2024","COM","2022","62","5","67","2024-12-30"
"89029","2024","COM","2022","875","12","887","2024-12-30"
"89030","2024","COM","2022","414","15","429","2024-12-30"
"89031","2024","COM","2022","620","12","632","2024-12-30"
"89032","2024","COM","2022","71","2","73","2024-12-30"
"89033","2024","COM","2022","394","12","406","2024-12-30"
"89034","2024","COM","2022","444","15","459","2024-12-30"
"89035","2024","COM","2022","437","16","453","2024-12-30"
"89036","2024","COM","2022","220","10","230","2024-12-30"
"89037","2024","COM","2022","524","22","546","2024-12-30"
"89038","2024","COM","2022","116","0","116","2024-12-30"
"89039","2024","COM","2022","75","5","80","2024-12-30"
"89040","2024","COM","2022","185","5","190","2024-12-30"
"89041","2024","COM","2022","286","8","294","2024-12-30"
"89042","2024","COM","2022","154","4","158","2024-12-30"
"89043","2024","COM","2022","99","1","100","2024-12-30"
"89044","2024","COM","2022","100","1","101","2024-12-30"
"89045","2024","COM","2022","282","5","287","2024-12-30"
"89046","2024","COM","2022","1146","19","1165","2024-12-30"
"89048","2024","COM","2022","337","10","347","2024-12-30"
"89049","2024","COM","2022","23","1","24","2024-12-30"
"89050","2024","COM","2022","907","21","928","2024-12-30"
"89051","2024","COM","2022","553","12","565","2024-12-30"
"89053","2024","COM","2022","435","7","442","2024-12-30"
"89054","2024","COM","2022","778","8","786","2024-12-30"
"89055","2024","COM","2022","3060","47","3107","2024-12-30"
"89056","2024","COM","2022","614","21","635","2024-12-30"
"89057","2024","COM","2022","278","6","284","2024-12-30"
"89058","2024","COM","2022","114","4","118","2024-12-30"
"89059","2024","COM","2022","696","9","705","2024-12-30"
"89060","2024","COM","2022","455","10","465","2024-12-30"
"89061","2024","COM","2022","255","2","257","2024-12-30"
"89062","2024","COM","2022","375","4","379","2024-12-30"
"89063","2024","COM","2022","842","17","859","2024-12-30"
"89064","2024","COM","2022","54","1","55","2024-12-30"
"89065","2024","COM","2022","50","1","51","2024-12-30"
"89066","2024","COM","2022","1002","25","1027","2024-12-30"
"89067","2024","COM","2022","1081","25","1106","2024-12-30"
"89068","2024","COM","2022","2151","42","2193","2024-12-30"
"89069","2024","COM","2022","525","10","535","2024-12-30"
"89071","2024","COM","2022","95","2","97","2024-12-30"
"89072","2024","COM","2022","311","0","311","2024-12-30"
"89073","2024","COM","2022","896","15","911","2024-12-30"
"89074","2024","COM","2022","2127","43","2170","2024-12-30"
"89075","2024","COM","2022","757","15","772","2024-12-30"
"89076","2024","COM","2022","779","20","799","2024-12-30"
"89077","2024","COM","2022","1534","85","1619","2024-12-30"
"89079","2024","COM","2022","656","15","671","2024-12-30"
"89080","2024","COM","2022","668","18","686","2024-12-30"
"89081","2024","COM","2022","92","0","92","2024-12-30"
"89083","2024","COM","2022","1870","49","1919","2024-12-30"
"89084","2024","COM","2022","286","7","293","2024-12-30"
"89085","2024","COM","2022","1108","29","1137","2024-12-30"
"89086","2024","COM","2022","4854","71","4925","2024-12-30"
"89087","2024","COM","2022","300","7","307","2024-12-30"
"89088","2024","COM","2022","475","9","484","2024-12-30"
"89089","2024","COM","2022","131","4","135","2024-12-30"
"89091","2024","COM","2022","565","17","582","2024-12-30"
"89092","2024","COM","2022","199","7","206","2024-12-30"
"89093","2024","COM","2022","659","13","672","2024-12-30"
"89094","2024","COM","2022","701","12","713","2024-12-30"
"89095","2024","COM","2022","134","8","142","2024-12-30"
"89096","2024","COM","2022","895","22","917","2024-12-30"
"89098","2024","COM","2022","234","8","242","2024-12-30"
"89099","2024","COM","2022","2231","41","2272","2024-12-30"
"89100","2024","COM","2022","1763","23","1786","2024-12-30"
"89101","2024","COM","2022","532","16","548","2024-12-30"
"89102","2024","COM","2022","2145","71","2216","2024-12-30"
"89104","2024","COM","2022","299","11","310","2024-12-30"
"89105","2024","COM","2022","434","12","446","2024-12-30"
"89108","2024","COM","2022","348","7","355","2024-12-30"
"89111","2024","COM","2022","298","5","303","2024-12-30"
"89112","2024","COM","2022","156","9","165","2024-12-30"
"89113","2024","COM","2022","661","14","675","2024-12-30"
"89115","2024","COM","2022","182","4","186","2024-12-30"
"89116","2024","COM","2022","364","10","374","2024-12-30"
"89117","2024","COM","2022","214","4","218","2024-12-30"
"89118","2024","COM","2022","787","18","805","2024-12-30"
"89119","2024","COM","2022","506","11","517","2024-12-30"
"89120","2024","COM","2022","140","7","147","2024-12-30"
"89122","2024","COM","2022","565","8","573","2024-12-30"
"89123","2024","COM","2022","241","6","247","2024-12-30"
"89124","2024","COM","2022","1191","19","1210","2024-12-30"
"89125","2024","COM","2022","895","11","906","2024-12-30"
"89126","2024","COM","2022","35","1","36","2024-12-30"
"89127","2024","COM","2022","783","21","804","2024-12-30"
"89128","2024","COM","2022","131","4","135","2024-12-30"
"89129","2024","COM","2022","411","8","419","2024-12-30"
"89130","2024","COM","2022","1272","31","1303","2024-12-30"
"89131","2024","COM","2022","224","5","229","2024-12-30"
"89132","2024","COM","2022","159","5","164","2024-12-30"
"89133","2024","COM","2022","392","4","396","2024-12-30"
"89134","2024","COM","2022","328","8","336","2024-12-30"
"89136","2024","COM","2022","863","29","892","2024-12-30"
"89137","2024","COM","2022","458","15","473","2024-12-30"
"89139","2024","COM","2022","1059","36","1095","2024-12-30"
"89141","2024","COM","2022","119","4","123","2024-12-30"
"89142","2024","COM","2022","898","14","912","2024-12-30"
"89143","2024","COM","2022","326","2","328","2024-12-30"
"89144","2024","COM","2022","795","8","803","2024-12-30"
"89145","2024","COM","2022","406","5","411","2024-12-30"
"89146","2024","COM","2022","85","3","88","2024-12-30"
"89147","2024","COM","2022","237","1","238","2024-12-30"
"89148","2024","COM","2022","273","5","278","2024-12-30"
"89149","2024","COM","2022","188","3","191","2024-12-30"
"89150","2024","COM","2022","451","9","460","2024-12-30"
"89151","2024","COM","2022","1387","20","1407","2024-12-30"
"89152","2024","COM","2022","711","11","722","2024-12-30"
"89153","2024","COM","2022","515","16","531","2024-12-30"
"89154","2024","COM","2022","853","18","871","2024-12-30"
"89155","2024","COM","2022","714","11","725","2024-12-30"
"89156","2024","COM","2022","386","8","394","2024-12-30"
"89158","2024","COM","2022","629","14","643","2024-12-30"
"89159","2024","COM","2022","392","10","402","2024-12-30"
"89160","2024","COM","2022","752","15","767","2024-12-30"
"89161","2024","COM","2022","186","4","190","2024-12-30"
"89162","2024","COM","2022","398","4","402","2024-12-30"
"89163","2024","COM","2022","547","9","556","2024-12-30"
"89164","2024","COM","2022","92","1","93","2024-12-30"
"89165","2024","COM","2022","122","1","123","2024-12-30"
"89167","2024","COM","2022","1019","32","1051","2024-12-30"
"89168","2024","COM","2022","175","3","178","2024-12-30"
"89169","2024","COM","2022","947","22","969","2024-12-30"
"89170","2024","COM","2022","115","3","118","2024-12-30"
"89171","2024","COM","2022","286","3","289","2024-12-30"
"89172","2024","COM","2022","518","16","534","2024-12-30"
"89173","2024","COM","2022","462","9","471","2024-12-30"
"89175","2024","COM","2022","136","5","141","2024-12-30"
"89176","2024","COM","2022","136","4","140","2024-12-30"
"89177","2024","COM","2022","81","0","81","2024-12-30"
"89179","2024","COM","2022","293","8","301","2024-12-30"
"89180","2024","COM","2022","460","11","471","2024-12-30"
"89181","2024","COM","2022","130","2","132","2024-12-30"
"89182","2024","COM","2022","182","4","186","2024-12-30"
"89183","2024","COM","2022","62","0","62","2024-12-30"
"89184","2024","COM","2022","129","3","132","2024-12-30"
"89186","2024","COM","2022","531","13","544","2024-12-30"
"89187","2024","COM","2022","83","2","85","2024-12-30"
"89188","2024","COM","2022","189","6","195","2024-12-30"
"89189","2024","COM","2022","556","22","578","2024-12-30"
"89190","2024","COM","2022","178","8","186","2024-12-30"
"89191","2024","COM","2022","41","1","42","2024-12-30"
"89194","2024","COM","2022","111","6","117","2024-12-30"
"89195","2024","COM","2022","1260","74","1334","2024-12-30"
"89196","2024","COM","2022","1777","54","1831","2024-12-30"
"89197","2024","COM","2022","712","15","727","2024-12-30"
"89198","2024","COM","2022","1724","42","1766","2024-12-30"
"89199","2024","COM","2022","446","9","455","2024-12-30"
"89200","2024","COM","2022","393","6","399","2024-12-30"
"89201","2024","COM","2022","1789","36","1825","2024-12-30"
"89202","2024","COM","2022","243","8","251","2024-12-30"
"89203","2024","COM","2022","188","6","194","2024-12-30"
"89204","2024","COM","2022","664","12","676","2024-12-30"
"89205","2024","COM","2022","431","16","447","2024-12-30"
"89206","2024","COM","2022","9055","299","9354","2024-12-30"
"89207","2024","COM","2022","28","1","29","2024-12-30"
"89208","2024","COM","2022","1164","10","1174","2024-12-30"
"89209","2024","COM","2022","519","10","529","2024-12-30"
"89210","2024","COM","2022","123","8","131","2024-12-30"
"89211","2024","COM","2022","64","0","64","2024-12-30"
"89212","2024","COM","2022","355","9","364","2024-12-30"
"89214","2024","COM","2022","202","3","205","2024-12-30"
"89215","2024","COM","2022","178","2","180","2024-12-30"
"89216","2024","COM","2022","324","3","327","2024-12-30"
"89217","2024","COM","2022","133","3","136","2024-12-30"
"89218","2024","COM","2022","1209","24","1233","2024-12-30"
"89219","2024","COM","2022","142","2","144","2024-12-30"
"89220","2024","COM","2022","391","2","393","2024-12-30"
"89221","2024","COM","2022","317","4","321","2024-12-30"
"89222","2024","COM","2022","222","5","227","2024-12-30"
"89223","2024","COM","2022","664","18","682","2024-12-30"
"89224","2024","COM","2022","156","3","159","2024-12-30"
"89225","2024","COM","2022","41","0","41","2024-12-30"
"89226","2024","COM","2022","186","5","191","2024-12-30"
"89227","2024","COM","2022","1211","27","1238","2024-12-30"
"89228","2024","COM","2022","1334","46","1380","2024-12-30"
"89229","2024","COM","2022","489","12","501","2024-12-30"
"89230","2024","COM","2022","438","20","458","2024-12-30"
"89232","2024","COM","2022","322","14","336","2024-12-30"
"89233","2024","COM","2022","206","10","216","2024-12-30"
"89234","2024","COM","2022","119","2","121","2024-12-30"
"89235","2024","COM","2022","872","20","892","2024-12-30"
"89236","2024","COM","2022","1271","28","1299","2024-12-30"
"89237","2024","COM","2022","494","12","506","2024-12-30"
"89238","2024","COM","2022","523","7","530","2024-12-30"
"89239","2024","COM","2022","1635","46","1681","2024-12-30"
"89240","2024","COM","2022","310","9","319","2024-12-30"
"89242","2024","COM","2022","780","14","794","2024-12-30"
"89244","2024","COM","2022","84","4","88","2024-12-30"
"89245","2024","COM","2022","858","17","875","2024-12-30"
"89246","2024","COM","2022","337","8","345","2024-12-30"
"89247","2024","COM","2022","225","3","228","2024-12-30"
"89248","2024","COM","2022","37","2","39","2024-12-30"
"89249","2024","COM","2022","77","0","77","2024-12-30"
"89250","2024","COM","2022","168","8","176","2024-12-30"
"89251","2024","COM","2022","361","10","371","2024-12-30"
"89252","2024","COM","2022","175","3","178","2024-12-30"
"89253","2024","COM","2022","189","3","192","2024-12-30"
"89254","2024","COM","2022","516","5","521","2024-12-30"
"89255","2024","COM","2022","1080","21","1101","2024-12-30"
"89256","2024","COM","2022","392","9","401","2024-12-30"
"89257","2024","COM","2022","6878","96","6974","2024-12-30"
"89259","2024","COM","2022","100","2","102","2024-12-30"
"89261","2024","COM","2022","272","3","275","2024-12-30"
"89262","2024","COM","2022","160","5","165","2024-12-30"
"89263","2024","COM","2022","4113","84","4197","2024-12-30"
"89264","2024","COM","2022","719","26","745","2024-12-30"
"89265","2024","COM","2022","582","20","602","2024-12-30"
"89266","2024","COM","2022","251","4","255","2024-12-30"
"89267","2024","COM","2022","166","8","174","2024-12-30"
"89268","2024","COM","2022","783","20","803","2024-12-30"
"89270","2024","COM","2022","133","2","135","2024-12-30"
"89271","2024","COM","2022","108","4","112","2024-12-30"
"89272","2024","COM","2022","279","2","281","2024-12-30"
"89273","2024","COM","2022","270","3","273","2024-12-30"
"89274","2024","COM","2022","1329","37","1366","2024-12-30"
"89276","2024","COM","2022","881","38","919","2024-12-30"
"89277","2024","COM","2022","372","11","383","2024-12-30"
"89278","2024","COM","2022","563","5","568","2024-12-30"
"89279","2024","COM","2022","590","20","610","2024-12-30"
"89280","2024","COM","2022","372","7","379","2024-12-30"
"89281","2024","COM","2022","284","4","288","2024-12-30"
"89282","2024","COM","2022","650","11","661","2024-12-30"
"89283","2024","COM","2022","584","14","598","2024-12-30"
"89284","2024","COM","2022","180","4","184","2024-12-30"
"89285","2024","COM","2022","291","4","295","2024-12-30"
"89286","2024","COM","2022","827","24","851","2024-12-30"
"89287","2024","COM","2022","4855","116","4971","2024-12-30"
"89288","2024","COM","2022","154","7","161","2024-12-30"
"89289","2024","COM","2022","297","9","306","2024-12-30"
"89290","2024","COM","2022","50","1","51","2024-12-30"
"89291","2024","COM","2022","329","8","337","2024-12-30"
"89292","2024","COM","2022","248","3","251","2024-12-30"
"89295","2024","COM","2022","1254","30","1284","2024-12-30"
"89296","2024","COM","2022","125","5","130","2024-12-30"
"89297","2024","COM","2022","104","2","106","2024-12-30"
"89298","2024","COM","2022","588","12","600","2024-12-30"
"89299","2024","COM","2022","62","1","63","2024-12-30"
"89300","2024","COM","2022","80","0","80","2024-12-30"
"89302","2024","COM","2022","218","3","221","2024-12-30"
"89303","2024","COM","2022","243","6","249","2024-12-30"
"89304","2024","COM","2022","670","24","694","2024-12-30"
"89306","2024","COM","2022","361","11","372","2024-12-30"
"89307","2024","COM","2022","774","10","784","2024-12-30"
"89308","2024","COM","2022","205","6","211","2024-12-30"
"89309","2024","COM","2022","3357","39","3396","2024-12-30"
"89310","2024","COM","2022","152","4","156","2024-12-30"
"89311","2024","COM","2022","1284","27","1311","2024-12-30"
"89312","2024","COM","2022","238","5","243","2024-12-30"
"89313","2024","COM","2022","430","16","446","2024-12-30"
"89314","2024","COM","2022","180","4","184","2024-12-30"
"89315","2024","COM","2022","164","2","166","2024-12-30"
"89316","2024","COM","2022","249","7","256","2024-12-30"
"89318","2024","COM","2022","621","21","642","2024-12-30"
"89319","2024","COM","2022","489","14","503","2024-12-30"
"89320","2024","COM","2022","52","6","58","2024-12-30"
"89321","2024","COM","2022","727","12","739","2024-12-30"
"89323","2024","COM","2022","146","2","148","2024-12-30"
"89324","2024","COM","2022","699","10","709","2024-12-30"
"89325","2024","COM","2022","88","0","88","2024-12-30"
"89326","2024","COM","2022","1077","31","1108","2024-12-30"
"89327","2024","COM","2022","386","11","397","2024-12-30"
"89328","2024","COM","2022","368","9","377","2024-12-30"
"89329","2024","COM","2022","75","0","75","2024-12-30"
"89331","2024","COM","2022","290","7","297","2024-12-30"
"89332","2024","COM","2022","934","19","953","2024-12-30"
"89333","2024","COM","2022","159","5","164","2024-12-30"
"89334","2024","COM","2022","559","8","567","2024-12-30"
"89335","2024","COM","2022","435","14","449","2024-12-30"
"89336","2024","COM","2022","277","7","284","2024-12-30"
"89337","2024","COM","2022","1024","21","1045","2024-12-30"
"89338","2024","COM","2022","2813","77","2890","2024-12-30"
"89339","2024","COM","2022","185","9","194","2024-12-30"
"89341","2024","COM","2022","446","10","456","2024-12-30"
"89342","2024","COM","2022","624","17","641","2024-12-30"
"89344","2024","COM","2022","1466","14","1480","2024-12-30"
"89345","2024","COM","2022","4230","57","4287","2024-12-30"
"89346","2024","COM","2022","3176","113","3289","2024-12-30"
"89347","2024","COM","2022","344","9","353","2024-12-30"
"89348","2024","COM","2022","2202","49","2251","2024-12-30"
"89349","2024","COM","2022","358","11","369","2024-12-30"
"89350","2024","COM","2022","248","7","255","2024-12-30"
"89351","2024","COM","2022","480","9","489","2024-12-30"
"89352","2024","COM","2022","259","6","265","2024-12-30"
"89353","2024","COM","2022","420","6","426","2024-12-30"
"89354","2024","COM","2022","1553","43","1596","2024-12-30"
"89355","2024","COM","2022","141","3","144","2024-12-30"
"89359","2024","COM","2022","408","3","411","2024-12-30"
"89360","2024","COM","2022","372","8","380","2024-12-30"
"89361","2024","COM","2022","255","2","257","2024-12-30"
"89362","2024","COM","2022","177","2","179","2024-12-30"
"89363","2024","COM","2022","98","6","104","2024-12-30"
"89364","2024","COM","2022","287","5","292","2024-12-30"
"89365","2024","COM","2022","518","10","528","2024-12-30"
"89367","2024","COM","2022","546","7","553","2024-12-30"
"89368","2024","COM","2022","907","23","930","2024-12-30"
"89369","2024","COM","2022","597","11","608","2024-12-30"
"89370","2024","COM","2022","1806","22","1828","2024-12-30"
"89371","2024","COM","2022","67","4","71","2024-12-30"
"89373","2024","COM","2022","658","20","678","2024-12-30"
"89374","2024","COM","2022","65","1","66","2024-12-30"
"89375","2024","COM","2022","88","3","91","2024-12-30"
"89376","2024","COM","2022","134","8","142","2024-12-30"
"89377","2024","COM","2022","67","0","67","2024-12-30"
"89378","2024","COM","2022","739","15","754","2024-12-30"
"89379","2024","COM","2022","139","3","142","2024-12-30"
"89380","2024","COM","2022","451","8","459","2024-12-30"
"89382","2024","COM","2022","1460","31","1491","2024-12-30"
"89383","2024","COM","2022","104","2","106","2024-12-30"
"89384","2024","COM","2022","680","16","696","2024-12-30"
"89385","2024","COM","2022","77","3","80","2024-12-30"
"89386","2024","COM","2022","121","1","122","2024-12-30"
"89387","2024","COM","2022","27275","526","27801","2024-12-30"
"89388","2024","COM","2022","489","13","502","2024-12-30"
"89390","2024","COM","2022","693","6","699","2024-12-30"
"89391","2024","COM","2022","1235","23","1258","2024-12-30"
"89392","2024","COM","2022","249","3","252","2024-12-30"
"89393","2024","COM","2022","115","2","117","2024-12-30"
"89394","2024","COM","2022","76","1","77","2024-12-30"
"89395","2024","COM","2022","427","9","436","2024-12-30"
"89397","2024","COM","2022","387","6","393","2024-12-30"
"89398","2024","COM","2022","386","6","392","2024-12-30"
"89399","2024","COM","2022","1546","42","1588","2024-12-30"
"89400","2024","COM","2022","298","6","304","2024-12-30"
"89402","2024","COM","2022","212","3","215","2024-12-30"
"89403","2024","COM","2022","88","3","91","2024-12-30"
"89404","2024","COM","2022","520","12","532","2024-12-30"
"89405","2024","COM","2022","481","11","492","2024-12-30"
"89406","2024","COM","2022","83","2","85","2024-12-30"
"89407","2024","COM","2022","889","29","918","2024-12-30"
"89408","2024","COM","2022","271","6","277","2024-12-30"
"89409","2024","COM","2022","62","1","63","2024-12-30"
"89410","2024","COM","2022","111","1","112","2024-12-30"
"89411","2024","COM","2022","1012","20","1032","2024-12-30"
"89412","2024","COM","2022","184","6","190","2024-12-30"
"89413","2024","COM","2022","43","1","44","2024-12-30"
"89414","2024","COM","2022","1396","27","1423","2024-12-30"
"89415","2024","COM","2022","193","6","199","2024-12-30"
"89416","2024","COM","2022","426","8","434","2024-12-30"
"89417","2024","COM","2022","113","3","116","2024-12-30"
"89418","2024","COM","2022","4268","165","4433","2024-12-30"
"89419","2024","COM","2022","2562","147","2709","2024-12-30"
"89420","2024","COM","2022","1076","22","1098","2024-12-30"
"89422","2024","COM","2022","43","2","45","2024-12-30"
"89423","2024","COM","2022","123","3","126","2024-12-30"
"89424","2024","COM","2022","133","7","140","2024-12-30"
"89425","2024","COM","2022","650","12","662","2024-12-30"
"89426","2024","COM","2022","373","7","380","2024-12-30"
"89427","2024","COM","2022","675","13","688","2024-12-30"
"89428","2024","COM","2022","579","5","584","2024-12-30"
"89430","2024","COM","2022","330","8","338","2024-12-30"
"89431","2024","COM","2022","62","4","66","2024-12-30"
"89432","2024","COM","2022","471","6","477","2024-12-30"
"89433","2024","COM","2022","269","4","273","2024-12-30"
"89434","2024","COM","2022","345","10","355","2024-12-30"
"89436","2024","COM","2022","846","27","873","2024-12-30"
"89437","2024","COM","2022","291","10","301","2024-12-30"
"89438","2024","COM","2022","1747","191","1938","2024-12-30"
"89439","2024","COM","2022","1501","20","1521","2024-12-30"
"89440","2024","COM","2022","407","12","419","2024-12-30"
"89441","2024","COM","2022","1273","29","1302","2024-12-30"
"89442","2024","COM","2022","244","7","251","2024-12-30"
"89443","2024","COM","2022","1853","62","1915","2024-12-30"
"89445","2024","COM","2022","52","2","54","2024-12-30"
"89446","2024","COM","2022","464","8","472","2024-12-30"
"89447","2024","COM","2022","157","2","159","2024-12-30"
"89449","2024","COM","2022","1813","38","1851","2024-12-30"
"89450","2024","COM","2022","635","13","648","2024-12-30"
"89451","2024","COM","2022","261","5","266","2024-12-30"
"89452","2024","COM","2022","348","14","362","2024-12-30"
"89453","2024","COM","2022","1101","21","1122","2024-12-30"
"89456","2024","COM","2022","671","8","679","2024-12-30"
"89458","2024","COM","2022","162","7","169","2024-12-30"
"89459","2024","COM","2022","337","9","346","2024-12-30"
"89460","2024","COM","2022","3470","62","3532","2024-12-30"
"89461","2024","COM","2022","1111","13","1124","2024-12-30"
"89462","2024","COM","2022","308","5","313","2024-12-30"
"89463","2024","COM","2022","257","6","263","2024-12-30"
"89464","2024","COM","2022","5130","78","5208","2024-12-30"
"89465","2024","COM","2022","296","7","303","2024-12-30"
"89466","2024","COM","2022","385","8","393","2024-12-30"
"89467","2024","COM","2022","800","14","814","2024-12-30"
"89468","2024","COM","2022","417","63","480","2024-12-30"
"89469","2024","COM","2022","952","22","974","2024-12-30"
"89470","2024","COM","2022","125","3","128","2024-12-30"
"89471","2024","COM","2022","463","11","474","2024-12-30"
"89472","2024","COM","2022","433","10","443","2024-12-30"
"89474","2024","COM","2022","282","8","290","2024-12-30"
"89475","2024","COM","2022","111","1","112","2024-12-30"
"89477","2024","COM","2022","102","1","103","2024-12-30"
"89478","2024","COM","2022","910","22","932","2024-12-30"
"89479","2024","COM","2022","282","5","287","2024-12-30"
"89480","2024","COM","2022","1559","32","1591","2024-12-30"
"89481","2024","COM","2022","102","6","108","2024-12-30"
"89482","2024","COM","2022","104","1","105","2024-12-30"
"89483","2024","COM","2022","528","18","546","2024-12-30"
"89485","2024","COM","2022","209","6","215","2024-12-30"
"89486","2024","COM","2022","147","3","150","2024-12-30"
"90001","2024","COM","2022","1123","22","1145","2024-12-30"
"90002","2024","COM","2022","353","6","359","2024-12-30"
"90003","2024","COM","2022","598","15","613","2024-12-30"
"90004","2024","COM","2022","595","9","604","2024-12-30"
"90005","2024","COM","2022","422","13","435","2024-12-30"
"90006","2024","COM","2022","287","7","294","2024-12-30"
"90007","2024","COM","2022","290","12","302","2024-12-30"
"90008","2024","COM","2022","4641","100","4741","2024-12-30"
"90009","2024","COM","2022","4985","64","5049","2024-12-30"
"90010","2024","COM","2022","45646","739","46385","2024-12-30"
"90011","2024","COM","2022","373","9","382","2024-12-30"
"90012","2024","COM","2022","1304","50","1354","2024-12-30"
"90013","2024","COM","2022","237","11","248","2024-12-30"
"90014","2024","COM","2022","490","10","500","2024-12-30"
"90015","2024","COM","2022","248","12","260","2024-12-30"
"90016","2024","COM","2022","120","3","123","2024-12-30"
"90017","2024","COM","2022","1737","25","1762","2024-12-30"
"90018","2024","COM","2022","369","8","377","2024-12-30"
"90019","2024","COM","2022","314","3","317","2024-12-30"
"90020","2024","COM","2022","243","9","252","2024-12-30"
"90021","2024","COM","2022","371","6","377","2024-12-30"
"90022","2024","COM","2022","2637","49","2686","2024-12-30"
"90023","2024","COM","2022","1181","24","1205","2024-12-30"
"90024","2024","COM","2022","132","3","135","2024-12-30"
"90025","2024","COM","2022","343","7","350","2024-12-30"
"90026","2024","COM","2022","1566","36","1602","2024-12-30"
"90027","2024","COM","2022","128","2","130","2024-12-30"
"90028","2024","COM","2022","375","8","383","2024-12-30"
"90029","2024","COM","2022","1935","48","1983","2024-12-30"
"90030","2024","COM","2022","178","3","181","2024-12-30"
"90031","2024","COM","2022","344","7","351","2024-12-30"
"90032","2024","COM","2022","3531","65","3596","2024-12-30"
"90033","2024","COM","2022","5677","80","5757","2024-12-30"
"90034","2024","COM","2022","762","25","787","2024-12-30"
"90035","2024","COM","2022","823","10","833","2024-12-30"
"90036","2024","COM","2022","270","2","272","2024-12-30"
"90037","2024","COM","2022","954","27","981","2024-12-30"
"90039","2024","COM","2022","3382","72","3454","2024-12-30"
"90041","2024","COM","2022","1395","42","1437","2024-12-30"
"90042","2024","COM","2022","2022","67","2089","2024-12-30"
"90043","2024","COM","2022","592","1","593","2024-12-30"
"90044","2024","COM","2022","228","5","233","2024-12-30"
"90045","2024","COM","2022","721","20","741","2024-12-30"
"90046","2024","COM","2022","465","3","468","2024-12-30"
"90047","2024","COM","2022","601","13","614","2024-12-30"
"90048","2024","COM","2022","135","4","139","2024-12-30"
"90049","2024","COM","2022","885","22","907","2024-12-30"
"90050","2024","COM","2022","237","7","244","2024-12-30"
"90051","2024","COM","2022","446","10","456","2024-12-30"
"90052","2024","COM","2022","2897","82","2979","2024-12-30"
"90053","2024","COM","2022","2963","49","3012","2024-12-30"
"90054","2024","COM","2022","551","15","566","2024-12-30"
"90055","2024","COM","2022","322","5","327","2024-12-30"
"90056","2024","COM","2022","1439","15","1454","2024-12-30"
"90057","2024","COM","2022","748","18","766","2024-12-30"
"90058","2024","COM","2022","554","13","567","2024-12-30"
"90059","2024","COM","2022","234","9","243","2024-12-30"
"90060","2024","COM","2022","139","5","144","2024-12-30"
"90061","2024","COM","2022","49","2","51","2024-12-30"
"90062","2024","COM","2022","278","8","286","2024-12-30"
"90063","2024","COM","2022","419","11","430","2024-12-30"
"90064","2024","COM","2022","315","4","319","2024-12-30"
"90065","2024","COM","2022","1113","19","1132","2024-12-30"
"90066","2024","COM","2022","248","5","253","2024-12-30"
"90067","2024","COM","2022","391","16","407","2024-12-30"
"90068","2024","COM","2022","1420","25","1445","2024-12-30"
"90069","2024","COM","2022","1268","25","1293","2024-12-30"
"90070","2024","COM","2022","425","8","433","2024-12-30"
"90071","2024","COM","2022","1167","22","1189","2024-12-30"
"90072","2024","COM","2022","1098","18","1116","2024-12-30"
"90074","2024","COM","2022","309","4","313","2024-12-30"
"90075","2024","COM","2022","4054","90","4144","2024-12-30"
"90076","2024","COM","2022","1199","43","1242","2024-12-30"
"90077","2024","COM","2022","305","3","308","2024-12-30"
"90078","2024","COM","2022","192","2","194","2024-12-30"
"90079","2024","COM","2022","323","6","329","2024-12-30"
"90080","2024","COM","2022","429","12","441","2024-12-30"
"90081","2024","COM","2022","765","14","779","2024-12-30"
"90082","2024","COM","2022","279","11","290","2024-12-30"
"90083","2024","COM","2022","144","0","144","2024-12-30"
"90084","2024","COM","2022","324","3","327","2024-12-30"
"90085","2024","COM","2022","86","2","88","2024-12-30"
"90086","2024","COM","2022","214","8","222","2024-12-30"
"90087","2024","COM","2022","1042","33","1075","2024-12-30"
"90088","2024","COM","2022","988","19","1007","2024-12-30"
"90089","2024","COM","2022","1481","49","1530","2024-12-30"
"90090","2024","COM","2022","430","14","444","2024-12-30"
"90091","2024","COM","2022","664","25","689","2024-12-30"
"90093","2024","COM","2022","945","20","965","2024-12-30"
"90094","2024","COM","2022","696","24","720","2024-12-30"
"90095","2024","COM","2022","439","3","442","2024-12-30"
"90096","2024","COM","2022","281","6","287","2024-12-30"
"90097","2024","COM","2022","1290","28","1318","2024-12-30"
"90098","2024","COM","2022","253","3","256","2024-12-30"
"90099","2024","COM","2022","5193","232","5425","2024-12-30"
"90100","2024","COM","2022","220","5","225","2024-12-30"
"90101","2024","COM","2022","250","9","259","2024-12-30"
"90102","2024","COM","2022","707","20","727","2024-12-30"
"90103","2024","COM","2022","647","21","668","2024-12-30"
"90104","2024","COM","2022","1026","24","1050","2024-12-30"
"90105","2024","COM","2022","178","5","183","2024-12-30"
"91001","2024","COM","2022","331","8","339","2024-12-30"
"91016","2024","COM","2022","4416","52","4468","2024-12-30"
"91017","2024","COM","2022","1720","29","1749","2024-12-30"
"91021","2024","COM","2022","11503","106","11609","2024-12-30"
"91022","2024","COM","2022","119","6","125","2024-12-30"
"91027","2024","COM","2022","36451","274","36725","2024-12-30"
"91035","2024","COM","2022","371","8","379","2024-12-30"
"91037","2024","COM","2022","330","4","334","2024-12-30"
"91038","2024","COM","2022","1250","22","1272","2024-12-30"
"91041","2024","COM","2022","1045","8","1053","2024-12-30"
"91044","2024","COM","2022","4838","49","4887","2024-12-30"
"91045","2024","COM","2022","7795","109","7904","2024-12-30"
"91047","2024","COM","2022","1468","17","1485","2024-12-30"
"91064","2024","COM","2022","4700","64","4764","2024-12-30"
"91067","2024","COM","2022","115","4","119","2024-12-30"
"91069","2024","COM","2022","376","4","380","2024-12-30"
"91075","2024","COM","2022","83","1","84","2024-12-30"
"91079","2024","COM","2022","533","9","542","2024-12-30"
"91080","2024","COM","2022","1343","12","1355","2024-12-30"
"91081","2024","COM","2022","693","16","709","2024-12-30"
"91085","2024","COM","2022","3855","45","3900","2024-12-30"
"91086","2024","COM","2022","10833","104","10937","2024-12-30"
"91093","2024","COM","2022","632","18","650","2024-12-30"
"91095","2024","COM","2022","2077","26","2103","2024-12-30"
"91097","2024","COM","2022","7986","81","8067","2024-12-30"
"91098","2024","COM","2022","429","4","433","2024-12-30"
"91099","2024","COM","2022","3048","42","3090","2024-12-30"
"91100","2024","COM","2022","658","15","673","2024-12-30"
"91103","2024","COM","2022","26658","365","27023","2024-12-30"
"91105","2024","COM","2022","9023","131","9154","2024-12-30"
"91106","2024","COM","2022","1283","15","1298","2024-12-30"
"91109","2024","COM","2022","1218","17","1235","2024-12-30"
"91111","2024","COM","2022","3375","52","3427","2024-12-30"
"91112","2024","COM","2022","129","5","134","2024-12-30"
"91114","2024","COM","2022","25792","434","26226","2024-12-30"
"91115","2024","COM","2022","3738","47","3785","2024-12-30"
"91121","2024","COM","2022","523","5","528","2024-12-30"
"91122","2024","COM","2022","9481","212","9693","2024-12-30"
"91129","2024","COM","2022","3425","156","3581","2024-12-30"
"91130","2024","COM","2022","1042","17","1059","2024-12-30"
"91131","2024","COM","2022","380","8","388","2024-12-30"
"91132","2024","COM","2022","1104","14","1118","2024-12-30"
"91135","2024","COM","2022","2873","39","2912","2024-12-30"
"91136","2024","COM","2022","2606","20","2626","2024-12-30"
"91137","2024","COM","2022","360","7","367","2024-12-30"
"91145","2024","COM","2022","71","0","71","2024-12-30"
"91148","2024","COM","2022","135","3","138","2024-12-30"
"91156","2024","COM","2022","2212","29","2241","2024-12-30"
"91159","2024","COM","2022","1550","25","1575","2024-12-30"
"91161","2024","COM","2022","19981","110","20091","2024-12-30"
"91174","2024","COM","2022","53712","250","53962","2024-12-30"
"91175","2024","COM","2022","1675","28","1703","2024-12-30"
"91179","2024","COM","2022","4738","52","4790","2024-12-30"
"91180","2024","COM","2022","336","12","348","2024-12-30"
"91184","2024","COM","2022","279","7","286","2024-12-30"
"91186","2024","COM","2022","570","6","576","2024-12-30"
"91191","2024","COM","2022","9606","63","9669","2024-12-30"
"91195","2024","COM","2022","854","11","865","2024-12-30"
"91198","2024","COM","2022","1532","27","1559","2024-12-30"
"91200","2024","COM","2022","11068","148","11216","2024-12-30"
"91201","2024","COM","2022","29824","244","30068","2024-12-30"
"91204","2024","COM","2022","720","16","736","2024-12-30"
"91207","2024","COM","2022","7078","56","7134","2024-12-30"
"91215","2024","COM","2022","11783","68","11851","2024-12-30"
"91216","2024","COM","2022","10626","93","10719","2024-12-30"
"91223","2024","COM","2022","26601","190","26791","2024-12-30"
"91225","2024","COM","2022","3100","102","3202","2024-12-30"
"91226","2024","COM","2022","6926","62","6988","2024-12-30"
"91228","2024","COM","2022","66700","341","67041","2024-12-30"
"91232","2024","COM","2022","3663","60","3723","2024-12-30"
"91235","2024","COM","2022","13816","21","13837","2024-12-30"
"91240","2024","COM","2022","182","1","183","2024-12-30"
"91243","2024","COM","2022","2322","33","2355","2024-12-30"
"91244","2024","COM","2022","1563","25","1588","2024-12-30"
"91247","2024","COM","2022","493","10","503","2024-12-30"
"91248","2024","COM","2022","153","4","157","2024-12-30"
"91249","2024","COM","2022","4138","78","4216","2024-12-30"
"91272","2024","COM","2022","22578","556","23134","2024-12-30"
"91273","2024","COM","2022","762","16","778","2024-12-30"
"91274","2024","COM","2022","1512","24","1536","2024-12-30"
"91275","2024","COM","2022","2635","47","2682","2024-12-30"
"91284","2024","COM","2022","1187","23","1210","2024-12-30"
"91286","2024","COM","2022","26500","56","26556","2024-12-30"
"91292","2024","COM","2022","929","6","935","2024-12-30"
"91293","2024","COM","2022","876","18","894","2024-12-30"
"91294","2024","COM","2022","812","8","820","2024-12-30"
"91312","2024","COM","2022","10571","315","10886","2024-12-30"
"91315","2024","COM","2022","6674","78","6752","2024-12-30"
"91318","2024","COM","2022","1997","46","2043","2024-12-30"
"91319","2024","COM","2022","649","10","659","2024-12-30"
"91326","2024","COM","2022","18978","110","19088","2024-12-30"
"91330","2024","COM","2022","5572","105","5677","2024-12-30"
"91332","2024","COM","2022","1560","16","1576","2024-12-30"
"91333","2024","COM","2022","4307","44","4351","2024-12-30"
"91338","2024","COM","2022","6408","118","6526","2024-12-30"
"91339","2024","COM","2022","7310","52","7362","2024-12-30"
"91340","2024","COM","2022","7295","75","7370","2024-12-30"
"91345","2024","COM","2022","20470","126","20596","2024-12-30"
"91347","2024","COM","2022","6456","84","6540","2024-12-30"
"91359","2024","COM","2022","2804","42","2846","2024-12-30"
"91363","2024","COM","2022","8597","129","8726","2024-12-30"
"91374","2024","COM","2022","238","3","241","2024-12-30"
"91376","2024","COM","2022","5688","52","5740","2024-12-30"
"91377","2024","COM","2022","50597","332","50929","2024-12-30"
"91378","2024","COM","2022","379","9","388","2024-12-30"
"91386","2024","COM","2022","16071","249","16320","2024-12-30"
"91390","2024","COM","2022","3420","44","3464","2024-12-30"
"91393","2024","COM","2022","635","8","643","2024-12-30"
"91399","2024","COM","2022","188","1","189","2024-12-30"
"91405","2024","COM","2022","4582","78","4660","2024-12-30"
"91408","2024","COM","2022","1311","31","1342","2024-12-30"
"91411","2024","COM","2022","1935","44","1979","2024-12-30"
"91412","2024","COM","2022","724","12","736","2024-12-30"
"91414","2024","COM","2022","377","8","385","2024-12-30"
"91421","2024","COM","2022","23890","270","24160","2024-12-30"
"91425","2024","COM","2022","9238","223","9461","2024-12-30"
"91432","2024","COM","2022","13773","84","13857","2024-12-30"
"91433","2024","COM","2022","4435","108","4543","2024-12-30"
"91434","2024","COM","2022","21161","148","21309","2024-12-30"
"91435","2024","COM","2022","584","19","603","2024-12-30"
"91441","2024","COM","2022","521","11","532","2024-12-30"
"91457","2024","COM","2022","4308","47","4355","2024-12-30"
"91458","2024","COM","2022","4465","74","4539","2024-12-30"
"91461","2024","COM","2022","5361","77","5438","2024-12-30"
"91463","2024","COM","2022","1037","26","1063","2024-12-30"
"91468","2024","COM","2022","2896","21","2917","2024-12-30"
"91469","2024","COM","2022","950","51","1001","2024-12-30"
"91471","2024","COM","2022","16655","364","17019","2024-12-30"
"91473","2024","COM","2022","145","2","147","2024-12-30"
"91477","2024","COM","2022","36067","283","36350","2024-12-30"
"91479","2024","COM","2022","7956","46","8002","2024-12-30"
"91482","2024","COM","2022","567","10","577","2024-12-30"
"91494","2024","COM","2022","4107","61","4168","2024-12-30"
"91495","2024","COM","2022","327","4","331","2024-12-30"
"91507","2024","COM","2022","312","2","314","2024-12-30"
"91508","2024","COM","2022","261","5","266","2024-12-30"
"91511","2024","COM","2022","2182","30","2212","2024-12-30"
"91514","2024","COM","2022","9491","60","9551","2024-12-30"
"91519","2024","COM","2022","388","11","399","2024-12-30"
"91521","2024","COM","2022","30283","165","30448","2024-12-30"
"91525","2024","COM","2022","1314","24","1338","2024-12-30"
"91526","2024","COM","2022","110","1","111","2024-12-30"
"91533","2024","COM","2022","1857","20","1877","2024-12-30"
"91534","2024","COM","2022","4380","69","4449","2024-12-30"
"91538","2024","COM","2022","671","23","694","2024-12-30"
"91540","2024","COM","2022","5176","80","5256","2024-12-30"
"91544","2024","COM","2022","472","6","478","2024-12-30"
"91546","2024","COM","2022","957","22","979","2024-12-30"
"91547","2024","COM","2022","465","16","481","2024-12-30"
"91549","2024","COM","2022","35714","301","36015","2024-12-30"
"91552","2024","COM","2022","11577","80","11657","2024-12-30"
"91553","2024","COM","2022","7471","90","7561","2024-12-30"
"91556","2024","COM","2022","402","8","410","2024-12-30"
"91560","2024","COM","2022","471","7","478","2024-12-30"
"91568","2024","COM","2022","1540","20","1560","2024-12-30"
"91570","2024","COM","2022","21536","136","21672","2024-12-30"
"91573","2024","COM","2022","12071","103","12174","2024-12-30"
"91577","2024","COM","2022","5853","69","5922","2024-12-30"
"91578","2024","COM","2022","271","8","279","2024-12-30"
"91579","2024","COM","2022","3046","55","3101","2024-12-30"
"91581","2024","COM","2022","914","10","924","2024-12-30"
"91587","2024","COM","2022","6611","57","6668","2024-12-30"
"91589","2024","COM","2022","37775","253","38028","2024-12-30"
"91593","2024","COM","2022","1606","30","1636","2024-12-30"
"91599","2024","COM","2022","1169","20","1189","2024-12-30"
"91600","2024","COM","2022","7370","91","7461","2024-12-30"
"91602","2024","COM","2022","484","9","493","2024-12-30"
"91613","2024","COM","2022","212","4","216","2024-12-30"
"91617","2024","COM","2022","4359","80","4439","2024-12-30"
"91619","2024","COM","2022","277","12","289","2024-12-30"
"91629","2024","COM","2022","621","14","635","2024-12-30"
"91630","2024","COM","2022","1550","28","1578","2024-12-30"
"91631","2024","COM","2022","2381","38","2419","2024-12-30"
"91634","2024","COM","2022","1451","34","1485","2024-12-30"
"91635","2024","COM","2022","1954","38","1992","2024-12-30"
"91639","2024","COM","2022","974","50","1024","2024-12-30"
"91645","2024","COM","2022","14772","242","15014","2024-12-30"
"91648","2024","COM","2022","2348","28","2376","2024-12-30"
"91649","2024","COM","2022","2716","26","2742","2024-12-30"
"91654","2024","COM","2022","584","11","595","2024-12-30"
"91657","2024","COM","2022","31233","151","31384","2024-12-30"
"91659","2024","COM","2022","5654","43","5697","2024-12-30"
"91661","2024","COM","2022","10353","191","10544","2024-12-30"
"91662","2024","COM","2022","768","12","780","2024-12-30"
"91665","2024","COM","2022","8140","99","8239","2024-12-30"
"91666","2024","COM","2022","2502","19","2521","2024-12-30"
"91667","2024","COM","2022","7226","73","7299","2024-12-30"
"91671","2024","COM","2022","595","7","602","2024-12-30"
"91679","2024","COM","2022","1040","21","1061","2024-12-30"
"91685","2024","COM","2022","4576","32","4608","2024-12-30"
"91687","2024","COM","2022","31112","206","31318","2024-12-30"
"91689","2024","COM","2022","6924","72","6996","2024-12-30"
"91691","2024","COM","2022","28349","282","28631","2024-12-30"
"91692","2024","COM","2022","25633","107","25740","2024-12-30"
"92002","2024","COM","2022","64026","731","64757","2024-12-30"
"92004","2024","COM","2022","91457","643","92100","2024-12-30"
"92007","2024","COM","2022","43647","167","43814","2024-12-30"
"92009","2024","COM","2022","29376","301","29677","2024-12-30"
"92012","2024","COM","2022","120205","1186","121391","2024-12-30"
"92014","2024","COM","2022","21140","303","21443","2024-12-30"
"92019","2024","COM","2022","35490","434","35924","2024-12-30"
"92020","2024","COM","2022","36224","233","36457","2024-12-30"
"92022","2024","COM","2022","20198","267","20465","2024-12-30"
"92023","2024","COM","2022","56882","507","57389","2024-12-30"
"92024","2024","COM","2022","65102","242","65344","2024-12-30"
"92025","2024","COM","2022","90692","595","91287","2024-12-30"
"92026","2024","COM","2022","81945","602","82547","2024-12-30"
"92032","2024","COM","2022","24586","183","24769","2024-12-30"
"92033","2024","COM","2022","17705","372","18077","2024-12-30"
"92035","2024","COM","2022","29828","270","30098","2024-12-30"
"92036","2024","COM","2022","50874","208","51082","2024-12-30"
"92040","2024","COM","2022","67695","680","68375","2024-12-30"
"92044","2024","COM","2022","68412","533","68945","2024-12-30"
"92046","2024","COM","2022","30183","189","30372","2024-12-30"
"92047","2024","COM","2022","1758","57","1815","2024-12-30"
"92048","2024","COM","2022","46722","636","47358","2024-12-30"
"92049","2024","COM","2022","46273","267","46540","2024-12-30"
"92050","2024","COM","2022","98119","626","98745","2024-12-30"
"92051","2024","COM","2022","59200","969","60169","2024-12-30"
"92060","2024","COM","2022","28893","173","29066","2024-12-30"
"92062","2024","COM","2022","44198","256","44454","2024-12-30"
"92063","2024","COM","2022","80842","1447","82289","2024-12-30"
"92064","2024","COM","2022","29859","471","30330","2024-12-30"
"92071","2024","COM","2022","20740","330","21070","2024-12-30"
"92072","2024","COM","2022","22782","289","23071","2024-12-30"
"92073","2024","COM","2022","48932","530","49462","2024-12-30"
"92075","2024","COM","2022","28507","287","28794","2024-12-30"
"92076","2024","COM","2022","8506","317","8823","2024-12-30"
"92077","2024","COM","2022","10871","222","11093","2024-12-30"
"92078","2024","COM","2022","25566","68","25634","2024-12-30"
"93001","2024","COM","2022","89489","173","89662","2024-12-30"
"93005","2024","COM","2022","86360","367","86727","2024-12-30"
"93006","2024","COM","2022","41776","142","41918","2024-12-30"
"93007","2024","COM","2022","59912","139","60051","2024-12-30"
"93008","2024","COM","2022","55270","134","55404","2024-12-30"
"93010","2024","COM","2022","51066","173","51239","2024-12-30"
"93013","2024","COM","2022","15052","40","15092","2024-12-30"
"93014","2024","COM","2022","29551","81","29632","2024-12-30"
"93015","2024","COM","2022","5156","44","5200","2024-12-30"
"93027","2024","COM","2022","47086","125","47211","2024-12-30"
"93029","2024","COM","2022","71312","240","71552","2024-12-30"
"93030","2024","COM","2022","11723","27","11750","2024-12-30"
"93031","2024","COM","2022","53564","135","53699","2024-12-30"
"93032","2024","COM","2022","40790","231","41021","2024-12-30"
"93033","2024","COM","2022","7101","43","7144","2024-12-30"
"93039","2024","COM","2022","8682","20","8702","2024-12-30"
"93045","2024","COM","2022","23262","123","23385","2024-12-30"
"93046","2024","COM","2022","46507","204","46711","2024-12-30"
"93047","2024","COM","2022","28257","134","28391","2024-12-30"
"93048","2024","COM","2022","110758","575","111333","2024-12-30"
"93049","2024","COM","2022","21914","128","22042","2024-12-30"
"93050","2024","COM","2022","38799","90","38889","2024-12-30"
"93051","2024","COM","2022","71632","432","72064","2024-12-30"
"93053","2024","COM","2022","45915","129","46044","2024-12-30"
"93055","2024","COM","2022","60954","172","61126","2024-12-30"
"93057","2024","COM","2022","24872","98","24970","2024-12-30"
"93059","2024","COM","2022","33670","55","33725","2024-12-30"
"93061","2024","COM","2022","16733","49","16782","2024-12-30"
"93062","2024","COM","2022","14778","173","14951","2024-12-30"
"93063","2024","COM","2022","35314","66","35380","2024-12-30"
"93064","2024","COM","2022","45947","194","46141","2024-12-30"
"93066","2024","COM","2022","115237","819","116056","2024-12-30"
"93070","2024","COM","2022","53041","123","53164","2024-12-30"
"93071","2024","COM","2022","51640","162","51802","2024-12-30"
"93072","2024","COM","2022","40600","83","40683","2024-12-30"
"93073","2024","COM","2022","38210","170","38380","2024-12-30"
"93074","2024","COM","2022","7743","54","7797","2024-12-30"
"93077","2024","COM","2022","29973","159","30132","2024-12-30"
"93078","2024","COM","2022","39647","101","39748","2024-12-30"
"93079","2024","COM","2022","12432","73","12505","2024-12-30"
"94001","2024","COM","2022","6029","40","6069","2024-12-30"
"94002","2024","COM","2022","45569","156","45725","2024-12-30"
"94003","2024","COM","2022","21868","108","21976","2024-12-30"
"94004","2024","COM","2022","17335","48","17383","2024-12-30"
"94011","2024","COM","2022","18340","70","18410","2024-12-30"
"94015","2024","COM","2022","18095","312","18407","2024-12-30"
"94016","2024","COM","2022","30526","268","30794","2024-12-30"
"94017","2024","COM","2022","78367","305","78672","2024-12-30"
"94018","2024","COM","2022","28756","180","28936","2024-12-30"
"94019","2024","COM","2022","18295","104","18399","2024-12-30"
"94021","2024","COM","2022","19813","86","19899","2024-12-30"
"94022","2024","COM","2022","46122","187","46309","2024-12-30"
"94028","2024","COM","2022","92859","429","93288","2024-12-30"
"94033","2024","COM","2022","52646","437","53083","2024-12-30"
"94034","2024","COM","2022","29298","134","29432","2024-12-30"
"94037","2024","COM","2022","18883","118","19001","2024-12-30"
"94038","2024","COM","2022","31338","212","31550","2024-12-30"
"94041","2024","COM","2022","64526","237","64763","2024-12-30"
"94042","2024","COM","2022","20784","145","20929","2024-12-30"
"94043","2024","COM","2022","23678","95","23773","2024-12-30"
"94044","2024","COM","2022","27806","94","27900","2024-12-30"
"94046","2024","COM","2022","57422","304","57726","2024-12-30"
"94047","2024","COM","2022","4876","50","4926","2024-12-30"
"94048","2024","COM","2022","4685","118","4803","2024-12-30"
"94052","2024","COM","2022","32998","266","33264","2024-12-30"
"94053","2024","COM","2022","4619","42","4661","2024-12-30"
"94054","2024","COM","2022","24488","193","24681","2024-12-30"
"94055","2024","COM","2022","10589","80","10669","2024-12-30"
"94056","2024","COM","2022","2744","35","2779","2024-12-30"
"94058","2024","COM","2022","34654","307","34961","2024-12-30"
"94059","2024","COM","2022","21096","123","21219","2024-12-30"
"94060","2024","COM","2022","12074","120","12194","2024-12-30"
"94065","2024","COM","2022","5669","51","5720","2024-12-30"
"94067","2024","COM","2022","21223","156","21379","2024-12-30"
"94068","2024","COM","2022","76010","872","76882","2024-12-30"
"94069","2024","COM","2022","14411","72","14483","2024-12-30"
"94070","2024","COM","2022","3958","51","4009","2024-12-30"
"94071","2024","COM","2022","27593","286","27879","2024-12-30"
"94073","2024","COM","2022","32006","228","32234","2024-12-30"
"94074","2024","COM","2022","14453","40","14493","2024-12-30"
"94075","2024","COM","2022","11650","96","11746","2024-12-30"
"94076","2024","COM","2022","58142","269","58411","2024-12-30"
"94077","2024","COM","2022","20871","69","20940","2024-12-30"
"94078","2024","COM","2022","36170","117","36287","2024-12-30"
"94079","2024","COM","2022","32547","157","32704","2024-12-30"
"94080","2024","COM","2022","48368","473","48841","2024-12-30"
"94081","2024","COM","2022","95282","479","95761","2024-12-30"
"95002","2024","COM","2022","1109","15","1124","2024-12-30"
"95008","2024","COM","2022","870","11","881","2024-12-30"
"95011","2024","COM","2022","390","2","392","2024-12-30"
"95012","2024","COM","2022","208","0","208","2024-12-30"
"95014","2024","COM","2022","2691","47","2738","2024-12-30"
"95018","2024","COM","2022","107135","428","107563","2024-12-30"
"95019","2024","COM","2022","14898","83","14981","2024-12-30"
"95023","2024","COM","2022","619","4","623","2024-12-30"
"95024","2024","COM","2022","267","4","271","2024-12-30"
"95026","2024","COM","2022","3128","43","3171","2024-12-30"
"95028","2024","COM","2022","1834","13","1847","2024-12-30"
"95039","2024","COM","2022","6820","104","6924","2024-12-30"
"95040","2024","COM","2022","866","14","880","2024-12-30"
"95042","2024","COM","2022","1947","15","1962","2024-12-30"
"95046","2024","COM","2022","148","2","150","2024-12-30"
"95051","2024","COM","2022","9506","70","9576","2024-12-30"
"95052","2024","COM","2022","9931","107","10038","2024-12-30"
"95054","2024","COM","2022","219","5","224","2024-12-30"
"95055","2024","COM","2022","471","3","474","2024-12-30"
"95056","2024","COM","2022","2239","18","2257","2024-12-30"
"95058","2024","COM","2022","2703","26","2729","2024-12-30"
"95059","2024","COM","2022","370","9","379","2024-12-30"
"95060","2024","COM","2022","8521","43","8564","2024-12-30"
"95061","2024","COM","2022","426","3","429","2024-12-30"
"95063","2024","COM","2022","34314","94","34408","2024-12-30"
"95074","2024","COM","2022","883","17","900","2024-12-30"
"95078","2024","COM","2022","2114","32","2146","2024-12-30"
"95088","2024","COM","2022","1179","2","1181","2024-12-30"
"95091","2024","COM","2022","6565","58","6623","2024-12-30"
"95094","2024","COM","2022","306","2","308","2024-12-30"
"95101","2024","COM","2022","957","8","965","2024-12-30"
"95102","2024","COM","2022","425","9","434","2024-12-30"
"95110","2024","COM","2022","243","2","245","2024-12-30"
"95116","2024","COM","2022","4907","38","4945","2024-12-30"
"95119","2024","COM","2022","327","3","330","2024-12-30"
"95120","2024","COM","2022","2242","27","2269","2024-12-30"
"95127","2024","COM","2022","69578","387","69965","2024-12-30"
"95134","2024","COM","2022","5022","59","5081","2024-12-30"
"95139","2024","COM","2022","316","5","321","2024-12-30"
"95141","2024","COM","2022","33","2","35","2024-12-30"
"95142","2024","COM","2022","2017","17","2034","2024-12-30"
"95144","2024","COM","2022","73","0","73","2024-12-30"
"95149","2024","COM","2022","3340","56","3396","2024-12-30"
"95150","2024","COM","2022","634","8","642","2024-12-30"
"95151","2024","COM","2022","297","4","301","2024-12-30"
"95154","2024","COM","2022","294","2","296","2024-12-30"
"95157","2024","COM","2022","128","1","129","2024-12-30"
"95166","2024","COM","2022","467","6","473","2024-12-30"
"95169","2024","COM","2022","648","7","655","2024-12-30"
"95170","2024","COM","2022","557","6","563","2024-12-30"
"95176","2024","COM","2022","27086","234","27320","2024-12-30"
"95177","2024","COM","2022","1294","16","1310","2024-12-30"
"95181","2024","COM","2022","307","3","310","2024-12-30"
"95183","2024","COM","2022","7111","73","7184","2024-12-30"
"95197","2024","COM","2022","22903","189","23092","2024-12-30"
"95199","2024","COM","2022","16075","146","16221","2024-12-30"
"95203","2024","COM","2022","25934","354","26288","2024-12-30"
"95205","2024","COM","2022","7173","31","7204","2024-12-30"
"95210","2024","COM","2022","11594","120","11714","2024-12-30"
"95211","2024","COM","2022","2313","25","2338","2024-12-30"
"95212","2024","COM","2022","141","0","141","2024-12-30"
"95213","2024","COM","2022","607","17","624","2024-12-30"
"95214","2024","COM","2022","58","0","58","2024-12-30"
"95218","2024","COM","2022","18723","137","18860","2024-12-30"
"95219","2024","COM","2022","29189","179","29368","2024-12-30"
"95229","2024","COM","2022","9789","60","9849","2024-12-30"
"95241","2024","COM","2022","2220","14","2234","2024-12-30"
"95250","2024","COM","2022","10249","66","10315","2024-12-30"
"95252","2024","COM","2022","38024","148","38172","2024-12-30"
"95253","2024","COM","2022","502","9","511","2024-12-30"
"95254","2024","COM","2022","535","7","542","2024-12-30"
"95256","2024","COM","2022","3327","43","3370","2024-12-30"
"95257","2024","COM","2022","4587","53","4640","2024-12-30"
"95258","2024","COM","2022","347","8","355","2024-12-30"
"95268","2024","COM","2022","42388","91","42479","2024-12-30"
"95270","2024","COM","2022","521","10","531","2024-12-30"
"95271","2024","COM","2022","515","8","523","2024-12-30"
"95277","2024","COM","2022","26959","100","27059","2024-12-30"
"95280","2024","COM","2022","30952","132","31084","2024-12-30"
"95287","2024","COM","2022","706","15","721","2024-12-30"
"95288","2024","COM","2022","8378","44","8422","2024-12-30"
"95295","2024","COM","2022","151","2","153","2024-12-30"
"95298","2024","COM","2022","582","6","588","2024-12-30"
"95301","2024","COM","2022","291","6","297","2024-12-30"
"95303","2024","COM","2022","206","3","209","2024-12-30"
"95304","2024","COM","2022","280","2","282","2024-12-30"
"95306","2024","COM","2022","31818","259","32077","2024-12-30"
"95308","2024","COM","2022","569","13","582","2024-12-30"
"95309","2024","COM","2022","225","0","225","2024-12-30"
"95313","2024","COM","2022","12302","176","12478","2024-12-30"
"95316","2024","COM","2022","272","6","278","2024-12-30"
"95323","2024","COM","2022","17411","152","17563","2024-12-30"
"95328","2024","COM","2022","641","7","648","2024-12-30"
"95331","2024","COM","2022","194","3","197","2024-12-30"
"95341","2024","COM","2022","386","5","391","2024-12-30"
"95348","2024","COM","2022","505","9","514","2024-12-30"
"95351","2024","COM","2022","12226","64","12290","2024-12-30"
"95352","2024","COM","2022","4909","83","4992","2024-12-30"
"95353","2024","COM","2022","1768","19","1787","2024-12-30"
"95355","2024","COM","2022","5755","56","5811","2024-12-30"
"95365","2024","COM","2022","721","7","728","2024-12-30"
"95369","2024","COM","2022","2954","39","2993","2024-12-30"
"95370","2024","COM","2022","3508","54","3562","2024-12-30"
"95371","2024","COM","2022","5852","48","5900","2024-12-30"
"95379","2024","COM","2022","203","4","207","2024-12-30"
"95387","2024","COM","2022","62","0","62","2024-12-30"
"95388","2024","COM","2022","6189","48","6237","2024-12-30"
"95392","2024","COM","2022","5337","57","5394","2024-12-30"
"95394","2024","COM","2022","10015","70","10085","2024-12-30"
"95395","2024","COM","2022","901","9","910","2024-12-30"
"95409","2024","COM","2022","1259","11","1270","2024-12-30"
"95422","2024","COM","2022","350","3","353","2024-12-30"
"95424","2024","COM","2022","22390","117","22507","2024-12-30"
"95426","2024","COM","2022","2966","81","3047","2024-12-30"
"95427","2024","COM","2022","14632","64","14696","2024-12-30"
"95428","2024","COM","2022","21677","236","21913","2024-12-30"
"95429","2024","COM","2022","382","8","390","2024-12-30"
"95430","2024","COM","2022","4095","35","4130","2024-12-30"
"95436","2024","COM","2022","1680","8","1688","2024-12-30"
"95438","2024","COM","2022","111","2","113","2024-12-30"
"95445","2024","COM","2022","779","5","784","2024-12-30"
"95446","2024","COM","2022","1823","27","1850","2024-12-30"
"95447","2024","COM","2022","238","5","243","2024-12-30"
"95450","2024","COM","2022","2089","26","2115","2024-12-30"
"95452","2024","COM","2022","887","8","895","2024-12-30"
"95456","2024","COM","2022","582","5","587","2024-12-30"
"95459","2024","COM","2022","719","13","732","2024-12-30"
"95462","2024","COM","2022","325","3","328","2024-12-30"
"95476","2024","COM","2022","17471","164","17635","2024-12-30"
"95480","2024","COM","2022","5683","116","5799","2024-12-30"
"95483","2024","COM","2022","513","11","524","2024-12-30"
"95487","2024","COM","2022","14348","49","14397","2024-12-30"
"95488","2024","COM","2022","10230","35","10265","2024-12-30"
"95489","2024","COM","2022","737","47","784","2024-12-30"
"95491","2024","COM","2022","8333","67","8400","2024-12-30"
"95492","2024","COM","2022","97","2","99","2024-12-30"
"95493","2024","COM","2022","140","3","143","2024-12-30"
"95500","2024","COM","2022","31623","495","32118","2024-12-30"
"95504","2024","COM","2022","3994","49","4043","2024-12-30"
"95509","2024","COM","2022","3755","36","3791","2024-12-30"
"95510","2024","COM","2022","593","1","594","2024-12-30"
"95523","2024","COM","2022","423","29","452","2024-12-30"
"95527","2024","COM","2022","2682","25","2707","2024-12-30"
"95529","2024","COM","2022","890","20","910","2024-12-30"
"95535","2024","COM","2022","1100","22","1122","2024-12-30"
"95539","2024","COM","2022","15209","77","15286","2024-12-30"
"95541","2024","COM","2022","979","9","988","2024-12-30"
"95543","2024","COM","2022","237","1","238","2024-12-30"
"95554","2024","COM","2022","883","20","903","2024-12-30"
"95555","2024","COM","2022","21297","89","21386","2024-12-30"
"95563","2024","COM","2022","16047","135","16182","2024-12-30"
"95566","2024","COM","2022","2662","24","2686","2024-12-30"
"95572","2024","COM","2022","25614","114","25728","2024-12-30"
"95574","2024","COM","2022","7588","83","7671","2024-12-30"
"95580","2024","COM","2022","2511","111","2622","2024-12-30"
"95582","2024","COM","2022","26772","347","27119","2024-12-30"
"95584","2024","COM","2022","660","11","671","2024-12-30"
"95585","2024","COM","2022","58576","222","58798","2024-12-30"
"95592","2024","COM","2022","1310","14","1324","2024-12-30"
"95594","2024","COM","2022","1039","14","1053","2024-12-30"
"95598","2024","COM","2022","18068","141","18209","2024-12-30"
"95604","2024","COM","2022","4154","40","4194","2024-12-30"
"95607","2024","COM","2022","27065","180","27245","2024-12-30"
"95610","2024","COM","2022","289","6","295","2024-12-30"
"95611","2024","COM","2022","53","0","53","2024-12-30"
"95612","2024","COM","2022","4575","12","4587","2024-12-30"
"95625","2024","COM","2022","1331","12","1343","2024-12-30"
"95627","2024","COM","2022","616","8","624","2024-12-30"
"95628","2024","COM","2022","1209","25","1234","2024-12-30"
"95633","2024","COM","2022","102","1","103","2024-12-30"
"95637","2024","COM","2022","16079","189","16268","2024-12-30"
"95641","2024","COM","2022","2986","19","3005","2024-12-30"
"95651","2024","COM","2022","867","18","885","2024-12-30"
"95652","2024","COM","2022","5509","66","5575","2024-12-30"
"95656","2024","COM","2022","360","6","366","2024-12-30"
"95658","2024","COM","2022","1132","23","1155","2024-12-30"
"95660","2024","COM","2022","776","10","786","2024-12-30"
"95675","2024","COM","2022","1672","16","1688","2024-12-30"
"95676","2024","COM","2022","487","10","497","2024-12-30"
"95678","2024","COM","2022","848","16","864","2024-12-30"
"95680","2024","COM","2022","29238","129","29367","2024-12-30"
"95682","2024","COM","2022","198","3","201","2024-12-30"
"95690","2024","COM","2022","329","4","333","2024-12-30"
"97101","2024","COM","2022","51760","425","52185","2024-12-30"
"97102","2024","COM","2022","4232","56","4288","2024-12-30"
"97103","2024","COM","2022","30943","423","31366","2024-12-30"
"97104","2024","COM","2022","4949","91","5040","2024-12-30"
"97105","2024","COM","2022","9419","182","9601","2024-12-30"
"97106","2024","COM","2022","6381","90","6471","2024-12-30"
"97107","2024","COM","2022","17882","161","18043","2024-12-30"
"97108","2024","COM","2022","3150","27","3177","2024-12-30"
"97109","2024","COM","2022","7378","107","7485","2024-12-30"
"97110","2024","COM","2022","1349","13","1362","2024-12-30"
"97111","2024","COM","2022","3792","33","3825","2024-12-30"
"97112","2024","COM","2022","4678","73","4751","2024-12-30"
"97113","2024","COM","2022","27205","233","27438","2024-12-30"
"97114","2024","COM","2022","7640","133","7773","2024-12-30"
"97115","2024","COM","2022","18437","254","18691","2024-12-30"
"97116","2024","COM","2022","15839","167","16006","2024-12-30"
"97117","2024","COM","2022","22924","296","23220","2024-12-30"
"97118","2024","COM","2022","24299","231","24530","2024-12-30"
"97119","2024","COM","2022","8206","124","8330","2024-12-30"
"97120","2024","COM","2022","14855","85","14940","2024-12-30"
"97121","2024","COM","2022","5813","124","5937","2024-12-30"
"97122","2024","COM","2022","5591","83","5674","2024-12-30"
"97124","2024","COM","2022","10432","214","10646","2024-12-30"
"97125","2024","COM","2022","13249","144","13393","2024-12-30"
"97126","2024","COM","2022","2594","34","2628","2024-12-30"
"97128","2024","COM","2022","24415","225","24640","2024-12-30"
"97129","2024","COM","2022","17494","206","17700","2024-12-30"
"97130","2024","COM","2022","895","20","915","2024-12-30"
"97131","2024","COM","2022","1479","48","1527","2024-12-30"
"97132","2024","COM","2022","7519","137","7656","2024-12-30"
"97133","2024","COM","2022","1730","29","1759","2024-12-30"
"97134","2024","COM","2022","7040","160","7200","2024-12-30"
"97201","2024","COM","2022","1693","37","1730","2024-12-30"
"97202","2024","COM","2022","3874","28","3902","2024-12-30"
"97203","2024","COM","2022","2810","29","2839","2024-12-30"
"97204","2024","COM","2022","3619","44","3663","2024-12-30"
"97205","2024","COM","2022","4524","58","4582","2024-12-30"
"97206","2024","COM","2022","5924","70","5994","2024-12-30"
"97207","2024","COM","2022","17837","239","18076","2024-12-30"
"97208","2024","COM","2022","641","3","644","2024-12-30"
"97209","2024","COM","2022","75165","634","75799","2024-12-30"
"97210","2024","COM","2022","15858","141","15999","2024-12-30"
"97211","2024","COM","2022","508","11","519","2024-12-30"
"97212","2024","COM","2022","9752","106","9858","2024-12-30"
"97213","2024","COM","2022","39346","407","39753","2024-12-30"
"97214","2024","COM","2022","6607","71","6678","2024-12-30"
"97215","2024","COM","2022","1001","3","1004","2024-12-30"
"97216","2024","COM","2022","2991","45","3036","2024-12-30"
"97217","2024","COM","2022","8526","72","8598","2024-12-30"
"97218","2024","COM","2022","4469","51","4520","2024-12-30"
"97219","2024","COM","2022","1463","11","1474","2024-12-30"
"97220","2024","COM","2022","11797","100","11897","2024-12-30"
"97221","2024","COM","2022","11818","215","12033","2024-12-30"
"97222","2024","COM","2022","21490","108","21598","2024-12-30"
"97223","2024","COM","2022","10422","100","10522","2024-12-30"
"97224","2024","COM","2022","16470","193","16663","2024-12-30"
"97225","2024","COM","2022","4069","50","4119","2024-12-30"
"97226","2024","COM","2022","4491","65","4556","2024-12-30"
"97227","2024","COM","2022","9275","200","9475","2024-12-30"
"97228","2024","COM","2022","14827","181","15008","2024-12-30"
"97229","2024","COM","2022","19342","215","19557","2024-12-30"
"97230","2024","COM","2022","11622","156","11778","2024-12-30"
"97231","2024","COM","2022","6735","79","6814","2024-12-30"
"97232","2024","COM","2022","8481","99","8580","2024-12-30"
"97233","2024","COM","2022","1748","22","1770","2024-12-30"
"97234","2024","COM","2022","1824","129","1953","2024-12-30"
"97301","2024","COM","2022","1657","95","1752","2024-12-30"
"97302","2024","COM","2022","63956","280","64236","2024-12-30"
"97303","2024","COM","2022","1685","14","1699","2024-12-30"
"97304","2024","COM","2022","24470","227","24697","2024-12-30"
"97305","2024","COM","2022","18807","182","18989","2024-12-30"
"97306","2024","COM","2022","11364","116","11480","2024-12-30"
"97307","2024","COM","2022","35551","177","35728","2024-12-30"
"97308","2024","COM","2022","4710","56","4766","2024-12-30"
"97309","2024","COM","2022","27037","347","27384","2024-12-30"
"97310","2024","COM","2022","3382","54","3436","2024-12-30"
"97311","2024","COM","2022","51732","284","52016","2024-12-30"
"97312","2024","COM","2022","2801","37","2838","2024-12-30"
"97313","2024","COM","2022","3457","19","3476","2024-12-30"
"97314","2024","COM","2022","200","1","201","2024-12-30"
"97352","2024","COM","2022","297","7","304","2024-12-30"
"97353","2024","COM","2022","8423","141","8564","2024-12-30"
"97356","2024","COM","2022","2168","8","2176","2024-12-30"
"97357","2024","COM","2022","9390","7","9397","2024-12-30"
"97358","2024","COM","2022","157","0","157","2024-12-30"
"97360","2024","COM","2022","10059","21","10080","2024-12-30"
"97361","2024","COM","2022","1549","5","1554","2024-12-30"
"97362","2024","COM","2022","5530","16","5546","2024-12-30"
"97401","2024","COM","2022","11445","218","11663","2024-12-30"
"97402","2024","COM","2022","13131","216","13347","2024-12-30"
"97403","2024","COM","2022","7115","73","7188","2024-12-30"
"97404","2024","COM","2022","14329","211","14540","2024-12-30"
"97405","2024","COM","2022","12920","171","13091","2024-12-30"
"97406","2024","COM","2022","6920","99","7019","2024-12-30"
"97407","2024","COM","2022","33670","270","33940","2024-12-30"
"97408","2024","COM","2022","36390","444","36834","2024-12-30"
"97409","2024","COM","2022","57546","491","58037","2024-12-30"
"97410","2024","COM","2022","37585","317","37902","2024-12-30"
"97411","2024","COM","2022","156149","1525","157674","2024-12-30"
"97412","2024","COM","2022","38992","549","39541","2024-12-30"
"97413","2024","COM","2022","35597","453","36050","2024-12-30"
"97414","2024","COM","2022","54478","676","55154","2024-12-30"
"97415","2024","COM","2022","106220","1281","107501","2024-12-30"
"97416","2024","COM","2022","85254","886","86140","2024-12-30"
"97417","2024","COM","2022","5093","67","5160","2024-12-30"
"97418","2024","COM","2022","35584","430","36014","2024-12-30"
"97419","2024","COM","2022","6450","81","6531","2024-12-30"
"97420","2024","COM","2022","24855","258","25113","2024-12-30"
"97421","2024","COM","2022","7333","76","7409","2024-12-30"
"97422","2024","COM","2022","81964","911","82875","2024-12-30"
"97423","2024","COM","2022","7113","94","7207","2024-12-30"
"97424","2024","COM","2022","5215","45","5260","2024-12-30"
"97501","2024","COM","2021","591","16","607","2024-12-30"
"97502","2024","COM","2021","5282","152","5434","2024-12-30"
"97601","2024","COM","2017","5192","192","5384","2024-12-30"
"97602","2024","COM","2017","13989","222","14211","2024-12-30"
"97603","2024","COM","2017","10282","247","10529","2024-12-30"
"97604","2024","COM","2017","6189","314","6503","2024-12-30"
"97605","2024","COM","2017","8295","321","8616","2024-12-30"
"97606","2024","COM","2017","8920","277","9197","2024-12-30"
"97607","2024","COM","2017","15848","268","16116","2024-12-30"
"97608","2024","COM","2017","17831","406","18237","2024-12-30"
"97609","2024","COM","2017","5507","209","5716","2024-12-30"
"97610","2024","COM","2017","32156","596","32752","2024-12-30"
"97611","2024","COM","2017","71437","1537","72974","2024-12-30"
"97612","2024","COM","2017","7705","320","8025","2024-12-30"
"97613","2024","COM","2017","6432","154","6586","2024-12-30"
"97614","2024","COM","2017","10203","190","10393","2024-12-30"
"97615","2024","COM","2017","11442","360","11802","2024-12-30"
"97616","2024","COM","2017","11156","463","11619","2024-12-30"
"97617","2024","COM","2017","13934","301","14235","2024-12-30"
"97701","2024","COM","2021","10464","91","10556","2024-12-30"
"97801","2024","COM","2021","31477","533","32010","2024-12-30"
"98411","2024","DIS",".",".",".",".","2024-12-30"
"98412","2024","DIS",".",".",".",".","2024-12-30"
"98413","2024","DIS",".",".",".",".","2024-12-30"
"98414","2024","DIS",".",".",".",".","2024-12-30"
"98415","2024","DIS",".",".",".",".","2024-12-30"
"98611","2024","CIR","2018","1950","81","2031","2024-12-30"
"98612","2024","CIR","2018","1275","60","1335","2024-12-30"
"98613","2024","CIR","2018","8333","368","8701","2024-12-30"
"98711","2024","COM","2017","970","1","971","2024-12-30"
"98712","2024","COM","2017","10322","55","10377","2024-12-30"
"98713","2024","COM","2017","1736","15","1751","2024-12-30"
"98714","2024","COM","2017","10758","98","10856","2024-12-30"
"98715","2024","COM","2017","29826","319","30145","2024-12-30"
"98716","2024","COM","2017","1679","23","1702","2024-12-30"
"98717","2024","COM","2017","323","1","324","2024-12-30"
"98718","2024","COM","2017","600","9","609","2024-12-30"
"98719","2024","COM","2017","1570","26","1596","2024-12-30"
"98720","2024","COM","2017","1227","147","1374","2024-12-30"
"98721","2024","COM","2017","199","0","199","2024-12-30"
"98722","2024","COM","2017","10196","40","10236","2024-12-30"
"98723","2024","COM","2017","2371","143","2514","2024-12-30"
"98724","2024","COM","2017","6263","62","6325","2024-12-30"
"98725","2024","COM","2017","14623","258","14881","2024-12-30"
"98726","2024","COM","2017","1391","96","1487","2024-12-30"
"98727","2024","COM","2017","1138","7","1145","2024-12-30"
"98728","2024","COM","2017","1302","13","1315","2024-12-30"
"98729","2024","COM","2017","18201","131","18332","2024-12-30"
"98730","2024","COM","2017","307","3","310","2024-12-30"
"98731","2024","COM","2017","3025","136","3161","2024-12-30"
"98732","2024","COM","2017","287","5","292","2024-12-30"
"98733","2024","COM","2017","12756","67","12823","2024-12-30"
"98734","2024","COM","2017","11743","151","11894","2024-12-30"
"98735","2024","COM","2017","26654","338","26992","2024-12-30"
"98736","2024","COM","2017","14068","402","14470","2024-12-30"
"98737","2024","COM","2017","137","1","138","2024-12-30"
"98738","2024","COM","2017","28781","392","29173","2024-12-30"
"98739","2024","COM","2017","900","29","929","2024-12-30"
"98740","2024","COM","2017","3761","143","3904","2024-12-30"
"98741","2024","COM","2017","451","16","467","2024-12-30"
"98742","2024","COM","2017","513","7","520","2024-12-30"
"98743","2024","COM","2017","893","26","919","2024-12-30"
"98744","2024","COM","2017","2163","87","2250","2024-12-30"
"98745","2024","COM","2017","5296","69","5365","2024-12-30"
"98746","2024","COM","2017","595","21","616","2024-12-30"
"98747","2024","COM","2017","13602","240","13842","2024-12-30"
"98748","2024","COM","2017","8371","100","8471","2024-12-30"
"98749","2024","COM","2017","1050","6","1056","2024-12-30"
"98750","2024","COM","2017","5007","32","5039","2024-12-30"
"98751","2024","COM","2017","180","0","180","2024-12-30"
"98752","2024","COM","2017","10837","48","10885","2024-12-30"
"98753","2024","COM","2017","2185","100","2285","2024-12-30"
"98754","2024","COM","2017","3718","42","3760","2024-12-30"
"98755","2024","COM","2017","261","3","264","2024-12-30"
"98756","2024","COM","2017","719","6","725","2024-12-30"
"98757","2024","COM","2017","2168","46","2214","2024-12-30"
"98758","2024","COM","2017","3663","401","4064","2024-12-30"
"98801","2024","COM","2019","867","852","1719","2024-12-30"
"98802","2024","COM","2019","3315","385","3700","2024-12-30"
"98803","2024","COM","2019","5531","878","6409","2024-12-30"
"98804","2024","COM","2019","3701","2327","6028","2024-12-30"
"98805","2024","COM","2019","35873","377","36250","2024-12-30"
"98806","2024","COM","2019","712","6","718","2024-12-30"
"98807","2024","COM","2019","2454","1524","3978","2024-12-30"
"98808","2024","COM","2019","3955","2198","6153","2024-12-30"
"98809","2024","COM","2019","2037","1010","3047","2024-12-30"
"98810","2024","COM","2019","1803","550","2353","2024-12-30"
"98811","2024","COM","2019","8144","1078","9222","2024-12-30"
"98812","2024","COM","2019","3981","469","4450","2024-12-30"
"98813","2024","COM","2019","3552","472","4024","2024-12-30"
"98814","2024","COM","2019","9195","13958","23153","2024-12-30"
"98815","2024","COM","2019","5757","7578","13335","2024-12-30"
"98816","2024","COM","2019","681","161","842","2024-12-30"
"98817","2024","COM","2019","27620","720","28340","2024-12-30"
"98818","2024","COM","2019","94285","1797","96082","2024-12-30"
"98819","2024","COM","2019","2118","875","2993","2024-12-30"
"98820","2024","COM","2019","3401","5296","8697","2024-12-30"
"98821","2024","COM","2019","24563","888","25451","2024-12-30"
"98822","2024","COM","2019","5006","1646","6652","2024-12-30"
"98823","2024","COM","2019","2420","1971","4391","2024-12-30"
"98824","2024","COM","2019","2144","1672","3816","2024-12-30"
"98825","2024","COM","2019","2752","537","3289","2024-12-30"
"98826","2024","COM","2019","1435","680","2115","2024-12-30"
"98827","2024","COM","2019","2802","582","3384","2024-12-30"
"98828","2024","COM","2019","572","357","929","2024-12-30"
"98829","2024","COM","2019","2524","860","3384","2024-12-30"
"98830","2024","COM","2019","2380","1123","3503","2024-12-30"
"98831","2024","COM","2019","2856","754","3610","2024-12-30"
"98832","2024","COM","2019","1667","1027","2694","2024-12-30"
"98833","2024","COM","2019","1304","526","1830","2024-12-30"
"98901","2024","CPT",".",".",".",".","2024-12-30"
"75056","2024","COM","2022","2113705","15552","2129257","2024-12-30"
"69123","2024","COM","2022","520774","6138","526912","2024-12-30"
"13055","2024","COM","2022","877215","6251","883466","2024-12-30"
